codice_provincia,Provincia,Età,Maschi celibi,Maschi coniugati,Maschi divorziati,Maschi vedovi,Maschi uniti civilmente,Maschi già in unione civile (per scioglimento),Maschi già in unione civile (per decesso del partner),Totale Maschi,Femmine nubili,Femmine coniugate,Femmine divorziate,Femmine vedove,Femmine unite civilmente,Femmine già in unione civile (per scioglimento),Femmine già in unione civile (per decesso del partner),Totale Femmine,Popolazione
1,Torino,0,7638,0,0,0,0,0,0,7638,7384,0,0,0,0,0,0,7384,15022
1,Torino,1,8314,0,0,0,0,0,0,8314,7954,0,0,0,0,0,0,7954,16268
1,Torino,2,8622,0,0,0,0,0,0,8622,8261,0,0,0,0,0,0,8261,16883
1,Torino,3,9156,0,0,0,0,0,0,9156,8386,0,0,0,0,0,0,8386,17542
1,Torino,4,9209,0,0,0,0,0,0,9209,8949,0,0,0,0,0,0,8949,18158
1,Torino,5,9680,0,0,0,0,0,0,9680,9043,0,0,0,0,0,0,9043,18723
1,Torino,6,9957,0,0,0,0,0,0,9957,9426,0,0,0,0,0,0,9426,19383
1,Torino,7,10234,0,0,0,0,0,0,10234,9459,0,0,0,0,0,0,9459,19693
1,Torino,8,10395,0,0,0,0,0,0,10395,9820,0,0,0,0,0,0,9820,20215
1,Torino,9,10708,0,0,0,0,0,0,10708,9896,0,0,0,0,0,0,9896,20604
1,Torino,10,10809,0,0,0,0,0,0,10809,10068,0,0,0,0,0,0,10068,20877
1,Torino,11,10645,0,0,0,0,0,0,10645,9975,0,0,0,0,0,0,9975,20620
1,Torino,12,10548,0,0,0,0,0,0,10548,9717,0,0,0,0,0,0,9717,20265
1,Torino,13,10401,0,0,0,0,0,0,10401,9839,0,0,0,0,0,0,9839,20240
1,Torino,14,10464,0,0,0,0,0,0,10464,9676,0,0,0,0,0,0,9676,20140
1,Torino,15,10396,0,0,0,0,0,0,10396,9845,0,0,0,0,0,0,9845,20241
1,Torino,16,10070,0,0,0,0,0,0,10070,9723,0,0,0,0,0,0,9723,19793
1,Torino,17,10071,0,0,0,0,0,0,10071,9582,3,0,0,0,0,0,9585,19656
1,Torino,18,10603,0,0,0,0,0,0,10603,9826,13,0,0,0,0,0,9839,20442
1,Torino,19,10538,4,0,0,0,0,0,10542,9418,53,0,0,0,0,0,9471,20013
1,Torino,20,10865,10,2,0,1,0,0,10878,9592,82,0,0,0,0,0,9674,20552
1,Torino,21,10652,23,0,0,0,0,0,10675,9591,195,4,0,0,0,0,9790,20465
1,Torino,22,10498,47,0,0,4,0,0,10549,9281,290,4,0,0,0,0,9575,20124
1,Torino,23,10343,113,1,0,2,0,0,10459,9069,410,5,1,1,0,0,9486,19945
1,Torino,24,10482,146,5,0,0,0,0,10633,9015,627,12,4,1,0,0,9659,20292
1,Torino,25,10250,290,5,0,2,0,0,10547,9115,950,14,1,5,0,0,10085,20632
1,Torino,26,10645,428,13,0,3,0,0,11089,8865,1377,21,1,3,0,0,10267,21356
1,Torino,27,10609,723,19,1,4,0,0,11356,8851,1791,39,1,2,0,0,10684,22040
1,Torino,28,10687,1144,22,1,3,0,0,11857,8538,2487,56,3,9,0,0,11093,22950
1,Torino,29,9902,1615,33,2,9,0,0,11561,7941,2961,91,4,7,0,0,11004,22565
1,Torino,30,9683,2187,55,2,12,0,0,11939,7544,3704,112,14,6,0,0,11380,23319
1,Torino,31,8770,2680,51,2,13,0,0,11516,6876,4407,173,19,13,0,0,11488,23004
1,Torino,32,8551,3302,69,3,13,0,0,11938,6382,4888,200,13,9,0,0,11492,23430
1,Torino,33,8196,3804,104,3,13,0,0,12120,6201,5704,244,22,6,0,0,12177,24297
1,Torino,34,7677,4277,114,7,7,0,0,12082,5938,5959,314,16,17,0,0,12244,24326
1,Torino,35,7336,4877,170,2,15,0,0,12400,5535,6570,336,30,13,0,0,12484,24884
1,Torino,36,7151,5637,203,2,15,0,0,13008,5414,7108,435,31,9,0,0,12997,26005
1,Torino,37,6654,5933,245,14,13,0,0,12859,5151,7392,511,55,9,0,0,13118,25977
1,Torino,38,6481,6350,321,9,10,0,0,13171,4983,7839,583,69,11,0,0,13485,26656
1,Torino,39,6509,6860,354,15,16,0,0,13754,4755,8344,671,68,9,0,0,13847,27601
1,Torino,40,6554,7392,418,20,13,0,0,14397,4955,8962,796,90,11,0,0,14814,29211
1,Torino,41,6600,8018,514,18,12,0,0,15162,4922,9706,910,97,7,0,0,15642,30804
1,Torino,42,6530,8637,583,20,15,0,0,15785,4849,10240,1128,121,14,1,0,16353,32138
1,Torino,43,6569,9465,737,26,26,0,0,16823,4920,11047,1241,155,17,0,0,17380,34203
1,Torino,44,6603,10337,883,33,23,1,0,17880,4772,11772,1455,153,14,0,0,18166,36046
1,Torino,45,6285,10511,939,40,31,0,0,17806,4581,11720,1492,174,11,0,0,17978,35784
1,Torino,46,5968,11120,1024,65,17,0,1,18195,4145,12274,1743,201,8,0,0,18371,36566
1,Torino,47,5700,11174,1127,59,24,0,0,18084,3947,12903,1760,256,9,1,0,18876,36960
1,Torino,48,5360,11494,1187,57,18,0,0,18116,3811,12698,1909,325,11,0,0,18754,36870
1,Torino,49,5142,11920,1318,85,20,0,0,18485,3513,13358,1973,341,7,0,0,19192,37677
1,Torino,50,4683,12343,1342,89,20,0,0,18477,3153,13240,2066,426,11,0,0,18896,37373
1,Torino,51,4298,12376,1378,111,27,0,0,18190,3126,13289,2115,441,16,1,0,18988,37178
1,Torino,52,4120,12473,1540,132,20,1,1,18287,2780,13347,2069,512,9,0,0,18717,37004
1,Torino,53,3748,12379,1531,142,24,0,0,17824,2633,13223,2182,599,10,0,0,18647,36471
1,Torino,54,3528,12743,1623,143,19,0,0,18056,2490,13607,2209,665,9,1,0,18981,37037
1,Torino,55,3043,12012,1497,174,23,0,1,16750,2225,12917,2049,696,4,0,0,17891,34641
1,Torino,56,2621,11650,1432,223,20,0,1,15947,1987,12548,1985,780,5,0,0,17305,33252
1,Torino,57,2460,11750,1408,173,18,0,1,15810,1789,12538,1886,886,2,0,0,17101,32911
1,Torino,58,2188,11453,1396,202,14,0,1,15254,1571,12016,1901,1003,5,0,0,16496,31750
1,Torino,59,2077,11415,1378,246,17,1,0,15134,1498,11933,1739,997,3,0,0,16170,31304
1,Torino,60,1959,11174,1241,273,11,0,0,14658,1398,11673,1646,1128,7,1,0,15853,30511
1,Torino,61,1769,11242,1254,288,15,0,0,14568,1293,11499,1545,1324,6,0,0,15667,30235
1,Torino,62,1604,11182,1138,350,14,0,0,14288,1219,11325,1543,1398,7,0,0,15492,29780
1,Torino,63,1508,10926,1024,381,15,0,0,13854,1124,11010,1390,1549,3,1,0,15077,28931
1,Torino,64,1421,10786,1017,403,8,0,0,13635,1055,10849,1282,1718,2,0,0,14906,28541
1,Torino,65,1272,10373,878,412,7,1,1,12944,919,10387,1201,1830,5,0,0,14342,27286
1,Torino,66,1154,10452,839,480,6,0,0,12931,926,10310,1074,2002,9,0,0,14321,27252
1,Torino,67,1119,10090,763,518,4,0,0,12494,836,10149,1030,2248,3,0,0,14266,26760
1,Torino,68,1074,10536,764,529,10,0,0,12913,821,10408,1015,2566,1,0,0,14811,27724
1,Torino,69,995,10904,700,659,7,0,0,13265,817,10504,926,2790,1,0,0,15038,28303
1,Torino,70,1043,11481,687,761,8,0,2,13982,853,10778,954,3308,2,0,0,15895,29877
1,Torino,71,935,11412,616,804,9,0,0,13776,775,10444,881,3438,1,0,0,15539,29315
1,Torino,72,865,11067,576,864,5,0,0,13377,743,9853,840,3852,0,0,0,15288,28665
1,Torino,73,679,8491,402,710,6,0,0,10288,559,7444,539,3245,0,0,0,11787,22075
1,Torino,74,641,8726,397,857,5,0,0,10626,633,7631,587,3747,0,0,0,12598,23224
1,Torino,75,654,8426,341,890,2,0,0,10313,629,7325,583,4088,0,0,0,12625,22938
1,Torino,76,670,8353,296,1063,9,0,0,10391,647,6860,551,4480,2,0,0,12540,22931
1,Torino,77,631,8121,284,1017,2,0,0,10055,663,6566,464,4908,0,0,0,12601,22656
1,Torino,78,640,8711,317,1290,4,0,0,10962,709,6821,448,5796,2,0,0,13776,24738
1,Torino,79,608,8386,238,1386,2,0,0,10620,731,6233,432,6098,1,0,0,13495,24115
1,Torino,80,542,7839,227,1429,3,0,0,10040,660,5542,417,6246,0,0,0,12865,22905
1,Torino,81,470,6679,207,1441,4,0,1,8802,636,4615,343,6083,0,0,0,11677,20479
1,Torino,82,374,5832,137,1379,1,0,0,7723,624,3755,293,5927,0,0,0,10599,18322
1,Torino,83,359,5329,130,1402,2,0,0,7222,605,3295,256,6223,0,0,0,10379,17601
1,Torino,84,308,4642,98,1295,2,0,0,6345,510,2646,218,6232,1,0,0,9607,15952
1,Torino,85,244,3869,81,1275,0,0,0,5469,506,2127,184,5923,0,0,0,8740,14209
1,Torino,86,240,3284,72,1221,0,0,0,4817,481,1694,149,5793,0,0,0,8117,12934
1,Torino,87,211,2822,55,1216,1,0,0,4305,474,1310,141,5605,0,0,0,7530,11835
1,Torino,88,181,2432,38,1121,2,0,0,3774,469,1087,124,5299,0,0,0,6979,10753
1,Torino,89,133,1762,40,930,0,0,0,2865,412,737,101,4600,0,0,0,5850,8715
1,Torino,90,96,1285,23,816,0,0,0,2220,337,508,82,3866,3,0,0,4796,7016
1,Torino,91,89,925,19,685,0,0,0,1718,305,345,61,3340,0,0,0,4051,5769
1,Torino,92,59,638,12,523,1,0,0,1233,245,218,40,2802,0,0,0,3305,4538
1,Torino,93,42,409,3,426,0,0,0,880,229,138,48,2239,0,0,0,2654,3534
1,Torino,94,29,257,1,326,0,0,0,613,185,77,26,1696,0,0,0,1984,2597
1,Torino,95,23,193,8,257,0,0,0,481,126,42,25,1376,0,0,0,1569,2050
1,Torino,96,24,109,1,170,0,0,0,304,110,42,11,1068,0,0,0,1231,1535
1,Torino,97,10,73,2,115,0,0,0,200,90,9,18,749,0,0,0,866,1066
1,Torino,98,5,46,0,80,0,0,0,131,52,13,10,479,0,0,0,554,685
1,Torino,99,1,13,0,29,0,0,0,43,27,4,4,226,0,0,0,261,304
1,Torino,100,4,13,1,46,0,0,0,64,40,3,4,378,0,0,0,425,489
2,Vercelli,0,512,0,0,0,0,0,0,512,553,0,0,0,0,0,0,553,1065
2,Vercelli,1,572,0,0,0,0,0,0,572,567,0,0,0,0,0,0,567,1139
2,Vercelli,2,602,0,0,0,0,0,0,602,572,0,0,0,0,0,0,572,1174
2,Vercelli,3,615,0,0,0,0,0,0,615,575,0,0,0,0,0,0,575,1190
2,Vercelli,4,660,0,0,0,0,0,0,660,583,0,0,0,0,0,0,583,1243
2,Vercelli,5,621,0,0,0,0,0,0,621,636,0,0,0,0,0,0,636,1257
2,Vercelli,6,705,0,0,0,0,0,0,705,662,0,0,0,0,0,0,662,1367
2,Vercelli,7,672,0,0,0,0,0,0,672,621,0,0,0,0,0,0,621,1293
2,Vercelli,8,716,0,0,0,0,0,0,716,630,0,0,0,0,0,0,630,1346
2,Vercelli,9,737,0,0,0,0,0,0,737,691,0,0,0,0,0,0,691,1428
2,Vercelli,10,693,0,0,0,0,0,0,693,699,0,0,0,0,0,0,699,1392
2,Vercelli,11,771,0,0,0,0,0,0,771,701,0,0,0,0,0,0,701,1472
2,Vercelli,12,716,0,0,0,0,0,0,716,688,0,0,0,0,0,0,688,1404
2,Vercelli,13,685,0,0,0,0,0,0,685,687,0,0,0,0,0,0,687,1372
2,Vercelli,14,696,0,0,0,0,0,0,696,660,0,0,0,0,0,0,660,1356
2,Vercelli,15,769,0,0,0,0,0,0,769,663,0,0,0,0,0,0,663,1432
2,Vercelli,16,750,0,0,0,0,0,0,750,714,0,0,0,0,0,0,714,1464
2,Vercelli,17,735,0,1,0,0,0,0,736,658,0,0,0,0,0,0,658,1394
2,Vercelli,18,791,0,0,0,0,0,0,791,693,2,0,0,0,0,0,695,1486
2,Vercelli,19,798,2,0,0,0,0,0,800,688,9,0,0,0,0,0,697,1497
2,Vercelli,20,800,3,0,0,0,0,0,803,704,12,0,0,0,0,0,716,1519
2,Vercelli,21,793,1,0,0,0,0,0,794,709,16,1,0,0,0,0,726,1520
2,Vercelli,22,778,7,0,0,0,0,0,785,705,27,0,1,0,0,0,733,1518
2,Vercelli,23,814,9,1,0,0,0,0,824,669,39,0,0,1,0,0,709,1533
2,Vercelli,24,817,13,0,0,0,0,0,830,673,51,0,0,0,0,0,724,1554
2,Vercelli,25,786,34,0,0,0,0,0,820,632,98,1,0,0,0,0,731,1551
2,Vercelli,26,792,52,0,0,0,0,0,844,643,108,1,0,0,0,0,752,1596
2,Vercelli,27,783,77,2,0,1,0,0,863,608,135,1,1,0,0,0,745,1608
2,Vercelli,28,781,75,0,0,1,0,0,857,590,191,6,0,0,0,0,787,1644
2,Vercelli,29,716,110,1,0,3,0,0,830,529,252,4,1,1,0,0,787,1617
2,Vercelli,30,696,170,2,0,0,0,0,868,530,286,6,0,1,0,0,823,1691
2,Vercelli,31,674,191,6,0,1,0,0,872,459,305,8,2,0,0,0,774,1646
2,Vercelli,32,621,195,6,0,2,0,0,824,423,408,16,0,0,0,0,847,1671
2,Vercelli,33,601,287,7,1,1,0,0,897,456,401,20,1,0,0,0,878,1775
2,Vercelli,34,585,296,10,0,2,0,0,893,411,428,10,2,1,0,0,852,1745
2,Vercelli,35,515,309,15,0,0,0,0,839,385,466,26,5,0,0,0,882,1721
2,Vercelli,36,551,414,11,0,1,0,0,977,370,501,27,2,0,0,0,900,1877
2,Vercelli,37,539,423,19,0,1,0,0,982,358,531,23,0,0,0,0,912,1894
2,Vercelli,38,489,433,10,3,0,0,0,935,299,596,26,10,0,0,0,931,1866
2,Vercelli,39,450,524,28,2,0,0,0,1004,301,584,40,4,0,0,0,929,1933
2,Vercelli,40,524,508,38,1,1,0,0,1072,356,655,52,4,1,0,0,1068,2140
2,Vercelli,41,494,531,26,2,1,0,0,1054,313,758,70,11,0,0,0,1152,2206
2,Vercelli,42,474,627,35,5,0,0,0,1141,311,728,72,15,1,0,0,1127,2268
2,Vercelli,43,490,697,41,5,1,0,0,1234,279,794,94,18,0,0,0,1185,2419
2,Vercelli,44,493,667,53,3,0,0,0,1216,280,769,92,15,1,1,0,1158,2374
2,Vercelli,45,448,729,68,2,1,0,0,1248,263,916,78,18,0,0,0,1275,2523
2,Vercelli,46,472,796,65,5,0,0,0,1338,310,894,89,25,4,0,0,1322,2660
2,Vercelli,47,439,842,73,3,1,0,0,1358,278,916,116,16,1,0,0,1327,2685
2,Vercelli,48,410,816,90,1,2,0,0,1319,215,903,142,27,0,0,0,1287,2606
2,Vercelli,49,388,894,100,9,1,0,0,1392,233,1015,122,22,1,0,0,1393,2785
2,Vercelli,50,379,884,100,6,1,0,0,1370,227,964,138,30,0,0,0,1359,2729
2,Vercelli,51,327,938,100,6,1,0,0,1372,191,998,123,49,0,0,0,1361,2733
2,Vercelli,52,328,982,93,8,0,0,0,1411,182,1032,167,51,0,0,0,1432,2843
2,Vercelli,53,302,1030,121,10,2,0,0,1465,200,1090,128,58,0,0,0,1476,2941
2,Vercelli,54,302,1004,123,19,0,0,0,1448,195,1072,145,57,0,0,0,1469,2917
2,Vercelli,55,257,1011,113,12,1,0,0,1394,164,1047,145,49,0,0,0,1405,2799
2,Vercelli,56,271,978,110,20,1,0,0,1380,140,999,149,82,1,0,0,1371,2751
2,Vercelli,57,215,1006,109,13,3,0,0,1346,146,1037,107,103,0,0,0,1393,2739
2,Vercelli,58,212,938,110,25,1,0,0,1286,114,1026,114,108,0,0,0,1362,2648
2,Vercelli,59,201,911,93,24,1,1,0,1231,113,934,108,95,0,0,0,1250,2481
2,Vercelli,60,179,926,69,17,0,0,0,1191,102,972,122,117,0,0,0,1313,2504
2,Vercelli,61,158,889,83,19,4,0,0,1153,83,938,126,108,0,0,0,1255,2408
2,Vercelli,62,157,874,78,34,2,0,0,1145,76,906,111,151,0,0,0,1244,2389
2,Vercelli,63,147,928,84,32,0,0,0,1191,71,897,80,135,0,0,0,1183,2374
2,Vercelli,64,129,865,81,26,0,0,0,1101,91,868,99,143,0,0,0,1201,2302
2,Vercelli,65,120,854,83,33,0,0,0,1090,79,816,69,175,0,0,0,1139,2229
2,Vercelli,66,122,900,69,33,0,0,0,1124,56,803,69,199,0,0,0,1127,2251
2,Vercelli,67,97,879,63,44,0,0,0,1083,47,836,66,187,0,0,0,1136,2219
2,Vercelli,68,122,892,54,52,0,0,0,1120,70,797,66,243,0,0,0,1176,2296
2,Vercelli,69,107,837,57,72,0,0,0,1073,52,845,62,264,0,0,0,1223,2296
2,Vercelli,70,109,916,50,65,0,0,0,1140,57,819,79,290,0,0,0,1245,2385
2,Vercelli,71,92,854,51,73,0,0,0,1070,60,768,67,294,0,0,0,1189,2259
2,Vercelli,72,94,837,39,68,0,0,0,1038,55,705,59,344,0,0,0,1163,2201
2,Vercelli,73,77,563,26,63,0,0,0,729,34,506,26,295,0,0,0,861,1590
2,Vercelli,74,70,635,25,88,0,0,0,818,44,521,46,327,0,0,0,938,1756
2,Vercelli,75,62,555,34,73,1,0,0,725,51,515,25,354,0,0,0,945,1670
2,Vercelli,76,62,597,21,65,0,0,0,745,46,505,35,347,0,0,0,933,1678
2,Vercelli,77,68,592,19,77,0,0,0,756,64,489,23,386,0,0,0,962,1718
2,Vercelli,78,69,696,26,81,0,0,0,872,63,484,30,515,0,0,0,1092,1964
2,Vercelli,79,52,611,14,129,0,0,0,806,65,494,34,556,0,0,0,1149,1955
2,Vercelli,80,63,551,22,115,0,0,0,751,61,423,29,565,0,0,0,1078,1829
2,Vercelli,81,60,493,14,105,0,0,0,672,68,319,19,571,0,0,0,977,1649
2,Vercelli,82,52,420,11,128,0,0,0,611,45,294,18,506,0,0,0,863,1474
2,Vercelli,83,58,401,8,119,0,0,0,586,53,221,14,649,0,0,0,937,1523
2,Vercelli,84,38,364,6,101,0,0,0,509,42,196,10,573,0,0,0,821,1330
2,Vercelli,85,37,294,2,109,0,0,0,442,41,153,12,550,0,0,0,756,1198
2,Vercelli,86,33,255,8,109,0,0,0,405,46,114,7,598,0,0,0,765,1170
2,Vercelli,87,21,252,2,87,0,0,0,362,42,111,6,547,0,0,0,706,1068
2,Vercelli,88,26,194,3,114,0,0,0,337,49,67,6,525,0,0,0,647,984
2,Vercelli,89,18,140,1,87,0,0,0,246,37,58,9,452,0,0,0,556,802
2,Vercelli,90,18,106,1,62,0,0,0,187,26,43,5,383,0,0,0,457,644
2,Vercelli,91,12,64,2,50,0,0,0,128,49,28,4,351,0,0,0,432,560
2,Vercelli,92,8,47,0,45,0,0,0,100,28,21,5,300,0,0,0,354,454
2,Vercelli,93,6,51,0,50,0,0,0,107,19,14,3,226,0,0,0,262,369
2,Vercelli,94,4,29,0,30,0,0,0,63,18,6,1,179,0,0,0,204,267
2,Vercelli,95,4,28,0,28,0,0,0,60,11,3,1,139,0,0,0,154,214
2,Vercelli,96,1,6,0,25,0,0,0,32,13,5,0,105,0,0,0,123,155
2,Vercelli,97,1,6,0,14,0,0,0,21,7,0,3,77,0,0,0,87,108
2,Vercelli,98,1,7,0,10,0,0,0,18,5,0,0,50,0,0,0,55,73
2,Vercelli,99,0,0,0,4,0,0,0,4,0,0,0,29,0,0,0,29,33
2,Vercelli,100,0,0,0,2,0,0,0,2,5,1,0,58,0,0,0,64,66
3,Novara,0,1312,0,0,0,0,0,0,1312,1297,0,0,0,0,0,0,1297,2609
3,Novara,1,1417,0,0,0,0,0,0,1417,1332,0,0,0,0,0,0,1332,2749
3,Novara,2,1488,0,0,0,0,0,0,1488,1397,0,0,0,0,0,0,1397,2885
3,Novara,3,1482,0,0,0,0,0,0,1482,1431,0,0,0,0,0,0,1431,2913
3,Novara,4,1576,0,0,0,0,0,0,1576,1489,0,0,0,0,0,0,1489,3065
3,Novara,5,1595,0,0,0,0,0,0,1595,1574,0,0,0,0,0,0,1574,3169
3,Novara,6,1657,0,0,0,0,0,0,1657,1619,0,0,0,0,0,0,1619,3276
3,Novara,7,1702,0,0,0,0,0,0,1702,1612,0,0,0,0,0,0,1612,3314
3,Novara,8,1708,0,0,0,0,0,0,1708,1600,0,0,0,0,0,0,1600,3308
3,Novara,9,1717,0,0,0,0,0,0,1717,1681,0,0,0,0,0,0,1681,3398
3,Novara,10,1743,0,0,0,0,0,0,1743,1681,0,0,0,0,0,0,1681,3424
3,Novara,11,1783,0,0,0,0,0,0,1783,1791,0,0,0,0,0,0,1791,3574
3,Novara,12,1701,0,0,0,0,0,0,1701,1718,0,0,0,0,0,0,1718,3419
3,Novara,13,1694,0,0,0,0,0,0,1694,1649,0,0,0,0,0,0,1649,3343
3,Novara,14,1723,0,0,0,0,0,0,1723,1611,0,0,0,0,0,0,1611,3334
3,Novara,15,1713,0,0,0,0,0,0,1713,1565,0,0,0,0,0,0,1565,3278
3,Novara,16,1708,0,0,0,0,0,0,1708,1600,0,0,0,0,0,0,1600,3308
3,Novara,17,1726,0,0,0,0,0,0,1726,1504,0,0,0,0,0,0,1504,3230
3,Novara,18,1788,0,0,0,0,0,0,1788,1615,4,0,0,0,0,0,1619,3407
3,Novara,19,1760,1,0,0,0,0,0,1761,1609,19,0,0,0,0,0,1628,3389
3,Novara,20,1868,0,0,0,0,0,0,1868,1569,28,0,0,0,0,0,1597,3465
3,Novara,21,1837,1,0,0,0,0,0,1838,1576,45,0,0,0,0,0,1621,3459
3,Novara,22,1769,10,0,0,0,0,0,1779,1472,73,0,0,0,0,0,1545,3324
3,Novara,23,1810,13,0,0,0,0,0,1823,1522,95,0,0,0,0,0,1617,3440
3,Novara,24,1715,26,1,0,0,0,0,1742,1528,163,1,0,0,0,0,1692,3434
3,Novara,25,1759,69,1,0,0,0,0,1829,1401,227,2,0,0,1,0,1631,3460
3,Novara,26,1748,98,1,0,0,0,0,1847,1562,266,3,2,0,0,0,1833,3680
3,Novara,27,1656,122,2,0,0,0,0,1780,1415,345,1,0,1,0,0,1762,3542
3,Novara,28,1707,166,1,0,1,0,0,1875,1249,452,5,0,0,0,0,1706,3581
3,Novara,29,1601,283,1,0,1,0,0,1886,1209,599,13,2,2,0,0,1825,3711
3,Novara,30,1544,363,9,0,0,0,0,1916,1100,714,15,0,2,0,0,1831,3747
3,Novara,31,1400,481,5,0,1,0,0,1887,986,862,15,4,0,0,0,1867,3754
3,Novara,32,1323,598,14,2,1,0,0,1938,949,907,26,2,0,0,0,1884,3822
3,Novara,33,1261,658,15,0,1,0,0,1935,833,1003,46,1,1,0,0,1884,3819
3,Novara,34,1179,800,21,0,1,0,0,2001,826,1077,47,3,0,0,0,1953,3954
3,Novara,35,1181,948,39,1,2,0,0,2171,806,1287,54,6,2,0,0,2155,4326
3,Novara,36,1185,1014,30,2,1,0,0,2232,796,1289,65,7,1,1,0,2159,4391
3,Novara,37,1172,1087,37,0,1,0,0,2297,749,1408,67,10,0,0,0,2234,4531
3,Novara,38,1099,1189,54,3,1,0,0,2346,715,1367,88,10,1,0,0,2181,4527
3,Novara,39,1061,1259,70,3,0,0,0,2393,700,1493,91,4,2,0,0,2290,4683
3,Novara,40,1058,1408,79,4,2,0,0,2551,690,1599,116,18,0,0,0,2423,4974
3,Novara,41,1068,1506,81,2,1,0,0,2658,716,1738,126,10,1,0,0,2591,5249
3,Novara,42,1082,1566,89,2,2,0,0,2741,711,1898,137,25,0,0,0,2771,5512
3,Novara,43,1144,1660,101,4,1,0,0,2910,705,1947,180,29,0,0,0,2861,5771
3,Novara,44,1032,1798,138,6,1,0,0,2975,664,2046,198,18,1,0,0,2927,5902
3,Novara,45,1014,1870,135,10,2,0,0,3031,632,2029,213,27,1,0,0,2902,5933
3,Novara,46,882,1975,142,11,1,0,0,3011,602,2118,203,26,2,0,0,2951,5962
3,Novara,47,949,2014,156,15,0,1,0,3135,554,2096,237,36,1,0,0,2924,6059
3,Novara,48,799,1932,149,16,1,0,0,2897,504,2143,266,58,1,0,0,2972,5869
3,Novara,49,788,2184,205,11,0,1,0,3189,484,2204,270,57,0,0,0,3015,6204
3,Novara,50,744,2075,186,12,3,1,0,3021,466,2237,267,62,4,1,0,3037,6058
3,Novara,51,683,2160,202,24,1,0,0,3070,407,2225,265,99,0,0,0,2996,6066
3,Novara,52,678,2238,235,21,1,0,0,3173,450,2316,284,75,2,0,0,3127,6300
3,Novara,53,541,2185,239,21,3,0,0,2989,402,2406,322,94,1,0,0,3225,6214
3,Novara,54,535,2267,262,44,0,0,0,3108,356,2489,294,99,0,0,0,3238,6346
3,Novara,55,483,2231,224,22,1,0,0,2961,320,2257,249,129,1,0,0,2956,5917
3,Novara,56,453,2162,201,32,0,0,0,2848,331,2144,224,153,0,0,0,2852,5700
3,Novara,57,394,2197,223,25,0,0,0,2839,276,2176,248,133,1,0,0,2834,5673
3,Novara,58,348,2028,218,28,0,0,0,2622,255,2168,250,194,0,0,0,2867,5489
3,Novara,59,324,2102,170,34,2,0,0,2632,245,2019,222,207,0,0,0,2693,5325
3,Novara,60,299,1956,155,46,0,0,0,2456,191,1914,207,203,1,0,0,2516,4972
3,Novara,61,265,1850,146,63,1,0,0,2325,211,1987,188,199,0,0,0,2585,4910
3,Novara,62,249,1821,149,47,0,0,0,2266,158,1869,184,198,0,0,0,2409,4675
3,Novara,63,241,1879,125,65,1,0,0,2311,137,1889,162,267,0,0,0,2455,4766
3,Novara,64,234,1805,137,62,1,0,0,2239,160,1834,156,286,0,0,0,2436,4675
3,Novara,65,205,1818,109,81,2,0,0,2215,135,1677,138,295,0,0,0,2245,4460
3,Novara,66,184,1819,123,66,0,0,0,2192,128,1700,135,337,0,0,0,2300,4492
3,Novara,67,164,1744,94,78,0,0,0,2080,128,1625,117,335,1,0,0,2206,4286
3,Novara,68,168,1833,68,99,0,0,0,2168,131,1664,124,430,0,0,0,2349,4517
3,Novara,69,160,1773,72,97,0,0,0,2102,110,1666,128,470,0,0,0,2374,4476
3,Novara,70,165,1782,83,119,0,0,0,2149,105,1624,111,544,1,0,0,2385,4534
3,Novara,71,142,1692,88,119,0,0,0,2041,133,1547,107,604,0,0,0,2391,4432
3,Novara,72,114,1667,87,142,3,0,0,2013,102,1413,99,608,1,0,0,2223,4236
3,Novara,73,80,1203,49,108,0,0,0,1440,84,1053,73,546,0,0,0,1756,3196
3,Novara,74,88,1271,47,120,0,0,0,1526,90,1048,69,599,0,0,0,1806,3332
3,Novara,75,99,1159,36,134,0,0,0,1428,84,979,69,694,0,0,0,1826,3254
3,Novara,76,91,1164,51,137,0,0,0,1443,101,958,58,687,0,0,0,1804,3247
3,Novara,77,89,1125,36,147,0,0,0,1397,111,989,55,805,0,0,0,1960,3357
3,Novara,78,91,1175,41,174,0,0,0,1481,101,996,47,961,0,0,0,2105,3586
3,Novara,79,103,1156,41,203,0,0,0,1503,134,886,55,980,0,0,0,2055,3558
3,Novara,80,91,1119,28,200,0,0,0,1438,105,772,47,1040,0,0,0,1964,3402
3,Novara,81,68,954,26,193,0,0,0,1241,111,684,27,1020,0,0,0,1842,3083
3,Novara,82,50,833,21,201,0,0,0,1105,98,517,26,984,0,0,0,1625,2730
3,Novara,83,53,806,19,193,0,0,0,1071,99,399,26,1048,0,0,0,1572,2643
3,Novara,84,45,650,14,188,0,0,0,897,70,354,21,1019,0,0,0,1464,2361
3,Novara,85,51,567,12,191,0,0,0,821,104,272,16,989,0,0,0,1381,2202
3,Novara,86,39,479,6,181,0,0,0,705,91,220,17,1014,0,0,0,1342,2047
3,Novara,87,41,393,4,156,0,0,0,594,78,172,11,981,0,0,0,1242,1836
3,Novara,88,27,369,4,157,0,0,0,557,107,129,7,900,0,0,0,1143,1700
3,Novara,89,23,254,5,135,0,0,0,417,76,92,8,782,0,0,0,958,1375
3,Novara,90,19,196,1,128,0,0,0,344,69,68,5,693,0,0,0,835,1179
3,Novara,91,12,158,2,95,0,0,0,267,56,40,5,623,0,0,0,724,991
3,Novara,92,5,84,1,88,0,0,0,178,52,27,8,492,0,0,0,579,757
3,Novara,93,6,54,0,73,0,0,0,133,42,20,3,396,0,0,0,461,594
3,Novara,94,11,57,1,53,0,0,0,122,41,11,2,308,0,0,0,362,484
3,Novara,95,2,22,0,44,0,0,0,68,24,15,1,251,0,0,0,291,359
3,Novara,96,4,21,0,36,0,0,0,61,21,2,1,216,0,0,0,240,301
3,Novara,97,1,4,0,19,0,0,0,24,10,1,2,152,0,0,0,165,189
3,Novara,98,0,3,1,11,0,0,0,15,12,0,0,91,0,0,0,103,118
3,Novara,99,0,4,0,4,0,0,0,8,5,0,0,43,0,0,0,48,56
3,Novara,100,1,1,0,7,0,0,0,9,10,0,0,66,0,0,0,76,85
4,Cuneo,0,2286,0,0,0,0,0,0,2286,2194,0,0,0,0,0,0,2194,4480
4,Cuneo,1,2360,0,0,0,0,0,0,2360,2353,0,0,0,0,0,0,2353,4713
4,Cuneo,2,2516,0,0,0,0,0,0,2516,2403,0,0,0,0,0,0,2403,4919
4,Cuneo,3,2602,0,0,0,0,0,0,2602,2321,0,0,0,0,0,0,2321,4923
4,Cuneo,4,2643,0,0,0,0,0,0,2643,2500,0,0,0,0,0,0,2500,5143
4,Cuneo,5,2700,0,0,0,0,0,0,2700,2552,0,0,0,0,0,0,2552,5252
4,Cuneo,6,2747,0,0,0,0,0,0,2747,2564,0,0,0,0,0,0,2564,5311
4,Cuneo,7,2850,0,0,0,0,0,0,2850,2488,0,0,0,0,0,0,2488,5338
4,Cuneo,8,2784,0,0,0,0,0,0,2784,2630,0,0,0,0,0,0,2630,5414
4,Cuneo,9,2820,0,0,0,0,0,0,2820,2787,0,0,0,0,0,0,2787,5607
4,Cuneo,10,2864,0,0,0,0,0,0,2864,2677,0,0,0,0,0,0,2677,5541
4,Cuneo,11,2809,0,0,0,0,0,0,2809,2696,0,0,0,0,0,0,2696,5505
4,Cuneo,12,2772,0,0,0,0,0,0,2772,2661,0,0,0,0,0,0,2661,5433
4,Cuneo,13,2848,0,0,0,0,0,0,2848,2599,0,0,0,0,0,0,2599,5447
4,Cuneo,14,2798,0,0,0,0,0,0,2798,2619,0,0,0,0,0,0,2619,5417
4,Cuneo,15,2732,0,0,0,0,0,0,2732,2612,0,0,0,0,0,0,2612,5344
4,Cuneo,16,2720,0,0,0,0,0,0,2720,2571,0,0,0,0,0,0,2571,5291
4,Cuneo,17,2849,0,0,0,0,0,0,2849,2703,1,1,0,0,0,0,2705,5554
4,Cuneo,18,2992,0,0,0,0,0,0,2992,2793,5,0,0,0,0,0,2798,5790
4,Cuneo,19,2994,1,0,0,0,0,0,2995,2664,29,1,0,0,0,0,2694,5689
4,Cuneo,20,3222,2,0,0,0,0,0,3224,2651,66,1,0,0,0,0,2718,5942
4,Cuneo,21,3112,19,1,0,0,0,0,3132,2688,107,2,0,0,0,0,2797,5929
4,Cuneo,22,3210,22,0,0,0,0,0,3232,2568,151,0,0,0,0,0,2719,5951
4,Cuneo,23,3036,35,0,0,0,0,0,3071,2618,232,2,0,0,0,0,2852,5923
4,Cuneo,24,2866,82,2,0,1,0,0,2951,2538,343,4,0,0,0,0,2885,5836
4,Cuneo,25,2900,121,3,0,0,0,0,3024,2394,447,4,1,0,0,0,2846,5870
4,Cuneo,26,2953,211,0,0,0,0,0,3164,2362,657,6,0,0,0,0,3025,6189
4,Cuneo,27,2741,364,2,0,1,0,0,3108,2166,778,12,1,0,0,0,2957,6065
4,Cuneo,28,2689,482,8,0,1,0,0,3180,1993,1033,20,1,0,0,0,3047,6227
4,Cuneo,29,2556,631,12,2,4,0,0,3205,1756,1217,24,3,0,0,0,3000,6205
4,Cuneo,30,2401,775,10,2,2,0,0,3190,1694,1361,32,0,1,0,0,3088,6278
4,Cuneo,31,2051,1013,11,1,1,0,0,3077,1479,1539,47,3,2,0,0,3070,6147
4,Cuneo,32,2023,1134,27,1,2,0,0,3187,1340,1683,59,4,1,0,0,3087,6274
4,Cuneo,33,1980,1257,21,1,2,0,0,3261,1304,1682,62,8,3,0,0,3059,6320
4,Cuneo,34,1819,1360,41,0,3,0,0,3223,1228,1864,68,5,2,0,0,3167,6390
4,Cuneo,35,1765,1604,55,4,2,0,0,3430,1216,1869,95,9,3,0,0,3192,6622
4,Cuneo,36,1702,1724,53,1,2,0,0,3482,1182,2066,102,9,1,0,0,3360,6842
4,Cuneo,37,1619,1714,82,3,1,0,0,3419,1063,2140,134,11,2,0,0,3350,6769
4,Cuneo,38,1610,1882,70,1,2,0,0,3565,1047,2340,151,23,2,0,0,3563,7128
4,Cuneo,39,1491,1985,76,5,3,1,0,3561,975,2331,169,21,1,1,0,3498,7059
4,Cuneo,40,1567,2132,104,4,1,0,0,3808,945,2437,189,29,0,0,0,3600,7408
4,Cuneo,41,1490,2272,118,5,2,0,0,3887,983,2531,204,28,4,0,0,3750,7637
4,Cuneo,42,1476,2461,163,6,1,0,0,4107,896,2805,241,28,1,0,0,3971,8078
4,Cuneo,43,1461,2629,167,8,0,0,0,4265,969,2906,280,37,5,0,0,4197,8462
4,Cuneo,44,1410,2774,195,7,5,0,0,4391,928,3188,309,39,1,0,0,4465,8856
4,Cuneo,45,1488,2830,231,4,1,0,0,4554,897,3107,333,61,2,0,0,4400,8954
4,Cuneo,46,1314,2952,239,12,3,0,0,4520,882,3200,355,57,1,0,0,4495,9015
4,Cuneo,47,1294,2995,287,16,1,0,0,4593,795,3355,365,74,1,1,0,4591,9184
4,Cuneo,48,1147,3018,257,20,1,0,0,4443,766,3255,359,66,3,0,0,4449,8892
4,Cuneo,49,1129,3215,315,18,4,0,0,4681,722,3405,415,79,1,0,0,4622,9303
4,Cuneo,50,1059,3318,305,28,7,0,0,4717,686,3495,430,95,0,0,0,4706,9423
4,Cuneo,51,1026,3303,325,26,2,0,0,4682,692,3453,416,124,2,0,0,4687,9369
4,Cuneo,52,1026,3277,328,36,2,0,0,4669,661,3530,415,119,1,0,0,4726,9395
4,Cuneo,53,914,3502,352,36,5,0,0,4809,598,3512,399,181,1,1,0,4692,9501
4,Cuneo,54,838,3525,375,59,2,0,0,4799,572,3722,435,169,0,0,0,4898,9697
4,Cuneo,55,807,3249,316,60,1,0,0,4433,511,3294,433,183,3,0,0,4424,8857
4,Cuneo,56,723,3227,299,50,2,0,0,4301,465,3308,393,240,1,0,0,4407,8708
4,Cuneo,57,684,3110,332,38,3,0,0,4167,437,3212,369,225,0,0,0,4243,8410
4,Cuneo,58,588,3151,318,64,3,0,0,4124,419,3092,349,272,0,0,0,4132,8256
4,Cuneo,59,627,3067,286,70,2,0,0,4052,356,3074,348,306,0,0,0,4084,8136
4,Cuneo,60,552,3078,249,61,0,0,0,3940,341,2849,278,293,0,0,0,3761,7701
4,Cuneo,61,568,2975,250,91,4,0,0,3888,289,2963,308,325,0,0,0,3885,7773
4,Cuneo,62,477,2863,239,79,2,0,0,3660,294,2860,275,405,1,0,0,3835,7495
4,Cuneo,63,458,2906,239,95,0,0,0,3698,289,2747,249,442,0,0,0,3727,7425
4,Cuneo,64,426,2749,222,118,1,0,0,3516,237,2751,224,490,0,0,0,3702,7218
4,Cuneo,65,432,2758,190,114,2,0,0,3496,255,2632,236,453,0,0,0,3576,7072
4,Cuneo,66,443,2777,221,133,0,0,0,3574,244,2550,225,552,1,0,0,3572,7146
4,Cuneo,67,418,2663,178,117,0,0,0,3376,223,2586,191,539,0,0,0,3539,6915
4,Cuneo,68,429,2812,151,145,0,0,0,3537,204,2619,184,634,0,0,0,3641,7178
4,Cuneo,69,399,2826,150,161,0,0,0,3536,223,2535,177,708,0,0,0,3643,7179
4,Cuneo,70,387,2835,165,194,1,0,0,3582,208,2568,149,868,0,0,0,3793,7375
4,Cuneo,71,350,2745,154,204,1,0,0,3454,207,2384,140,871,0,0,0,3602,7056
4,Cuneo,72,336,2513,131,199,0,0,0,3179,188,2232,108,885,0,0,0,3413,6592
4,Cuneo,73,281,1948,85,169,0,0,0,2483,151,1676,102,771,0,0,0,2700,5183
4,Cuneo,74,310,2061,92,222,1,0,0,2686,162,1763,93,903,0,0,0,2921,5607
4,Cuneo,75,295,2063,67,211,0,0,0,2636,170,1608,95,1038,0,0,0,2911,5547
4,Cuneo,76,309,1987,73,232,0,0,0,2601,182,1621,93,1122,0,0,0,3018,5619
4,Cuneo,77,323,1913,80,258,0,0,0,2574,199,1525,71,1259,0,0,0,3054,5628
4,Cuneo,78,347,1971,54,280,0,0,0,2652,193,1525,56,1427,0,0,0,3201,5853
4,Cuneo,79,301,1926,53,303,0,0,0,2583,202,1307,60,1536,0,0,0,3105,5688
4,Cuneo,80,300,1817,44,345,1,0,0,2507,188,1233,67,1601,0,0,0,3089,5596
4,Cuneo,81,275,1561,36,304,0,0,0,2176,198,1002,51,1547,0,0,0,2798,4974
4,Cuneo,82,199,1333,23,307,0,0,0,1862,174,765,38,1519,0,0,0,2496,4358
4,Cuneo,83,216,1269,26,304,0,0,0,1815,212,680,25,1604,0,0,0,2521,4336
4,Cuneo,84,189,1076,16,318,0,0,0,1599,179,578,24,1591,0,0,0,2372,3971
4,Cuneo,85,157,815,19,292,0,0,0,1283,170,428,33,1505,0,0,0,2136,3419
4,Cuneo,86,137,804,22,263,0,0,0,1226,151,341,20,1525,0,0,0,2037,3263
4,Cuneo,87,123,676,12,260,0,0,0,1071,164,267,19,1439,0,0,0,1889,2960
4,Cuneo,88,124,584,11,310,0,0,0,1029,166,218,15,1448,0,0,0,1847,2876
4,Cuneo,89,83,430,4,237,0,0,0,754,170,152,16,1175,0,0,0,1513,2267
4,Cuneo,90,64,308,5,167,0,0,0,544,144,91,8,1103,0,0,0,1346,1890
4,Cuneo,91,64,247,5,188,0,0,0,504,119,72,13,930,0,0,0,1134,1638
4,Cuneo,92,39,157,1,120,0,0,0,317,87,54,11,785,0,0,0,937,1254
4,Cuneo,93,23,106,2,107,0,0,0,238,88,23,8,645,0,0,0,764,1002
4,Cuneo,94,16,74,0,82,0,0,0,172,68,11,5,497,0,0,0,581,753
4,Cuneo,95,15,42,1,78,0,0,0,136,38,13,4,366,0,0,0,421,557
4,Cuneo,96,10,25,0,50,0,0,0,85,43,3,7,271,0,0,0,324,409
4,Cuneo,97,9,22,0,32,0,0,0,63,39,2,2,205,0,0,0,248,311
4,Cuneo,98,6,6,0,15,0,0,0,27,16,0,2,122,0,0,0,140,167
4,Cuneo,99,0,2,0,9,0,0,0,11,11,1,1,69,0,0,0,82,93
4,Cuneo,100,1,1,0,12,0,0,0,14,16,0,0,106,0,0,0,122,136
5,Asti,0,676,0,0,0,0,0,0,676,677,0,0,0,0,0,0,677,1353
5,Asti,1,773,0,0,0,0,0,0,773,780,0,0,0,0,0,0,780,1553
5,Asti,2,794,0,0,0,0,0,0,794,790,0,0,0,0,0,0,790,1584
5,Asti,3,850,0,0,0,0,0,0,850,752,0,0,0,0,0,0,752,1602
5,Asti,4,846,0,0,0,0,0,0,846,809,0,0,0,0,0,0,809,1655
5,Asti,5,883,0,0,0,0,0,0,883,850,0,0,0,0,0,0,850,1733
5,Asti,6,951,0,0,0,0,0,0,951,839,0,0,0,0,0,0,839,1790
5,Asti,7,939,0,0,0,0,0,0,939,853,0,0,0,0,0,0,853,1792
5,Asti,8,900,0,0,0,0,0,0,900,862,0,0,0,0,0,0,862,1762
5,Asti,9,971,0,0,0,0,0,0,971,912,0,0,0,0,0,0,912,1883
5,Asti,10,1001,0,0,0,0,0,0,1001,896,0,0,0,0,0,0,896,1897
5,Asti,11,1044,0,0,0,0,0,0,1044,865,0,0,0,0,0,0,865,1909
5,Asti,12,937,0,0,0,0,0,0,937,951,0,0,0,0,0,0,951,1888
5,Asti,13,992,0,0,0,0,0,0,992,933,0,0,0,0,0,0,933,1925
5,Asti,14,971,0,0,0,0,0,0,971,920,0,0,0,0,0,0,920,1891
5,Asti,15,971,0,0,0,0,0,0,971,903,0,0,0,0,0,0,903,1874
5,Asti,16,949,0,0,0,0,0,0,949,978,0,0,0,0,0,0,978,1927
5,Asti,17,928,0,0,0,0,0,0,928,946,0,0,0,0,0,0,946,1874
5,Asti,18,1022,0,0,0,0,0,0,1022,884,0,0,0,0,0,0,884,1906
5,Asti,19,1023,1,0,0,0,0,0,1024,928,8,0,0,0,0,0,936,1960
5,Asti,20,1105,0,0,0,0,0,0,1105,922,18,0,0,0,0,0,940,2045
5,Asti,21,1009,1,2,0,0,0,0,1012,893,33,1,0,0,0,0,927,1939
5,Asti,22,1037,6,0,0,1,0,0,1044,820,58,0,0,0,0,0,878,1922
5,Asti,23,1026,14,0,0,1,0,0,1041,864,77,2,0,0,0,0,943,1984
5,Asti,24,1012,20,1,0,1,0,0,1034,819,113,1,0,0,0,0,933,1967
5,Asti,25,1020,62,4,0,0,0,0,1086,791,135,1,1,1,0,0,929,2015
5,Asti,26,947,74,1,0,1,0,0,1023,766,172,2,0,2,0,0,942,1965
5,Asti,27,910,102,2,0,1,0,0,1015,721,223,0,0,0,0,0,944,1959
5,Asti,28,945,130,2,0,1,0,0,1078,727,293,9,0,1,0,0,1030,2108
5,Asti,29,875,192,0,0,0,0,0,1067,593,350,8,3,1,0,0,955,2022
5,Asti,30,852,265,1,1,0,0,0,1119,602,451,8,3,0,0,0,1064,2183
5,Asti,31,708,303,5,0,1,0,0,1017,496,507,17,2,1,0,0,1023,2040
5,Asti,32,700,355,5,0,3,0,0,1063,521,492,19,2,0,0,0,1034,2097
5,Asti,33,680,362,12,0,1,0,0,1055,501,593,30,3,0,0,0,1127,2182
5,Asti,34,652,433,13,1,2,0,0,1101,452,560,32,1,1,0,0,1046,2147
5,Asti,35,580,497,23,1,1,0,0,1102,445,649,37,3,4,0,0,1138,2240
5,Asti,36,573,529,16,1,1,0,0,1120,406,710,38,7,2,0,0,1163,2283
5,Asti,37,544,569,21,0,0,0,0,1134,399,731,67,3,0,0,0,1200,2334
5,Asti,38,593,633,29,1,2,0,0,1258,375,761,59,7,0,1,0,1203,2461
5,Asti,39,561,643,48,0,2,0,0,1254,392,793,51,8,1,0,0,1245,2499
5,Asti,40,569,766,24,1,1,0,0,1361,378,865,74,9,2,0,0,1328,2689
5,Asti,41,544,811,45,5,0,0,0,1405,400,978,76,3,0,0,0,1457,2862
5,Asti,42,596,864,59,2,2,0,0,1523,360,976,100,12,4,0,0,1452,2975
5,Asti,43,561,951,72,3,1,0,0,1588,380,1097,99,11,1,0,0,1588,3176
5,Asti,44,592,1003,77,4,3,0,0,1679,374,1129,114,24,5,0,0,1646,3325
5,Asti,45,563,968,90,3,2,0,0,1626,319,1042,130,21,2,0,0,1514,3140
5,Asti,46,511,1070,94,5,3,0,0,1683,339,1172,163,26,1,0,0,1701,3384
5,Asti,47,479,1066,113,7,3,0,0,1668,316,1232,139,28,1,0,0,1716,3384
5,Asti,48,450,1124,117,5,2,0,0,1698,277,1194,147,35,3,0,0,1656,3354
5,Asti,49,486,1202,126,7,1,0,0,1822,299,1245,188,27,1,0,0,1760,3582
5,Asti,50,407,1158,141,14,3,0,0,1723,256,1258,163,36,1,0,0,1714,3437
5,Asti,51,414,1206,122,11,4,0,0,1757,248,1266,194,45,1,0,0,1754,3511
5,Asti,52,399,1225,129,16,0,0,0,1769,260,1336,184,49,0,0,0,1829,3598
5,Asti,53,341,1298,137,12,4,0,0,1792,245,1265,178,49,1,0,0,1738,3530
5,Asti,54,367,1251,126,12,4,0,0,1760,245,1278,186,67,2,0,0,1778,3538
5,Asti,55,288,1202,146,18,0,0,0,1654,192,1273,190,79,1,0,0,1735,3389
5,Asti,56,250,1225,113,13,1,0,0,1602,181,1180,152,70,1,0,0,1584,3186
5,Asti,57,264,1194,126,23,0,0,0,1607,155,1253,144,89,1,0,0,1642,3249
5,Asti,58,252,1145,155,27,1,0,0,1580,144,1208,152,106,1,0,0,1611,3191
5,Asti,59,232,1155,133,34,2,0,0,1556,124,1130,148,95,0,0,0,1497,3053
5,Asti,60,213,1153,102,19,1,0,0,1488,101,1072,127,122,2,0,0,1424,2912
5,Asti,61,182,1108,124,33,0,0,0,1447,111,1166,149,142,0,0,0,1568,3015
5,Asti,62,190,1108,116,36,0,0,0,1450,112,1124,105,146,1,0,0,1488,2938
5,Asti,63,175,1080,96,26,2,0,0,1379,105,1099,112,157,1,0,0,1474,2853
5,Asti,64,155,1115,103,44,0,0,0,1417,76,1042,122,181,2,0,0,1423,2840
5,Asti,65,133,1045,110,36,0,0,0,1324,73,1055,78,187,0,0,0,1393,2717
5,Asti,66,145,1075,73,48,0,0,0,1341,68,1029,84,184,2,0,0,1367,2708
5,Asti,67,121,1025,69,47,3,0,0,1265,83,989,80,229,0,0,0,1381,2646
5,Asti,68,128,1140,74,68,3,0,0,1413,75,1023,84,245,0,0,0,1427,2840
5,Asti,69,115,1121,68,45,0,0,0,1349,60,1084,74,289,0,0,0,1507,2856
5,Asti,70,120,1198,58,76,2,0,0,1454,71,1094,71,347,0,0,0,1583,3037
5,Asti,71,108,1184,73,89,1,0,0,1455,71,992,80,330,1,0,0,1474,2929
5,Asti,72,103,1041,55,95,0,0,0,1294,64,946,63,365,0,0,0,1438,2732
5,Asti,73,79,775,42,67,0,0,0,963,59,615,43,305,1,0,0,1023,1986
5,Asti,74,93,799,28,72,0,0,0,992,46,635,40,368,0,0,0,1089,2081
5,Asti,75,82,797,21,85,0,0,0,985,55,701,38,402,0,0,0,1196,2181
5,Asti,76,69,787,26,92,1,0,0,975,35,627,33,419,0,0,0,1114,2089
5,Asti,77,102,715,13,96,1,0,0,927,52,557,34,440,0,0,0,1083,2010
5,Asti,78,84,779,20,119,0,0,0,1002,50,591,23,551,0,0,0,1215,2217
5,Asti,79,90,688,26,123,1,0,0,928,54,595,36,599,0,0,0,1284,2212
5,Asti,80,78,699,19,133,0,0,0,929,46,508,19,645,0,0,0,1218,2147
5,Asti,81,57,637,13,136,0,0,0,843,52,442,26,615,0,0,0,1135,1978
5,Asti,82,48,559,18,142,0,0,0,767,51,305,14,614,0,0,0,984,1751
5,Asti,83,53,506,11,132,0,0,0,702,53,295,20,693,0,0,0,1061,1763
5,Asti,84,46,471,9,142,0,0,0,668,50,213,10,641,0,0,0,914,1582
5,Asti,85,43,364,9,152,0,0,0,568,35,188,12,567,0,0,0,802,1370
5,Asti,86,41,328,5,126,0,0,0,500,56,185,10,598,0,0,0,849,1349
5,Asti,87,40,269,6,126,0,0,0,441,51,140,11,625,0,0,0,827,1268
5,Asti,88,37,245,7,111,0,0,0,400,56,108,6,681,0,0,0,851,1251
5,Asti,89,23,226,8,95,0,0,0,352,42,72,10,545,0,0,0,669,1021
5,Asti,90,17,141,2,77,1,0,0,238,41,48,7,457,0,0,0,553,791
5,Asti,91,24,106,1,91,0,0,0,222,29,33,6,405,0,0,0,473,695
5,Asti,92,14,79,2,64,0,0,0,159,29,24,4,358,0,0,0,415,574
5,Asti,93,11,57,3,38,0,0,0,109,22,19,3,274,0,0,0,318,427
5,Asti,94,14,44,0,37,0,0,0,95,16,10,2,225,0,0,0,253,348
5,Asti,95,5,23,0,38,0,0,0,66,14,8,2,168,0,0,0,192,258
5,Asti,96,5,13,0,26,0,0,0,44,17,3,5,155,0,0,0,180,224
5,Asti,97,5,3,0,16,0,0,0,24,11,2,0,107,0,0,0,120,144
5,Asti,98,1,8,0,6,0,0,0,15,2,1,0,71,0,0,0,74,89
5,Asti,99,0,0,0,7,0,0,0,7,3,3,0,24,0,0,0,30,37
5,Asti,100,2,2,0,7,0,0,0,11,3,0,0,55,0,0,0,58,69
6,Alessandria,0,1261,0,0,0,0,0,0,1261,1237,0,0,0,0,0,0,1237,2498
6,Alessandria,1,1350,0,0,0,0,0,0,1350,1329,0,0,0,0,0,0,1329,2679
6,Alessandria,2,1416,0,0,0,0,0,0,1416,1376,0,0,0,0,0,0,1376,2792
6,Alessandria,3,1505,0,0,0,0,0,0,1505,1343,0,0,0,0,0,0,1343,2848
6,Alessandria,4,1525,0,0,0,0,0,0,1525,1429,0,0,0,0,0,0,1429,2954
6,Alessandria,5,1573,0,0,0,0,0,0,1573,1436,0,0,0,0,0,0,1436,3009
6,Alessandria,6,1673,0,0,0,0,0,0,1673,1528,0,0,0,0,0,0,1528,3201
6,Alessandria,7,1667,0,0,0,0,0,0,1667,1573,0,0,0,0,0,0,1573,3240
6,Alessandria,8,1731,0,0,0,0,0,0,1731,1611,0,0,0,0,0,0,1611,3342
6,Alessandria,9,1758,0,0,0,0,0,0,1758,1661,0,0,0,0,0,0,1661,3419
6,Alessandria,10,1792,0,0,0,0,0,0,1792,1698,0,0,0,0,0,0,1698,3490
6,Alessandria,11,1775,0,0,0,0,0,0,1775,1693,0,0,0,0,0,0,1693,3468
6,Alessandria,12,1740,0,0,0,0,0,0,1740,1665,0,0,0,0,0,0,1665,3405
6,Alessandria,13,1734,0,0,0,0,0,0,1734,1573,0,0,0,0,0,0,1573,3307
6,Alessandria,14,1732,0,0,0,0,0,0,1732,1680,0,0,0,0,0,0,1680,3412
6,Alessandria,15,1739,0,0,0,0,0,0,1739,1621,0,0,0,0,0,0,1621,3360
6,Alessandria,16,1677,0,0,0,0,0,0,1677,1674,0,0,0,0,0,0,1674,3351
6,Alessandria,17,1784,0,0,0,0,0,0,1784,1611,0,0,0,0,0,0,1611,3395
6,Alessandria,18,1751,1,0,0,0,0,0,1752,1665,1,0,0,0,0,0,1666,3418
6,Alessandria,19,1961,1,0,0,0,0,0,1962,1585,16,0,0,0,0,0,1601,3563
6,Alessandria,20,1870,4,0,0,0,0,0,1874,1616,37,0,0,0,0,0,1653,3527
6,Alessandria,21,1951,5,1,0,0,0,0,1957,1642,62,0,0,0,0,0,1704,3661
6,Alessandria,22,1935,22,0,0,0,0,0,1957,1531,88,0,0,2,0,0,1621,3578
6,Alessandria,23,1870,20,0,0,2,0,0,1892,1589,107,3,0,0,0,0,1699,3591
6,Alessandria,24,1879,30,1,0,0,0,0,1910,1592,178,0,0,0,0,0,1770,3680
6,Alessandria,25,1868,49,0,0,0,0,0,1917,1601,222,2,0,0,0,0,1825,3742
6,Alessandria,26,1901,114,0,1,0,0,0,2016,1548,297,2,0,2,0,0,1849,3865
6,Alessandria,27,1790,133,0,0,0,0,0,1923,1526,361,9,1,2,0,0,1899,3822
6,Alessandria,28,1874,212,5,0,4,0,0,2095,1344,475,11,1,2,0,0,1833,3928
6,Alessandria,29,1724,270,3,0,1,0,0,1998,1313,606,15,0,0,0,0,1934,3932
6,Alessandria,30,1600,386,5,0,1,0,0,1992,1236,745,15,3,0,0,0,1999,3991
6,Alessandria,31,1477,522,13,1,1,0,0,2014,1103,803,30,2,4,0,0,1942,3956
6,Alessandria,32,1482,536,11,0,2,0,0,2031,1041,891,27,4,2,0,0,1965,3996
6,Alessandria,33,1449,637,16,1,2,0,0,2105,959,999,40,3,1,0,0,2002,4107
6,Alessandria,34,1352,690,15,0,1,0,0,2058,952,1135,41,2,2,0,0,2132,4190
6,Alessandria,35,1292,862,25,1,2,0,0,2182,948,1127,72,5,0,0,0,2152,4334
6,Alessandria,36,1283,914,41,2,1,0,0,2241,842,1285,75,5,1,0,0,2208,4449
6,Alessandria,37,1201,1050,26,1,1,0,0,2279,849,1324,80,5,0,0,0,2258,4537
6,Alessandria,38,1206,1131,49,2,1,0,0,2389,786,1350,103,12,1,0,0,2252,4641
6,Alessandria,39,1134,1179,53,4,0,0,0,2370,775,1463,98,8,1,0,0,2345,4715
6,Alessandria,40,1197,1319,74,5,3,0,0,2598,805,1660,139,19,1,0,0,2624,5222
6,Alessandria,41,1279,1459,80,2,3,0,0,2823,843,1793,166,20,2,0,0,2824,5647
6,Alessandria,42,1315,1556,103,5,2,0,0,2981,843,1902,167,28,2,0,0,2942,5923
6,Alessandria,43,1273,1653,121,4,1,0,0,3052,812,2005,243,21,3,0,0,3084,6136
6,Alessandria,44,1250,1770,143,8,3,0,0,3174,777,2005,226,30,3,0,0,3041,6215
6,Alessandria,45,1186,1784,151,3,0,0,0,3124,772,2104,212,51,4,0,0,3143,6267
6,Alessandria,46,1214,1939,187,8,4,0,0,3352,781,2144,268,51,1,0,0,3245,6597
6,Alessandria,47,1170,1974,200,20,3,0,0,3367,723,2372,300,51,0,0,0,3446,6813
6,Alessandria,48,1043,2113,207,20,1,0,0,3384,617,2327,301,67,1,0,0,3313,6697
6,Alessandria,49,1028,2221,229,14,4,0,0,3496,721,2451,354,86,0,0,0,3612,7108
6,Alessandria,50,931,2245,255,21,3,2,0,3457,569,2455,355,100,1,0,0,3480,6937
6,Alessandria,51,964,2344,286,25,1,0,0,3620,561,2528,401,91,3,0,0,3584,7204
6,Alessandria,52,919,2393,271,24,4,0,0,3611,531,2555,395,104,2,0,0,3587,7198
6,Alessandria,53,869,2430,311,30,2,0,0,3642,520,2567,390,121,2,0,0,3600,7242
6,Alessandria,54,781,2493,346,27,2,0,0,3649,504,2678,412,141,0,0,0,3735,7384
6,Alessandria,55,621,2455,319,34,5,0,0,3434,442,2500,353,153,0,0,0,3448,6882
6,Alessandria,56,587,2278,301,44,1,0,0,3211,397,2444,360,185,1,0,0,3387,6598
6,Alessandria,57,567,2362,277,40,9,0,0,3255,397,2348,381,224,0,0,0,3350,6605
6,Alessandria,58,541,2304,263,38,2,0,0,3148,342,2262,304,217,0,0,0,3125,6273
6,Alessandria,59,497,2236,247,44,1,0,0,3025,309,2205,339,213,1,0,0,3067,6092
6,Alessandria,60,431,2198,265,79,0,0,0,2973,268,2293,324,259,0,0,0,3144,6117
6,Alessandria,61,435,2294,248,64,0,0,0,3041,272,2199,259,247,0,0,0,2977,6018
6,Alessandria,62,379,2252,227,53,1,0,0,2912,197,2220,280,292,1,0,0,2990,5902
6,Alessandria,63,324,2186,218,78,3,0,0,2809,217,2123,249,295,1,0,0,2885,5694
6,Alessandria,64,323,2149,207,69,0,0,0,2748,183,2123,247,346,2,0,0,2901,5649
6,Alessandria,65,292,2080,197,81,2,0,0,2652,214,2004,194,383,0,0,0,2795,5447
6,Alessandria,66,305,2056,170,109,1,0,0,2641,197,1932,188,415,0,0,0,2732,5373
6,Alessandria,67,286,2072,153,118,0,0,0,2629,190,1977,162,463,1,0,0,2793,5422
6,Alessandria,68,242,2111,165,110,1,0,0,2629,180,2044,204,548,0,0,0,2976,5605
6,Alessandria,69,263,2174,145,135,1,0,0,2718,160,1914,165,591,1,0,0,2831,5549
6,Alessandria,70,274,2223,130,150,1,0,0,2778,182,1983,171,686,0,0,0,3022,5800
6,Alessandria,71,284,2124,127,200,0,0,0,2735,168,2014,176,704,0,0,0,3062,5797
6,Alessandria,72,229,2156,121,204,1,0,0,2711,155,1920,159,813,1,0,0,3048,5759
6,Alessandria,73,170,1563,88,141,2,0,0,1964,132,1415,79,648,0,0,0,2274,4238
6,Alessandria,74,171,1678,78,182,0,0,0,2109,143,1385,105,842,0,0,0,2475,4584
6,Alessandria,75,169,1638,72,202,0,0,0,2081,150,1364,94,879,0,0,0,2487,4568
6,Alessandria,76,168,1600,68,210,1,0,0,2047,148,1353,116,946,0,0,0,2563,4610
6,Alessandria,77,183,1543,73,241,0,0,0,2040,131,1276,78,1058,0,0,0,2543,4583
6,Alessandria,78,162,1646,63,264,0,0,0,2135,153,1215,93,1270,0,0,0,2731,4866
6,Alessandria,79,187,1609,52,277,0,0,0,2125,143,1207,63,1334,0,0,0,2747,4872
6,Alessandria,80,168,1472,65,286,0,0,0,1991,129,985,75,1435,0,0,0,2624,4615
6,Alessandria,81,126,1268,38,280,1,0,0,1713,121,831,49,1298,0,0,0,2299,4012
6,Alessandria,82,119,1146,28,260,0,0,0,1553,133,715,33,1289,0,0,0,2170,3723
6,Alessandria,83,134,996,33,293,1,0,0,1457,151,608,50,1321,0,0,0,2130,3587
6,Alessandria,84,99,853,26,300,0,0,0,1278,122,512,24,1340,0,0,0,1998,3276
6,Alessandria,85,97,778,22,275,0,0,0,1172,135,407,30,1406,0,0,0,1978,3150
6,Alessandria,86,81,633,18,246,0,0,0,978,132,321,25,1303,0,0,0,1781,2759
6,Alessandria,87,70,548,7,213,0,0,0,838,125,245,19,1241,0,0,0,1630,2468
6,Alessandria,88,60,468,8,247,0,0,0,783,127,212,24,1253,0,0,0,1616,2399
6,Alessandria,89,56,372,12,190,0,0,0,630,88,139,14,1069,0,0,0,1310,1940
6,Alessandria,90,40,274,7,187,0,0,0,508,108,102,13,963,0,0,0,1186,1694
6,Alessandria,91,32,188,7,159,0,0,0,386,78,74,14,867,0,0,0,1033,1419
6,Alessandria,92,24,138,4,119,0,0,0,285,64,54,7,659,0,0,0,784,1069
6,Alessandria,93,19,117,2,104,0,0,0,242,51,35,5,570,0,0,0,661,903
6,Alessandria,94,10,59,3,101,0,0,0,173,38,23,8,471,0,0,0,540,713
6,Alessandria,95,7,54,0,58,0,0,0,119,35,15,3,346,0,0,0,399,518
6,Alessandria,96,8,26,0,46,0,0,0,80,30,11,3,287,0,0,0,331,411
6,Alessandria,97,6,22,0,39,0,0,0,67,19,3,4,207,0,0,0,233,300
6,Alessandria,98,5,8,0,30,0,0,0,43,13,3,0,155,0,0,0,171,214
6,Alessandria,99,1,7,0,2,0,0,0,10,4,2,0,62,0,0,0,68,78
6,Alessandria,100,1,2,0,17,0,0,0,20,22,0,0,108,0,0,0,130,150
7,Valle d'Aosta/Vallée d'Aoste,0,472,0,0,0,0,0,0,472,417,0,0,0,0,0,0,417,889
7,Valle d'Aosta/Vallée d'Aoste,1,473,0,0,0,0,0,0,473,419,0,0,0,0,0,0,419,892
7,Valle d'Aosta/Vallée d'Aoste,2,503,0,0,0,0,0,0,503,459,0,0,0,0,0,0,459,962
7,Valle d'Aosta/Vallée d'Aoste,3,495,0,0,0,0,0,0,495,477,0,0,0,0,0,0,477,972
7,Valle d'Aosta/Vallée d'Aoste,4,553,0,0,0,0,0,0,553,508,0,0,0,0,0,0,508,1061
7,Valle d'Aosta/Vallée d'Aoste,5,510,0,0,0,0,0,0,510,526,0,0,0,0,0,0,526,1036
7,Valle d'Aosta/Vallée d'Aoste,6,575,0,0,0,0,0,0,575,552,0,0,0,0,0,0,552,1127
7,Valle d'Aosta/Vallée d'Aoste,7,617,0,0,0,0,0,0,617,576,0,0,0,0,0,0,576,1193
7,Valle d'Aosta/Vallée d'Aoste,8,583,0,0,0,0,0,0,583,582,0,0,0,0,0,0,582,1165
7,Valle d'Aosta/Vallée d'Aoste,9,637,0,0,0,0,0,0,637,594,0,0,0,0,0,0,594,1231
7,Valle d'Aosta/Vallée d'Aoste,10,621,0,0,0,0,0,0,621,592,0,0,0,0,0,0,592,1213
7,Valle d'Aosta/Vallée d'Aoste,11,624,0,0,0,0,0,0,624,576,0,0,0,0,0,0,576,1200
7,Valle d'Aosta/Vallée d'Aoste,12,659,0,0,0,0,0,0,659,582,0,0,0,0,0,0,582,1241
7,Valle d'Aosta/Vallée d'Aoste,13,587,0,0,0,0,0,0,587,553,0,0,0,0,0,0,553,1140
7,Valle d'Aosta/Vallée d'Aoste,14,591,0,0,0,0,0,0,591,587,0,0,0,0,0,0,587,1178
7,Valle d'Aosta/Vallée d'Aoste,15,595,0,0,0,0,0,0,595,590,0,0,0,0,0,0,590,1185
7,Valle d'Aosta/Vallée d'Aoste,16,598,0,0,0,0,0,0,598,515,0,0,0,0,0,0,515,1113
7,Valle d'Aosta/Vallée d'Aoste,17,626,0,0,0,0,0,0,626,557,0,1,0,0,0,0,558,1184
7,Valle d'Aosta/Vallée d'Aoste,18,643,0,0,0,0,0,0,643,591,1,0,0,0,0,0,592,1235
7,Valle d'Aosta/Vallée d'Aoste,19,644,0,0,0,0,0,0,644,569,5,0,0,0,0,0,574,1218
7,Valle d'Aosta/Vallée d'Aoste,20,632,1,0,0,0,0,0,633,555,9,0,0,1,0,0,565,1198
7,Valle d'Aosta/Vallée d'Aoste,21,591,1,0,0,0,0,0,592,527,15,0,0,0,0,0,542,1134
7,Valle d'Aosta/Vallée d'Aoste,22,639,3,0,0,0,0,0,642,562,17,0,0,0,0,0,579,1221
7,Valle d'Aosta/Vallée d'Aoste,23,602,9,0,0,0,0,0,611,529,28,0,1,0,0,0,558,1169
7,Valle d'Aosta/Vallée d'Aoste,24,559,18,0,0,0,0,0,577,512,50,1,0,0,0,0,563,1140
7,Valle d'Aosta/Vallée d'Aoste,25,568,17,0,0,0,0,0,585,496,58,2,0,0,0,0,556,1141
7,Valle d'Aosta/Vallée d'Aoste,26,623,27,0,0,0,0,0,650,493,90,2,0,0,0,0,585,1235
7,Valle d'Aosta/Vallée d'Aoste,27,572,45,0,0,0,0,0,617,478,93,4,1,0,0,0,576,1193
7,Valle d'Aosta/Vallée d'Aoste,28,566,56,2,0,0,0,0,624,478,153,4,1,0,0,0,636,1260
7,Valle d'Aosta/Vallée d'Aoste,29,556,86,1,0,0,0,0,643,395,177,6,1,1,0,0,580,1223
7,Valle d'Aosta/Vallée d'Aoste,30,531,113,5,0,0,0,0,649,418,207,8,1,0,0,0,634,1283
7,Valle d'Aosta/Vallée d'Aoste,31,493,136,2,0,0,0,0,631,376,239,9,1,0,0,0,625,1256
7,Valle d'Aosta/Vallée d'Aoste,32,423,181,3,1,0,0,0,608,362,285,9,1,1,0,0,658,1266
7,Valle d'Aosta/Vallée d'Aoste,33,451,189,9,0,0,0,0,649,374,275,6,0,0,0,0,655,1304
7,Valle d'Aosta/Vallée d'Aoste,34,440,224,5,0,0,0,0,669,341,299,16,0,0,0,0,656,1325
7,Valle d'Aosta/Vallée d'Aoste,35,406,285,8,0,1,0,0,700,326,343,21,1,0,0,0,691,1391
7,Valle d'Aosta/Vallée d'Aoste,36,388,270,16,0,0,0,0,674,324,376,21,3,2,0,0,726,1400
7,Valle d'Aosta/Vallée d'Aoste,37,376,275,12,0,3,0,0,666,263,384,29,2,1,0,0,679,1345
7,Valle d'Aosta/Vallée d'Aoste,38,397,332,18,0,0,1,0,748,250,396,32,6,0,0,0,684,1432
7,Valle d'Aosta/Vallée d'Aoste,39,356,357,21,0,0,0,0,734,257,411,31,9,1,0,0,709,1443
7,Valle d'Aosta/Vallée d'Aoste,40,468,369,24,2,1,0,0,864,313,473,44,4,0,0,0,834,1698
7,Valle d'Aosta/Vallée d'Aoste,41,360,444,33,0,2,0,0,839,295,471,49,4,2,0,0,821,1660
7,Valle d'Aosta/Vallée d'Aoste,42,406,410,30,1,0,0,0,847,291,568,56,4,2,1,0,922,1769
7,Valle d'Aosta/Vallée d'Aoste,43,423,445,44,0,0,0,0,912,309,575,61,9,0,0,0,954,1866
7,Valle d'Aosta/Vallée d'Aoste,44,432,512,48,1,0,0,0,993,303,578,82,6,1,0,0,970,1963
7,Valle d'Aosta/Vallée d'Aoste,45,370,562,58,1,3,0,0,994,278,607,96,13,1,0,0,995,1989
7,Valle d'Aosta/Vallée d'Aoste,46,378,547,55,3,1,0,0,984,278,631,89,17,0,0,0,1015,1999
7,Valle d'Aosta/Vallée d'Aoste,47,339,605,69,4,0,0,0,1017,260,690,115,18,0,0,0,1083,2100
7,Valle d'Aosta/Vallée d'Aoste,48,362,577,73,3,0,0,0,1015,248,664,122,23,0,0,0,1057,2072
7,Valle d'Aosta/Vallée d'Aoste,49,339,628,102,5,2,0,0,1076,259,716,112,14,0,0,0,1101,2177
7,Valle d'Aosta/Vallée d'Aoste,50,327,623,75,5,1,1,0,1032,223,684,138,23,0,0,0,1068,2100
7,Valle d'Aosta/Vallée d'Aoste,51,320,641,99,7,1,0,0,1068,231,704,134,39,0,0,0,1108,2176
7,Valle d'Aosta/Vallée d'Aoste,52,329,647,121,9,1,0,0,1107,209,708,136,33,0,0,0,1086,2193
7,Valle d'Aosta/Vallée d'Aoste,53,258,702,94,7,0,0,0,1061,182,728,122,36,0,0,0,1068,2129
7,Valle d'Aosta/Vallée d'Aoste,54,275,758,120,7,1,0,0,1161,203,729,142,36,1,0,0,1111,2272
7,Valle d'Aosta/Vallée d'Aoste,55,237,693,112,14,0,0,0,1056,154,702,120,46,1,0,0,1023,2079
7,Valle d'Aosta/Vallée d'Aoste,56,189,648,90,13,0,0,0,940,125,691,125,45,0,0,0,986,1926
7,Valle d'Aosta/Vallée d'Aoste,57,207,654,110,12,2,0,0,985,126,640,129,48,0,0,0,943,1928
7,Valle d'Aosta/Vallée d'Aoste,58,157,586,98,10,1,0,0,852,109,626,111,60,0,0,0,906,1758
7,Valle d'Aosta/Vallée d'Aoste,59,152,643,91,15,0,0,0,901,104,647,113,80,0,0,0,944,1845
7,Valle d'Aosta/Vallée d'Aoste,60,165,578,69,17,0,0,0,829,74,623,98,63,0,0,0,858,1687
7,Valle d'Aosta/Vallée d'Aoste,61,139,587,76,13,0,0,0,815,95,582,104,71,0,0,0,852,1667
7,Valle d'Aosta/Vallée d'Aoste,62,119,598,77,11,0,0,0,805,65,583,84,74,0,0,0,806,1611
7,Valle d'Aosta/Vallée d'Aoste,63,113,559,69,19,1,0,0,761,76,606,92,97,1,0,0,872,1633
7,Valle d'Aosta/Vallée d'Aoste,64,123,568,64,22,0,0,0,777,68,577,78,110,0,1,0,834,1611
7,Valle d'Aosta/Vallée d'Aoste,65,106,608,56,22,0,0,0,792,58,553,65,99,0,0,0,775,1567
7,Valle d'Aosta/Vallée d'Aoste,66,110,567,53,21,0,0,0,751,49,522,59,115,0,0,0,745,1496
7,Valle d'Aosta/Vallée d'Aoste,67,88,558,66,27,0,0,0,739,51,560,58,116,0,0,0,785,1524
7,Valle d'Aosta/Vallée d'Aoste,68,96,565,45,32,0,0,0,738,58,524,54,138,0,0,0,774,1512
7,Valle d'Aosta/Vallée d'Aoste,69,85,585,59,29,0,0,0,758,56,563,57,161,0,0,0,837,1595
7,Valle d'Aosta/Vallée d'Aoste,70,86,584,44,44,3,0,0,761,49,545,74,176,0,0,0,844,1605
7,Valle d'Aosta/Vallée d'Aoste,71,69,598,40,49,1,0,0,757,32,490,52,175,0,0,0,749,1506
7,Valle d'Aosta/Vallée d'Aoste,72,75,533,44,42,0,0,0,694,29,471,50,196,0,0,0,746,1440
7,Valle d'Aosta/Vallée d'Aoste,73,67,375,21,36,0,0,0,499,31,364,31,174,0,0,0,600,1099
7,Valle d'Aosta/Vallée d'Aoste,74,63,449,27,48,0,0,0,587,26,330,33,202,0,0,0,591,1178
7,Valle d'Aosta/Vallée d'Aoste,75,59,466,26,52,0,0,0,603,35,345,34,222,0,0,0,636,1239
7,Valle d'Aosta/Vallée d'Aoste,76,58,455,17,51,0,0,0,581,21,324,29,269,0,0,0,643,1224
7,Valle d'Aosta/Vallée d'Aoste,77,62,401,20,60,0,0,0,543,43,340,20,276,0,0,0,679,1222
7,Valle d'Aosta/Vallée d'Aoste,78,66,419,17,62,0,0,0,564,46,303,32,320,0,0,0,701,1265
7,Valle d'Aosta/Vallée d'Aoste,79,48,395,10,63,0,0,0,516,41,279,21,316,0,0,0,657,1173
7,Valle d'Aosta/Vallée d'Aoste,80,36,381,10,78,1,0,0,506,42,260,17,346,0,0,0,665,1171
7,Valle d'Aosta/Vallée d'Aoste,81,34,298,12,72,0,0,0,416,38,197,12,351,0,0,0,598,1014
7,Valle d'Aosta/Vallée d'Aoste,82,31,253,7,73,0,0,0,364,29,157,16,326,0,0,0,528,892
7,Valle d'Aosta/Vallée d'Aoste,83,25,228,7,68,0,0,0,328,31,132,18,312,0,0,0,493,821
7,Valle d'Aosta/Vallée d'Aoste,84,29,184,7,52,0,0,0,272,34,117,10,306,0,0,0,467,739
7,Valle d'Aosta/Vallée d'Aoste,85,25,183,4,56,0,0,0,268,33,105,8,325,0,0,0,471,739
7,Valle d'Aosta/Vallée d'Aoste,86,17,142,6,58,0,0,0,223,41,71,6,290,0,0,0,408,631
7,Valle d'Aosta/Vallée d'Aoste,87,21,120,6,63,0,0,0,210,27,59,6,293,0,0,0,385,595
7,Valle d'Aosta/Vallée d'Aoste,88,14,120,4,52,0,0,0,190,27,54,8,304,0,0,0,393,583
7,Valle d'Aosta/Vallée d'Aoste,89,15,90,2,48,0,0,0,155,21,34,3,245,0,0,0,303,458
7,Valle d'Aosta/Vallée d'Aoste,90,11,69,3,38,0,0,0,121,20,27,3,229,0,0,0,279,400
7,Valle d'Aosta/Vallée d'Aoste,91,4,40,0,33,0,0,0,77,22,20,1,196,0,0,0,239,316
7,Valle d'Aosta/Vallée d'Aoste,92,6,24,1,31,0,0,0,62,22,6,1,169,0,0,0,198,260
7,Valle d'Aosta/Vallée d'Aoste,93,3,31,2,24,0,0,0,60,9,9,3,123,0,0,0,144,204
7,Valle d'Aosta/Vallée d'Aoste,94,6,10,1,11,0,0,0,28,7,4,2,90,0,0,0,103,131
7,Valle d'Aosta/Vallée d'Aoste,95,2,7,1,12,0,0,0,22,10,4,1,77,0,0,0,92,114
7,Valle d'Aosta/Vallée d'Aoste,96,0,5,0,10,0,0,0,15,3,2,1,73,0,0,0,79,94
7,Valle d'Aosta/Vallée d'Aoste,97,0,3,0,8,0,0,0,11,5,1,2,56,0,0,0,64,75
7,Valle d'Aosta/Vallée d'Aoste,98,1,1,1,3,0,0,0,6,6,0,1,26,0,0,0,33,39
7,Valle d'Aosta/Vallée d'Aoste,99,0,0,1,3,0,0,0,4,0,0,0,15,0,0,0,15,19
7,Valle d'Aosta/Vallée d'Aoste,100,0,2,0,1,0,0,0,3,3,0,0,18,0,0,0,21,24
8,Imperia,0,657,0,0,0,0,0,0,657,603,0,0,0,0,0,0,603,1260
8,Imperia,1,693,0,0,0,0,0,0,693,668,0,0,0,0,0,0,668,1361
8,Imperia,2,748,0,0,0,0,0,0,748,675,0,0,0,0,0,0,675,1423
8,Imperia,3,729,0,0,0,0,0,0,729,688,0,0,0,0,0,0,688,1417
8,Imperia,4,784,0,0,0,0,0,0,784,725,0,0,0,0,0,0,725,1509
8,Imperia,5,775,0,0,0,0,0,0,775,728,0,0,0,0,0,0,728,1503
8,Imperia,6,820,0,0,0,0,0,0,820,763,0,0,0,0,0,0,763,1583
8,Imperia,7,845,0,0,0,0,0,0,845,744,0,0,0,0,0,0,744,1589
8,Imperia,8,850,0,0,0,0,0,0,850,764,0,0,0,0,0,0,764,1614
8,Imperia,9,856,0,0,0,0,0,0,856,859,0,0,0,0,0,0,859,1715
8,Imperia,10,894,0,0,0,0,0,0,894,855,0,0,0,0,0,0,855,1749
8,Imperia,11,946,0,0,0,0,0,0,946,822,0,0,0,0,0,0,822,1768
8,Imperia,12,827,0,0,0,0,0,0,827,846,0,0,0,0,0,0,846,1673
8,Imperia,13,916,0,0,0,0,0,0,916,881,0,0,0,0,0,0,881,1797
8,Imperia,14,910,0,0,0,0,0,0,910,852,0,0,0,0,0,0,852,1762
8,Imperia,15,875,0,0,0,0,0,0,875,813,0,0,0,0,0,0,813,1688
8,Imperia,16,922,0,0,0,0,0,0,922,760,0,0,0,0,0,0,760,1682
8,Imperia,17,911,0,0,0,0,0,0,911,902,1,0,0,0,0,0,903,1814
8,Imperia,18,987,0,0,0,0,0,0,987,856,2,0,0,0,0,0,858,1845
8,Imperia,19,976,1,0,0,0,0,0,977,926,8,0,0,0,0,0,934,1911
8,Imperia,20,1073,0,0,0,0,0,0,1073,855,21,0,0,1,0,0,877,1950
8,Imperia,21,1038,1,0,0,0,0,0,1039,859,30,0,0,0,0,0,889,1928
8,Imperia,22,1078,4,0,0,0,0,0,1082,902,48,0,0,0,0,0,950,2032
8,Imperia,23,997,16,0,0,0,0,0,1013,874,64,0,0,0,0,0,938,1951
8,Imperia,24,980,19,0,0,1,0,0,1000,839,78,0,0,0,0,0,917,1917
8,Imperia,25,1016,37,0,0,1,0,0,1054,806,141,4,0,1,0,0,952,2006
8,Imperia,26,1023,50,0,0,0,0,0,1073,888,157,5,0,0,0,0,1050,2123
8,Imperia,27,959,88,1,1,0,0,0,1049,797,226,6,0,0,0,0,1029,2078
8,Imperia,28,947,126,2,0,0,0,0,1075,753,297,7,1,0,0,0,1058,2133
8,Imperia,29,888,177,1,0,0,0,0,1066,696,299,9,1,1,0,0,1006,2072
8,Imperia,30,843,189,4,0,1,0,0,1037,665,366,11,2,2,0,0,1046,2083
8,Imperia,31,847,254,1,0,0,0,0,1102,600,400,11,1,0,0,0,1012,2114
8,Imperia,32,799,284,9,1,1,0,0,1094,554,405,19,1,0,0,0,979,2073
8,Imperia,33,765,300,6,0,1,0,0,1072,527,507,28,3,0,0,0,1065,2137
8,Imperia,34,648,400,12,1,0,0,0,1061,459,462,34,3,0,0,0,958,2019
8,Imperia,35,642,436,16,0,0,0,0,1094,460,554,25,3,3,0,0,1045,2139
8,Imperia,36,605,444,32,0,1,0,0,1082,416,582,37,2,1,0,0,1038,2120
8,Imperia,37,630,500,28,2,1,0,0,1161,429,615,64,5,0,0,0,1113,2274
8,Imperia,38,584,487,49,0,0,0,0,1120,428,628,53,5,1,0,0,1115,2235
8,Imperia,39,548,559,36,1,1,0,0,1145,379,676,51,7,2,0,0,1115,2260
8,Imperia,40,566,595,47,0,1,0,0,1209,473,732,74,8,1,0,0,1288,2497
8,Imperia,41,578,618,43,0,0,0,0,1239,459,755,92,11,1,0,0,1318,2557
8,Imperia,42,551,690,55,0,1,0,0,1297,434,822,117,9,1,0,0,1383,2680
8,Imperia,43,616,765,65,3,2,0,0,1451,433,898,105,9,2,0,0,1447,2898
8,Imperia,44,593,828,80,2,1,0,0,1504,463,952,137,16,0,0,0,1568,3072
8,Imperia,45,613,848,67,2,0,0,0,1530,404,971,140,15,1,0,0,1531,3061
8,Imperia,46,651,938,100,8,1,0,0,1698,424,1028,177,17,3,0,0,1649,3347
8,Imperia,47,587,940,88,6,3,0,0,1624,376,1035,172,26,0,0,0,1609,3233
8,Imperia,48,577,942,118,9,3,0,0,1649,389,1104,191,34,0,0,0,1718,3367
8,Imperia,49,534,1004,144,9,1,0,0,1692,351,1113,186,40,1,0,0,1691,3383
8,Imperia,50,511,1116,149,8,0,0,0,1784,336,1148,213,34,1,0,0,1732,3516
8,Imperia,51,463,1055,157,6,2,0,0,1683,339,1214,237,39,0,0,0,1829,3512
8,Imperia,52,517,1081,182,10,0,0,0,1790,314,1220,234,63,0,0,0,1831,3621
8,Imperia,53,430,1170,176,16,4,0,0,1796,329,1300,227,67,0,0,0,1923,3719
8,Imperia,54,430,1187,173,13,1,0,0,1804,283,1342,248,63,1,0,0,1937,3741
8,Imperia,55,376,1115,185,17,2,0,0,1695,269,1207,223,72,0,0,0,1771,3466
8,Imperia,56,356,1146,169,12,1,0,0,1684,238,1208,242,73,0,0,0,1761,3445
8,Imperia,57,327,1089,188,19,1,0,0,1624,197,1201,214,89,0,0,0,1701,3325
8,Imperia,58,248,1202,179,25,1,0,0,1655,201,1140,201,100,0,0,0,1642,3297
8,Imperia,59,278,1100,170,24,0,0,0,1572,185,1158,227,109,0,0,0,1679,3251
8,Imperia,60,224,1007,155,32,1,0,0,1419,174,1095,207,114,0,0,0,1590,3009
8,Imperia,61,248,1086,166,26,2,0,0,1528,171,1089,174,130,0,0,0,1564,3092
8,Imperia,62,201,1012,152,33,1,0,0,1399,150,1049,179,117,1,0,0,1496,2895
8,Imperia,63,179,1029,138,21,1,0,0,1368,157,988,161,159,0,0,0,1465,2833
8,Imperia,64,177,1011,125,33,0,0,0,1346,133,1001,133,170,1,0,0,1438,2784
8,Imperia,65,171,1007,116,45,0,0,0,1339,113,1009,162,189,0,0,0,1473,2812
8,Imperia,66,147,975,122,36,2,0,0,1282,121,945,127,181,0,0,0,1374,2656
8,Imperia,67,119,936,92,48,0,0,0,1195,107,977,141,226,0,0,0,1451,2646
8,Imperia,68,136,973,106,52,1,0,0,1268,100,981,121,256,0,0,0,1458,2726
8,Imperia,69,114,1024,97,65,0,0,0,1300,111,1004,129,311,1,0,0,1556,2856
8,Imperia,70,141,1066,103,86,0,0,0,1396,104,1004,118,354,0,0,0,1580,2976
8,Imperia,71,113,1113,100,76,0,0,0,1402,121,993,125,376,0,0,0,1615,3017
8,Imperia,72,106,1046,79,69,0,0,0,1300,101,1001,122,384,1,0,0,1609,2909
8,Imperia,73,87,770,67,76,1,0,0,1001,68,709,77,369,0,0,0,1223,2224
8,Imperia,74,103,864,65,96,0,0,0,1128,76,744,74,409,0,0,0,1303,2431
8,Imperia,75,92,822,65,91,0,0,0,1070,88,704,75,397,0,0,0,1264,2334
8,Imperia,76,98,833,53,106,0,0,0,1090,70,692,81,455,0,0,0,1298,2388
8,Imperia,77,83,830,52,142,0,0,0,1107,87,667,76,535,0,0,0,1365,2472
8,Imperia,78,90,867,47,145,0,0,0,1149,99,698,74,622,0,0,0,1493,2642
8,Imperia,79,76,772,56,123,0,0,0,1027,86,617,68,629,0,0,0,1400,2427
8,Imperia,80,66,787,50,129,0,0,0,1032,84,544,66,648,0,0,0,1342,2374
8,Imperia,81,77,659,43,126,0,0,0,905,77,482,68,665,0,0,0,1292,2197
8,Imperia,82,66,612,30,147,0,0,0,855,84,420,45,648,0,0,0,1197,2052
8,Imperia,83,59,543,30,139,0,0,0,771,71,344,37,695,0,0,0,1147,1918
8,Imperia,84,42,480,15,140,0,0,0,677,64,283,45,601,0,0,0,993,1670
8,Imperia,85,39,456,16,131,0,0,0,642,53,237,41,648,0,0,0,979,1621
8,Imperia,86,32,327,12,134,0,0,0,505,58,201,26,651,0,0,0,936,1441
8,Imperia,87,25,297,13,118,0,0,0,453,68,134,30,609,0,0,0,841,1294
8,Imperia,88,34,270,10,117,0,0,0,431,53,123,26,645,0,0,0,847,1278
8,Imperia,89,20,195,9,107,0,0,0,331,49,89,18,479,0,0,0,635,966
8,Imperia,90,13,135,9,100,0,0,0,257,42,50,9,459,0,0,0,560,817
8,Imperia,91,12,111,2,82,0,0,0,207,40,37,8,389,0,0,0,474,681
8,Imperia,92,8,90,4,45,0,0,0,147,38,29,6,308,0,0,0,381,528
8,Imperia,93,7,46,3,51,0,0,0,107,25,31,10,245,0,0,0,311,418
8,Imperia,94,10,44,4,41,0,0,0,99,29,16,7,194,0,0,0,246,345
8,Imperia,95,7,12,3,26,0,0,0,48,25,7,3,188,0,0,0,223,271
8,Imperia,96,1,15,0,21,0,0,0,37,10,4,4,128,0,0,0,146,183
8,Imperia,97,1,8,0,16,0,0,0,25,11,0,2,102,0,0,0,115,140
8,Imperia,98,0,4,0,14,0,0,0,18,7,3,0,76,0,0,0,86,104
8,Imperia,99,1,1,0,5,0,0,0,7,1,3,2,31,0,0,0,37,44
8,Imperia,100,0,2,0,11,0,0,0,13,3,1,0,57,0,0,0,61,74
9,Savona,0,761,0,0,0,0,0,0,761,768,0,0,0,0,0,0,768,1529
9,Savona,1,841,0,0,0,0,0,0,841,761,0,0,0,0,0,0,761,1602
9,Savona,2,869,0,0,0,0,0,0,869,838,0,0,0,0,0,0,838,1707
9,Savona,3,916,0,0,0,0,0,0,916,921,0,0,0,0,0,0,921,1837
9,Savona,4,1038,0,0,0,0,0,0,1038,896,0,0,0,0,0,0,896,1934
9,Savona,5,1006,0,0,0,0,0,0,1006,911,0,0,0,0,0,0,911,1917
9,Savona,6,1051,0,0,0,0,0,0,1051,1022,0,0,0,0,0,0,1022,2073
9,Savona,7,1028,0,0,0,0,0,0,1028,1019,0,0,0,0,0,0,1019,2047
9,Savona,8,1091,0,0,0,0,0,0,1091,1016,0,0,0,0,0,0,1016,2107
9,Savona,9,1123,0,0,0,0,0,0,1123,1082,0,0,0,0,0,0,1082,2205
9,Savona,10,1171,0,0,0,0,0,0,1171,1089,0,0,0,0,0,0,1089,2260
9,Savona,11,1196,0,0,0,0,0,0,1196,1080,0,0,0,0,0,0,1080,2276
9,Savona,12,1172,0,0,0,0,0,0,1172,1092,0,0,0,0,0,0,1092,2264
9,Savona,13,1236,0,0,0,0,0,0,1236,1087,0,0,0,0,0,0,1087,2323
9,Savona,14,1162,0,0,0,0,0,0,1162,1135,0,0,0,0,0,0,1135,2297
9,Savona,15,1193,0,0,0,0,0,0,1193,1102,0,0,0,0,0,0,1102,2295
9,Savona,16,1205,0,0,0,0,0,0,1205,1113,0,0,0,0,0,0,1113,2318
9,Savona,17,1154,0,0,0,0,0,0,1154,1081,0,0,0,0,0,0,1081,2235
9,Savona,18,1210,0,0,0,0,0,0,1210,1163,0,0,0,0,0,0,1163,2373
9,Savona,19,1208,1,0,0,0,0,0,1209,1065,4,0,0,0,0,0,1069,2278
9,Savona,20,1230,2,0,0,0,0,0,1232,1102,13,0,0,0,0,0,1115,2347
9,Savona,21,1253,1,0,0,0,0,0,1254,1088,35,0,0,0,0,0,1123,2377
9,Savona,22,1268,5,0,0,0,0,0,1273,1047,31,0,0,0,0,0,1078,2351
9,Savona,23,1214,6,0,0,0,0,0,1220,1033,64,0,0,0,0,0,1097,2317
9,Savona,24,1159,18,0,0,2,0,0,1179,1064,79,3,0,0,0,0,1146,2325
9,Savona,25,1147,26,1,0,0,0,0,1174,1044,109,2,0,0,0,0,1155,2329
9,Savona,26,1324,43,0,0,0,0,0,1367,1019,145,3,0,0,0,0,1167,2534
9,Savona,27,1102,66,1,0,1,0,0,1170,920,210,2,1,0,0,0,1133,2303
9,Savona,28,1155,119,1,0,0,0,0,1275,883,281,4,0,0,0,0,1168,2443
9,Savona,29,1127,139,4,0,0,0,0,1270,850,342,5,1,0,0,0,1198,2468
9,Savona,30,1036,230,3,0,0,0,0,1269,793,402,12,3,1,0,0,1211,2480
9,Savona,31,999,244,10,0,0,0,0,1253,664,417,11,1,0,0,0,1093,2346
9,Savona,32,884,308,6,0,0,0,1,1199,638,524,17,3,2,0,0,1184,2383
9,Savona,33,864,378,14,0,1,0,0,1257,623,598,17,2,1,0,0,1241,2498
9,Savona,34,846,436,16,0,1,0,0,1299,595,634,37,2,0,0,0,1268,2567
9,Savona,35,853,481,27,0,3,0,0,1364,573,651,31,0,0,0,0,1255,2619
9,Savona,36,812,549,23,0,1,0,0,1385,544,665,49,8,0,0,0,1266,2651
9,Savona,37,790,500,21,1,1,0,0,1313,582,700,63,2,0,0,0,1347,2660
9,Savona,38,707,577,21,1,1,0,0,1307,536,719,58,3,0,0,0,1316,2623
9,Savona,39,672,682,41,1,0,0,0,1396,544,855,78,3,3,0,0,1483,2879
9,Savona,40,726,717,45,1,1,0,0,1490,587,948,82,7,1,0,0,1625,3115
9,Savona,41,756,807,66,1,1,0,0,1631,560,988,121,15,0,0,0,1684,3315
9,Savona,42,813,881,54,2,2,0,0,1752,584,1093,107,7,0,0,0,1791,3543
9,Savona,43,793,994,76,5,1,0,0,1869,610,1182,125,17,0,0,0,1934,3803
9,Savona,44,824,1098,102,6,0,0,0,2030,592,1302,150,18,2,0,0,2064,4094
9,Savona,45,839,1096,90,2,2,0,0,2029,553,1342,144,18,2,0,0,2059,4088
9,Savona,46,824,1220,105,4,3,0,0,2156,562,1428,181,35,0,0,0,2206,4362
9,Savona,47,803,1257,131,14,1,0,0,2206,543,1450,221,35,0,0,0,2249,4455
9,Savona,48,730,1365,150,13,1,0,0,2259,572,1479,237,27,0,0,0,2315,4574
9,Savona,49,729,1404,176,8,2,0,0,2319,507,1602,265,32,0,0,0,2406,4725
9,Savona,50,685,1468,186,12,0,0,0,2351,528,1588,271,43,0,0,0,2430,4781
9,Savona,51,682,1436,194,10,0,0,0,2322,493,1610,285,54,0,0,0,2442,4764
9,Savona,52,583,1505,222,12,1,0,0,2323,458,1671,273,56,0,0,0,2458,4781
9,Savona,53,599,1597,206,22,2,0,0,2426,425,1673,309,89,0,0,0,2496,4922
9,Savona,54,565,1606,258,18,1,0,0,2448,400,1659,271,83,3,0,0,2416,4864
9,Savona,55,460,1645,217,15,2,0,0,2339,317,1610,280,83,0,0,0,2290,4629
9,Savona,56,449,1504,202,24,2,0,0,2181,304,1598,259,118,0,0,0,2279,4460
9,Savona,57,404,1457,187,30,2,0,0,2080,256,1594,264,99,0,0,1,2214,4294
9,Savona,58,327,1366,184,18,0,0,0,1895,258,1457,243,117,0,0,0,2075,3970
9,Savona,59,308,1418,180,26,1,0,0,1933,260,1506,236,142,1,0,0,2145,4078
9,Savona,60,283,1367,208,31,2,0,0,1891,206,1411,206,157,1,0,0,1981,3872
9,Savona,61,269,1403,146,25,0,0,0,1843,187,1385,198,159,0,1,0,1930,3773
9,Savona,62,264,1347,156,51,0,0,0,1818,195,1360,187,173,0,0,0,1915,3733
9,Savona,63,225,1361,154,59,1,0,0,1800,185,1338,188,197,0,0,0,1908,3708
9,Savona,64,233,1332,137,41,1,0,0,1744,167,1291,152,219,0,0,0,1829,3573
9,Savona,65,204,1265,141,53,1,0,0,1664,155,1272,144,229,0,0,0,1800,3464
9,Savona,66,189,1269,119,53,1,0,0,1631,146,1242,145,252,0,0,0,1785,3416
9,Savona,67,149,1297,117,52,2,0,0,1617,109,1284,131,282,0,0,0,1806,3423
9,Savona,68,151,1327,123,87,0,0,0,1688,132,1333,166,317,0,0,0,1948,3636
9,Savona,69,176,1329,100,71,1,0,0,1677,151,1337,135,356,0,0,0,1979,3656
9,Savona,70,165,1394,112,108,2,0,0,1781,110,1348,120,398,0,0,0,1976,3757
9,Savona,71,151,1422,92,93,2,0,0,1760,137,1436,140,454,0,0,0,2167,3927
9,Savona,72,158,1469,91,93,2,0,1,1814,119,1338,133,536,0,0,0,2126,3940
9,Savona,73,118,1068,73,108,1,0,0,1368,107,997,86,512,0,0,0,1702,3070
9,Savona,74,124,1173,68,129,0,0,0,1494,108,1099,97,538,0,0,0,1842,3336
9,Savona,75,118,1101,60,131,1,0,0,1411,111,960,96,590,0,0,0,1757,3168
9,Savona,76,113,1126,49,129,0,0,0,1417,122,1073,66,673,0,0,0,1934,3351
9,Savona,77,92,1211,44,138,0,0,0,1485,124,918,73,728,0,0,0,1843,3328
9,Savona,78,121,1200,62,195,0,0,0,1578,94,965,77,815,0,0,0,1951,3529
9,Savona,79,128,1148,47,193,1,0,0,1517,103,851,60,859,0,0,0,1873,3390
9,Savona,80,120,1017,50,218,1,0,0,1406,121,766,59,979,0,0,0,1925,3331
9,Savona,81,80,952,30,208,0,0,0,1270,121,673,50,924,0,0,0,1768,3038
9,Savona,82,79,778,32,187,0,0,0,1076,88,544,44,904,0,0,0,1580,2656
9,Savona,83,67,714,38,211,0,0,0,1030,89,466,47,915,0,0,0,1517,2547
9,Savona,84,67,675,21,187,1,0,0,951,100,327,34,967,0,0,0,1428,2379
9,Savona,85,49,541,23,214,0,0,0,827,101,308,37,886,0,0,0,1332,2159
9,Savona,86,49,486,13,184,0,0,0,732,83,250,24,893,0,0,0,1250,1982
9,Savona,87,34,415,11,187,0,0,0,647,76,211,21,886,0,0,0,1194,1841
9,Savona,88,31,356,13,161,0,0,0,561,98,138,15,839,0,0,0,1090,1651
9,Savona,89,26,272,8,155,0,0,0,461,63,130,7,718,0,0,0,918,1379
9,Savona,90,20,206,8,126,0,0,0,360,62,79,17,604,0,0,0,762,1122
9,Savona,91,21,164,3,102,0,0,0,290,46,61,14,553,0,0,0,674,964
9,Savona,92,10,109,5,91,0,0,0,215,40,25,6,474,0,0,0,545,760
9,Savona,93,9,91,0,72,0,0,0,172,39,26,3,406,0,0,0,474,646
9,Savona,94,5,50,1,56,0,0,0,112,41,11,3,308,0,0,0,363,475
9,Savona,95,5,16,0,37,0,0,0,58,22,8,4,245,0,0,0,279,337
9,Savona,96,3,11,0,20,0,0,0,34,17,6,4,190,0,0,0,217,251
9,Savona,97,1,9,0,27,0,0,0,37,18,4,0,141,0,0,0,163,200
9,Savona,98,1,5,0,16,0,0,0,22,12,2,0,98,0,0,0,112,134
9,Savona,99,0,3,0,5,0,0,0,8,6,0,3,42,0,0,0,51,59
9,Savona,100,1,0,0,6,0,0,0,7,10,2,1,89,0,0,0,102,109
10,Genova,0,2448,0,0,0,0,0,0,2448,2391,0,0,0,0,0,0,2391,4839
10,Genova,1,2723,0,0,0,0,0,0,2723,2567,0,0,0,0,0,0,2567,5290
10,Genova,2,2777,0,0,0,0,0,0,2777,2596,0,0,0,0,0,0,2596,5373
10,Genova,3,2901,0,0,0,0,0,0,2901,2674,0,0,0,0,0,0,2674,5575
10,Genova,4,3090,0,0,0,0,0,0,3090,2900,0,0,0,0,0,0,2900,5990
10,Genova,5,3133,0,0,0,0,0,0,3133,2934,0,0,0,0,0,0,2934,6067
10,Genova,6,3275,0,0,0,0,0,0,3275,3089,0,0,0,0,0,0,3089,6364
10,Genova,7,3194,0,0,0,0,0,0,3194,3069,0,0,0,0,0,0,3069,6263
10,Genova,8,3361,0,0,0,0,0,0,3361,3250,0,0,0,0,0,0,3250,6611
10,Genova,9,3460,0,0,0,0,0,0,3460,3454,0,0,0,0,0,0,3454,6914
10,Genova,10,3594,0,0,0,0,0,0,3594,3425,0,0,0,0,0,0,3425,7019
10,Genova,11,3522,0,0,0,0,0,0,3522,3271,0,0,0,0,0,0,3271,6793
10,Genova,12,3558,0,0,0,0,0,0,3558,3407,0,0,0,0,0,0,3407,6965
10,Genova,13,3523,0,0,0,0,0,0,3523,3325,0,0,0,0,0,0,3325,6848
10,Genova,14,3489,0,0,0,0,0,0,3489,3368,0,0,0,0,0,0,3368,6857
10,Genova,15,3529,0,0,0,0,0,0,3529,3267,0,0,0,0,0,0,3267,6796
10,Genova,16,3617,0,0,0,0,0,0,3617,3453,0,0,0,0,0,0,3453,7070
10,Genova,17,3702,0,2,0,0,0,0,3704,3391,0,0,0,0,0,0,3391,7095
10,Genova,18,3770,0,0,0,0,0,0,3770,3416,0,0,0,0,0,0,3416,7186
10,Genova,19,3874,2,0,0,0,0,0,3876,3317,10,0,0,0,0,0,3327,7203
10,Genova,20,3877,2,0,0,0,0,0,3879,3384,36,1,0,1,0,0,3422,7301
10,Genova,21,3801,9,0,0,0,0,0,3810,3373,65,0,0,0,0,0,3438,7248
10,Genova,22,4030,20,1,0,0,0,0,4051,3298,86,2,0,0,0,0,3386,7437
10,Genova,23,3772,32,0,0,1,0,0,3805,3281,137,1,0,0,0,0,3419,7224
10,Genova,24,3769,49,0,0,0,0,0,3818,3299,252,4,0,0,0,0,3555,7373
10,Genova,25,3792,105,1,0,2,0,0,3900,3332,335,1,0,1,0,0,3669,7569
10,Genova,26,3838,159,1,0,1,0,0,3999,3293,411,11,1,0,0,0,3716,7715
10,Genova,27,3848,218,6,0,0,0,0,4072,3232,617,9,1,1,0,0,3860,7932
10,Genova,28,3542,358,6,1,1,0,0,3908,2911,811,21,1,4,0,0,3748,7656
10,Genova,29,3423,481,9,0,1,0,0,3914,2822,1022,32,1,2,0,0,3879,7793
10,Genova,30,3291,711,14,2,4,0,0,4022,2579,1247,49,3,7,0,0,3885,7907
10,Genova,31,3142,866,16,0,1,0,0,4025,2306,1467,30,5,5,0,0,3813,7838
10,Genova,32,2799,1049,27,0,2,0,0,3877,2084,1513,58,2,2,0,0,3659,7536
10,Genova,33,2767,1246,32,0,2,0,0,4047,2002,1833,60,7,6,0,0,3908,7955
10,Genova,34,2581,1399,38,1,2,0,0,4021,1935,1903,85,7,6,0,0,3936,7957
10,Genova,35,2415,1639,52,2,0,0,0,4108,1829,2132,97,7,6,0,0,4071,8179
10,Genova,36,2222,1812,62,2,2,0,0,4100,1666,2188,123,11,5,0,0,3993,8093
10,Genova,37,2215,2005,96,2,5,0,0,4323,1692,2434,148,9,1,0,0,4284,8607
10,Genova,38,2191,1891,106,4,7,0,0,4199,1535,2552,184,16,3,0,0,4290,8489
10,Genova,39,2059,2145,104,0,8,0,0,4316,1601,2727,219,17,3,0,0,4567,8883
10,Genova,40,2142,2273,131,6,5,0,0,4557,1544,3065,237,19,6,0,0,4871,9428
10,Genova,41,2243,2560,172,6,9,0,0,4990,1595,3190,297,35,2,0,0,5119,10109
10,Genova,42,2302,2877,197,6,10,0,0,5392,1675,3365,327,40,4,0,0,5411,10803
10,Genova,43,2333,3157,214,7,4,0,0,5715,1768,3663,430,44,5,0,0,5910,11625
10,Genova,44,2375,3346,277,7,10,0,0,6015,1750,4123,433,64,2,0,0,6372,12387
10,Genova,45,2345,3601,302,17,7,0,0,6272,1628,4205,509,63,2,0,0,6407,12679
10,Genova,46,2353,3819,381,14,7,0,0,6574,1652,4427,614,74,5,0,0,6772,13346
10,Genova,47,2281,3945,412,15,13,0,0,6666,1629,4449,636,75,3,0,0,6792,13458
10,Genova,48,2023,4037,441,24,6,0,0,6531,1482,4640,704,108,3,0,0,6937,13468
10,Genova,49,2002,4207,473,16,11,0,0,6709,1419,4684,728,109,7,0,0,6947,13656
10,Genova,50,1890,4323,488,32,7,0,0,6740,1350,4755,710,148,4,0,0,6967,13707
10,Genova,51,1768,4171,546,31,5,0,1,6522,1266,4802,767,152,4,0,0,6991,13513
10,Genova,52,1729,4603,608,46,9,0,0,6995,1207,5059,849,195,5,0,0,7315,14310
10,Genova,53,1683,4720,668,48,5,0,0,7124,1128,5110,913,220,5,0,0,7376,14500
10,Genova,54,1590,4902,665,59,3,0,0,7219,1133,5227,945,232,3,0,0,7540,14759
10,Genova,55,1357,4504,683,74,13,0,0,6631,986,5114,912,300,5,0,0,7317,13948
10,Genova,56,1251,4415,597,74,4,0,0,6341,911,4888,831,278,3,0,0,6911,13252
10,Genova,57,1138,4322,592,60,2,0,0,6114,807,4713,782,347,4,0,0,6653,12767
10,Genova,58,1023,4387,579,68,7,0,0,6064,775,4677,748,324,2,0,0,6526,12590
10,Genova,59,974,4321,613,93,7,0,0,6008,716,4578,748,421,3,0,0,6466,12474
10,Genova,60,876,4203,502,86,5,0,0,5672,650,4489,675,446,0,0,0,6260,11932
10,Genova,61,842,4203,542,96,3,0,0,5686,591,4332,694,504,1,0,0,6122,11808
10,Genova,62,752,4164,459,118,2,0,0,5495,553,4266,659,518,2,0,0,5998,11493
10,Genova,63,696,3931,442,139,4,0,0,5212,488,4170,565,604,0,0,0,5827,11039
10,Genova,64,662,4071,426,137,4,0,0,5300,491,4119,543,681,1,0,0,5835,11135
10,Genova,65,588,3900,359,169,7,0,0,5023,481,3946,490,787,1,0,0,5705,10728
10,Genova,66,576,3817,370,172,3,0,0,4938,409,3800,498,771,3,0,0,5481,10419
10,Genova,67,534,3746,347,217,1,0,0,4845,442,3776,416,856,1,0,0,5491,10336
10,Genova,68,563,4197,335,221,1,0,0,5317,446,3934,436,963,2,0,0,5781,11098
10,Genova,69,468,4057,311,238,3,0,0,5077,408,3994,439,1064,1,0,0,5906,10983
10,Genova,70,501,4277,315,278,1,0,0,5372,462,4215,425,1260,1,0,0,6363,11735
10,Genova,71,453,4486,291,297,4,0,0,5531,467,4092,448,1458,0,0,0,6465,11996
10,Genova,72,449,4427,264,342,1,0,0,5483,405,4225,371,1635,0,0,0,6636,12119
10,Genova,73,348,3075,174,332,2,0,0,3931,292,2726,266,1307,1,0,0,4592,8523
10,Genova,74,315,3440,191,363,4,0,0,4313,308,3058,269,1651,2,0,0,5288,9601
10,Genova,75,326,3310,164,370,0,0,0,4170,327,2921,244,1694,0,0,0,5186,9356
10,Genova,76,315,3242,162,384,1,0,0,4104,350,2749,255,1959,0,0,0,5313,9417
10,Genova,77,302,3220,155,465,2,0,0,4144,346,2827,235,2095,0,0,0,5503,9647
10,Genova,78,317,3373,137,542,4,0,0,4373,367,2845,202,2482,0,0,0,5896,10269
10,Genova,79,309,3266,120,585,1,0,0,4281,395,2573,236,2697,0,0,0,5901,10182
10,Genova,80,321,2990,112,592,2,0,0,4017,365,2310,200,2803,0,0,0,5678,9695
10,Genova,81,246,2661,95,592,1,0,0,3595,304,1925,168,2741,1,0,0,5139,8734
10,Genova,82,202,2312,81,515,0,0,0,3110,300,1521,146,2750,0,0,0,4717,7827
10,Genova,83,169,2187,60,551,2,0,0,2969,294,1396,146,2803,0,0,0,4639,7608
10,Genova,84,173,1826,61,546,1,0,0,2607,324,1124,84,2720,0,0,0,4252,6859
10,Genova,85,179,1657,31,516,0,0,0,2383,278,950,107,2698,0,0,0,4033,6416
10,Genova,86,135,1438,37,515,0,0,0,2125,296,790,86,2751,0,0,0,3923,6048
10,Genova,87,109,1273,34,504,0,0,0,1920,285,643,70,2612,0,0,0,3610,5530
10,Genova,88,108,1056,32,532,0,0,0,1728,269,506,72,2611,0,0,0,3458,5186
10,Genova,89,105,825,16,427,0,0,0,1373,280,387,41,2304,0,0,0,3012,4385
10,Genova,90,64,647,11,411,0,0,0,1133,227,261,49,2032,0,0,0,2569,3702
10,Genova,91,51,506,8,332,0,0,0,897,195,194,37,1705,0,0,0,2131,3028
10,Genova,92,36,316,11,282,0,0,0,645,156,118,19,1584,0,0,0,1877,2522
10,Genova,93,39,261,7,181,0,0,0,488,140,66,14,1262,0,0,0,1482,1970
10,Genova,94,29,161,4,174,0,0,0,368,81,62,11,981,0,0,0,1135,1503
10,Genova,95,14,96,2,172,0,0,0,284,83,24,13,793,0,0,0,913,1197
10,Genova,96,16,75,3,117,0,0,0,211,58,19,9,639,0,0,0,725,936
10,Genova,97,8,38,0,78,0,0,0,124,44,17,2,430,0,0,0,493,617
10,Genova,98,4,23,0,56,0,0,0,83,31,6,6,321,0,0,0,364,447
10,Genova,99,3,8,0,20,0,0,0,31,19,1,2,141,0,0,0,163,194
10,Genova,100,5,9,0,35,0,0,0,49,40,3,3,276,0,0,0,322,371
11,La Spezia,0,745,0,0,0,0,0,0,745,614,0,0,0,0,0,0,614,1359
11,La Spezia,1,773,0,0,0,0,0,0,773,716,0,0,0,0,0,0,716,1489
11,La Spezia,2,832,0,0,0,0,0,0,832,702,0,0,0,0,0,0,702,1534
11,La Spezia,3,743,0,0,0,0,0,0,743,737,0,0,0,0,0,0,737,1480
11,La Spezia,4,779,0,0,0,0,0,0,779,763,0,0,0,0,0,0,763,1542
11,La Spezia,5,858,0,0,0,0,0,0,858,769,0,0,0,0,0,0,769,1627
11,La Spezia,6,859,0,0,0,0,0,0,859,841,0,0,0,0,0,0,841,1700
11,La Spezia,7,889,0,0,0,0,0,0,889,794,0,0,0,0,0,0,794,1683
11,La Spezia,8,817,0,0,0,0,0,0,817,886,0,0,0,0,0,0,886,1703
11,La Spezia,9,909,0,0,0,0,0,0,909,874,0,0,0,0,0,0,874,1783
11,La Spezia,10,894,0,0,0,0,0,0,894,931,0,0,0,0,0,0,931,1825
11,La Spezia,11,942,0,0,0,0,0,0,942,809,0,0,0,0,0,0,809,1751
11,La Spezia,12,928,0,0,0,0,0,0,928,913,0,0,0,0,0,0,913,1841
11,La Spezia,13,908,0,0,0,0,0,0,908,811,0,0,0,0,0,0,811,1719
11,La Spezia,14,944,0,0,0,0,0,0,944,880,0,0,0,0,0,0,880,1824
11,La Spezia,15,894,0,0,0,0,0,0,894,835,0,0,0,0,0,0,835,1729
11,La Spezia,16,884,0,0,0,0,0,0,884,865,0,0,0,0,0,0,865,1749
11,La Spezia,17,859,0,0,0,0,0,0,859,935,0,0,0,0,0,0,935,1794
11,La Spezia,18,962,0,0,0,0,0,0,962,877,0,0,0,0,0,0,877,1839
11,La Spezia,19,994,0,0,0,0,0,0,994,811,6,0,0,0,0,0,817,1811
11,La Spezia,20,1033,0,0,0,0,0,0,1033,842,15,0,0,0,0,0,857,1890
11,La Spezia,21,1001,2,0,0,0,0,0,1003,877,13,0,0,0,0,0,890,1893
11,La Spezia,22,966,7,0,0,1,0,0,974,896,23,1,0,0,0,0,920,1894
11,La Spezia,23,969,7,0,0,0,0,0,976,836,56,0,0,0,0,0,892,1868
11,La Spezia,24,952,17,0,0,1,0,0,970,798,57,2,0,0,0,0,857,1827
11,La Spezia,25,977,28,1,0,0,0,0,1006,794,86,2,0,0,0,0,882,1888
11,La Spezia,26,1051,44,0,0,0,0,0,1095,865,112,0,0,0,0,0,977,2072
11,La Spezia,27,907,60,1,0,0,0,0,968,791,191,3,0,0,0,0,985,1953
11,La Spezia,28,964,82,0,0,1,0,0,1047,799,258,8,0,2,0,0,1067,2114
11,La Spezia,29,879,139,2,0,0,0,0,1020,761,240,8,0,0,0,0,1009,2029
11,La Spezia,30,924,198,5,1,0,0,0,1128,712,381,18,1,0,0,0,1112,2240
11,La Spezia,31,833,242,6,0,1,0,0,1082,609,419,16,0,0,0,0,1044,2126
11,La Spezia,32,783,326,12,0,1,0,0,1122,619,499,20,2,0,0,0,1140,2262
11,La Spezia,33,821,363,6,1,1,0,0,1192,539,552,24,0,0,0,0,1115,2307
11,La Spezia,34,727,417,10,0,1,0,0,1155,537,566,30,2,0,0,0,1135,2290
11,La Spezia,35,699,483,27,0,0,0,0,1209,452,563,39,1,1,0,0,1056,2265
11,La Spezia,36,646,532,20,1,1,0,0,1200,458,649,50,1,0,0,0,1158,2358
11,La Spezia,37,615,541,24,2,0,0,0,1182,448,672,48,5,1,0,0,1174,2356
11,La Spezia,38,620,567,26,1,0,0,0,1214,374,700,48,5,0,0,0,1127,2341
11,La Spezia,39,615,610,26,2,1,0,0,1254,429,745,54,5,2,0,0,1235,2489
11,La Spezia,40,633,729,38,0,2,0,0,1402,434,845,61,6,1,0,0,1347,2749
11,La Spezia,41,640,702,51,1,0,1,0,1395,436,946,71,5,1,0,0,1459,2854
11,La Spezia,42,633,763,53,5,0,0,0,1454,445,937,79,9,0,0,0,1470,2924
11,La Spezia,43,646,817,64,5,0,0,0,1532,429,957,110,9,1,0,0,1506,3038
11,La Spezia,44,616,944,80,5,0,0,0,1645,419,1096,118,18,0,0,0,1651,3296
11,La Spezia,45,636,971,92,2,0,0,0,1701,411,1149,125,23,0,0,0,1708,3409
11,La Spezia,46,588,1026,94,4,2,0,0,1714,372,1189,137,23,0,0,0,1721,3435
11,La Spezia,47,571,1053,98,3,1,0,0,1726,393,1211,158,26,0,0,0,1788,3514
11,La Spezia,48,551,1044,115,7,0,0,0,1717,349,1206,159,27,1,0,0,1742,3459
11,La Spezia,49,541,1112,128,5,0,0,0,1786,354,1286,196,38,1,0,0,1875,3661
11,La Spezia,50,481,1186,158,5,1,0,0,1831,347,1322,170,33,0,0,0,1872,3703
11,La Spezia,51,457,1211,131,12,3,0,0,1814,322,1321,223,49,0,0,0,1915,3729
11,La Spezia,52,460,1327,147,18,0,0,0,1952,313,1423,202,47,1,0,0,1986,3938
11,La Spezia,53,412,1308,166,11,1,0,0,1898,263,1462,221,57,0,0,0,2003,3901
11,La Spezia,54,394,1406,185,15,0,0,0,2000,253,1395,239,70,0,0,0,1957,3957
11,La Spezia,55,346,1257,161,16,2,0,0,1782,235,1335,212,62,1,0,0,1845,3627
11,La Spezia,56,291,1245,150,21,0,0,0,1707,208,1289,204,90,0,0,0,1791,3498
11,La Spezia,57,295,1279,154,13,1,0,0,1742,195,1324,198,75,0,0,0,1792,3534
11,La Spezia,58,243,1182,133,28,1,0,0,1587,134,1260,172,101,1,0,0,1668,3255
11,La Spezia,59,224,1163,135,19,0,0,0,1541,133,1164,165,93,0,0,0,1555,3096
11,La Spezia,60,218,1129,131,30,1,0,0,1509,143,1136,144,126,0,0,0,1549,3058
11,La Spezia,61,200,1082,135,28,2,0,0,1447,128,1123,135,127,0,0,0,1513,2960
11,La Spezia,62,160,1132,119,22,0,0,0,1433,112,1091,141,148,0,0,0,1492,2925
11,La Spezia,63,162,1024,94,43,0,0,0,1323,97,1062,125,157,0,0,0,1441,2764
11,La Spezia,64,149,1039,96,32,0,0,0,1316,93,1077,116,191,0,0,0,1477,2793
11,La Spezia,65,121,1068,61,35,0,0,0,1285,89,977,90,181,0,0,0,1337,2622
11,La Spezia,66,107,947,80,42,0,0,0,1176,59,1020,96,168,0,0,0,1343,2519
11,La Spezia,67,115,980,72,28,0,0,0,1195,77,979,90,212,0,0,0,1358,2553
11,La Spezia,68,114,1050,74,44,1,0,0,1283,71,1039,69,233,0,0,0,1412,2695
11,La Spezia,69,116,1092,78,71,1,0,0,1358,65,1118,77,286,0,0,0,1546,2904
11,La Spezia,70,136,1192,52,88,0,0,0,1468,75,1067,56,315,0,0,0,1513,2981
11,La Spezia,71,97,1181,66,71,0,0,0,1415,74,1083,84,378,0,0,0,1619,3034
11,La Spezia,72,111,1181,59,71,0,0,0,1422,69,1069,81,395,0,0,0,1614,3036
11,La Spezia,73,56,787,33,76,0,0,0,952,52,725,42,307,0,0,0,1126,2078
11,La Spezia,74,81,905,37,82,0,0,0,1105,60,838,52,406,0,0,0,1356,2461
11,La Spezia,75,73,915,35,63,0,0,0,1086,40,743,54,448,0,0,0,1285,2371
11,La Spezia,76,49,886,45,99,0,0,0,1079,58,779,35,497,0,0,0,1369,2448
11,La Spezia,77,66,905,40,103,0,0,0,1114,57,780,40,505,0,0,0,1382,2496
11,La Spezia,78,81,936,28,128,0,0,0,1173,69,709,47,633,0,0,0,1458,2631
11,La Spezia,79,62,864,21,129,0,0,0,1076,60,701,47,606,0,0,0,1414,2490
11,La Spezia,80,74,794,18,129,0,0,0,1015,63,594,42,668,0,0,0,1367,2382
11,La Spezia,81,56,664,20,113,0,0,0,853,61,472,35,655,0,0,0,1223,2076
11,La Spezia,82,50,595,21,112,0,0,0,778,52,398,16,677,0,0,0,1143,1921
11,La Spezia,83,53,522,13,115,0,0,0,703,70,294,17,660,0,0,0,1041,1744
11,La Spezia,84,37,512,9,110,0,0,0,668,45,284,8,678,0,0,0,1015,1683
11,La Spezia,85,46,416,8,131,0,0,0,601,45,242,7,648,0,0,0,942,1543
11,La Spezia,86,34,383,8,115,0,0,0,540,54,187,12,680,0,0,0,933,1473
11,La Spezia,87,44,323,10,106,0,0,0,483,67,176,11,634,0,0,0,888,1371
11,La Spezia,88,26,282,4,127,0,0,0,439,52,134,9,689,0,0,0,884,1323
11,La Spezia,89,20,209,6,111,0,0,0,346,51,104,7,594,0,0,0,756,1102
11,La Spezia,90,17,173,3,99,0,0,0,292,43,78,3,524,0,0,0,648,940
11,La Spezia,91,14,149,1,71,0,0,0,235,38,50,4,466,0,0,0,558,793
11,La Spezia,92,5,100,1,67,0,0,0,173,22,35,5,362,0,0,0,424,597
11,La Spezia,93,5,76,1,68,0,0,0,150,25,20,4,322,0,0,0,371,521
11,La Spezia,94,3,49,1,40,0,0,0,93,17,18,3,290,0,0,0,328,421
11,La Spezia,95,3,27,0,46,0,0,0,76,13,11,0,224,0,0,0,248,324
11,La Spezia,96,1,26,0,29,0,0,0,56,13,2,1,179,0,0,0,195,251
11,La Spezia,97,2,16,1,22,0,0,0,41,10,2,2,123,0,0,0,137,178
11,La Spezia,98,1,7,0,10,0,0,0,18,4,1,0,105,0,0,0,110,128
11,La Spezia,99,0,2,1,3,0,0,0,6,4,0,0,45,0,0,0,49,55
11,La Spezia,100,0,1,0,9,0,0,0,10,6,2,0,72,0,0,0,80,90
12,Varese,0,3352,0,0,0,0,0,0,3352,3201,0,0,0,0,0,0,3201,6553
12,Varese,1,3433,0,0,0,0,0,0,3433,3329,0,0,0,0,0,0,3329,6762
12,Varese,2,3616,0,0,0,0,0,0,3616,3463,0,0,0,0,0,0,3463,7079
12,Varese,3,3897,0,0,0,0,0,0,3897,3631,0,0,0,0,0,0,3631,7528
12,Varese,4,3964,0,0,0,0,0,0,3964,3717,0,0,0,0,0,0,3717,7681
12,Varese,5,4086,0,0,0,0,0,0,4086,3964,0,0,0,0,0,0,3964,8050
12,Varese,6,4192,0,0,0,0,0,0,4192,3975,0,0,0,0,0,0,3975,8167
12,Varese,7,4369,0,0,0,0,0,0,4369,4074,0,0,0,0,0,0,4074,8443
12,Varese,8,4335,0,0,0,0,0,0,4335,4127,0,0,0,0,0,0,4127,8462
12,Varese,9,4603,0,0,0,0,0,0,4603,4252,0,0,0,0,0,0,4252,8855
12,Varese,10,4458,0,0,0,0,0,0,4458,4152,0,0,0,0,0,0,4152,8610
12,Varese,11,4573,0,0,0,0,0,0,4573,4030,0,0,0,0,0,0,4030,8603
12,Varese,12,4417,0,0,0,0,0,0,4417,4295,0,0,0,0,0,0,4295,8712
12,Varese,13,4356,0,0,0,0,0,0,4356,4082,0,0,0,0,0,0,4082,8438
12,Varese,14,4363,0,0,0,0,0,0,4363,4187,0,0,0,0,0,0,4187,8550
12,Varese,15,4143,0,0,0,0,0,0,4143,4035,0,0,0,0,0,0,4035,8178
12,Varese,16,4228,0,0,0,0,0,0,4228,3962,0,0,0,0,0,0,3962,8190
12,Varese,17,4231,0,0,0,0,0,0,4231,3938,0,0,0,0,0,0,3938,8169
12,Varese,18,4341,0,0,0,0,0,0,4341,3997,4,0,0,0,0,0,4001,8342
12,Varese,19,4266,2,0,0,0,0,0,4268,4029,15,0,0,0,0,0,4044,8312
12,Varese,20,4290,1,0,0,0,0,0,4291,3996,53,1,0,0,0,0,4050,8341
12,Varese,21,4402,6,0,0,0,0,0,4408,3853,80,3,0,0,0,0,3936,8344
12,Varese,22,4435,20,0,0,0,0,0,4455,3739,146,1,0,0,0,0,3886,8341
12,Varese,23,4082,33,0,0,0,0,0,4115,3762,205,2,0,0,0,0,3969,8084
12,Varese,24,4129,69,0,0,1,0,0,4199,3765,310,4,0,0,0,0,4079,8278
12,Varese,25,4209,110,1,0,4,0,0,4324,3705,412,10,1,0,0,0,4128,8452
12,Varese,26,4258,183,3,0,0,0,0,4444,3660,617,11,1,0,0,0,4289,8733
12,Varese,27,4200,297,3,0,1,0,0,4501,3426,790,13,0,0,0,0,4229,8730
12,Varese,28,3972,485,5,0,0,0,0,4462,3341,1193,16,1,2,0,0,4553,9015
12,Varese,29,3732,708,10,0,0,0,0,4450,2988,1407,30,4,0,0,0,4429,8879
12,Varese,30,3844,914,22,0,2,0,0,4782,2863,1676,41,5,3,0,0,4588,9370
12,Varese,31,3548,1123,28,0,3,0,0,4702,2496,1855,67,5,1,0,0,4424,9126
12,Varese,32,3183,1404,26,0,2,0,0,4615,2293,2187,85,2,7,0,0,4574,9189
12,Varese,33,3159,1679,35,0,4,0,0,4877,2325,2473,96,7,1,0,0,4902,9779
12,Varese,34,3021,1921,37,0,4,0,0,4983,2074,2578,116,9,4,0,0,4781,9764
12,Varese,35,2886,2193,64,1,1,0,0,5145,2050,2929,121,17,1,0,0,5118,10263
12,Varese,36,2783,2353,78,3,1,0,0,5218,1970,3148,141,13,2,0,0,5274,10492
12,Varese,37,2581,2593,106,4,4,0,0,5288,1764,3246,164,13,2,0,0,5189,10477
12,Varese,38,2553,2775,94,2,4,0,0,5428,1815,3448,202,20,1,0,0,5486,10914
12,Varese,39,2569,2993,129,3,3,0,0,5697,1739,3694,245,23,2,0,0,5703,11400
12,Varese,40,2479,3399,181,10,3,0,0,6072,1700,3979,275,25,2,0,0,5981,12053
12,Varese,41,2573,3584,208,4,2,0,0,6371,1758,4192,356,34,3,0,0,6343,12714
12,Varese,42,2559,3802,262,12,2,0,0,6637,1696,4408,354,32,3,0,0,6493,13130
12,Varese,43,2632,4190,282,7,2,0,0,7113,1720,4780,420,49,3,0,0,6972,14085
12,Varese,44,2515,4379,319,20,7,0,0,7240,1649,4817,462,54,5,0,1,6988,14228
12,Varese,45,2452,4385,338,15,5,0,0,7195,1600,4918,485,54,2,0,0,7059,14254
12,Varese,46,2293,4671,359,30,2,0,0,7355,1513,5154,559,76,1,0,0,7303,14658
12,Varese,47,2215,4729,402,17,3,0,0,7366,1339,5119,613,100,0,0,0,7171,14537
12,Varese,48,1946,4788,448,32,6,0,0,7220,1256,5196,599,109,3,1,0,7164,14384
12,Varese,49,1826,4936,501,34,5,0,0,7302,1201,5452,674,130,2,0,0,7459,14761
12,Varese,50,1803,5269,481,37,3,0,0,7593,1146,5350,674,150,2,0,0,7322,14915
12,Varese,51,1659,5189,520,41,3,0,0,7412,1078,5448,663,159,3,0,0,7351,14763
12,Varese,52,1472,5420,563,39,4,0,0,7498,977,5618,742,183,0,0,0,7520,15018
12,Varese,53,1350,5562,599,61,6,0,0,7578,1013,5760,728,254,1,0,0,7756,15334
12,Varese,54,1272,5505,539,70,4,0,0,7390,880,5634,684,256,0,0,0,7454,14844
12,Varese,55,1118,5279,538,60,4,0,0,6999,787,5318,666,247,1,0,0,7019,14018
12,Varese,56,973,4907,501,74,2,0,0,6457,709,5094,578,298,1,0,0,6680,13137
12,Varese,57,846,4748,475,93,3,0,0,6165,678,4956,583,305,2,0,0,6524,12689
12,Varese,58,769,4789,434,84,6,0,0,6082,629,4646,539,333,1,0,0,6148,12230
12,Varese,59,694,4568,408,86,1,0,0,5757,543,4872,529,403,0,0,0,6347,12104
12,Varese,60,592,4433,377,105,3,0,0,5510,544,4467,494,372,0,0,0,5877,11387
12,Varese,61,636,4329,371,101,1,0,0,5438,478,4354,416,478,1,0,0,5727,11165
12,Varese,62,526,4275,341,109,0,0,0,5251,480,4313,400,463,0,0,0,5656,10907
12,Varese,63,510,4206,336,125,2,0,0,5179,428,4262,404,525,0,0,1,5620,10799
12,Varese,64,481,4163,291,147,2,0,0,5084,410,4178,355,649,0,0,0,5592,10676
12,Varese,65,454,4073,257,191,1,0,0,4976,360,4074,324,674,0,0,0,5432,10408
12,Varese,66,425,4070,274,171,0,0,0,4940,361,4073,274,744,0,0,0,5452,10392
12,Varese,67,399,4043,228,177,1,0,0,4848,345,3897,270,837,1,0,0,5350,10198
12,Varese,68,410,4179,213,186,0,0,0,4988,350,3970,239,940,0,0,0,5499,10487
12,Varese,69,370,4179,187,267,0,0,0,5003,305,4116,276,1058,2,0,0,5757,10760
12,Varese,70,361,4297,201,266,1,0,0,5126,334,4027,251,1192,0,0,0,5804,10930
12,Varese,71,334,4045,188,285,0,0,0,4852,325,3781,239,1283,0,0,0,5628,10480
12,Varese,72,324,4346,146,304,1,0,0,5121,327,3899,263,1451,0,0,0,5940,11061
12,Varese,73,256,3196,112,239,1,0,0,3804,246,2751,163,1204,0,0,0,4364,8168
12,Varese,74,251,3189,97,289,0,0,0,3826,280,2774,149,1356,0,0,0,4559,8385
12,Varese,75,210,3157,91,327,1,0,0,3786,234,2639,138,1446,0,0,0,4457,8243
12,Varese,76,204,3168,88,320,0,0,0,3780,241,2667,131,1644,0,0,0,4683,8463
12,Varese,77,230,3180,83,386,0,0,0,3879,297,2566,143,1774,0,0,0,4780,8659
12,Varese,78,238,3219,78,427,1,0,0,3963,312,2473,142,2097,2,0,0,5026,8989
12,Varese,79,203,3151,62,455,0,0,0,3871,313,2336,95,2222,0,0,0,4966,8837
12,Varese,80,175,2860,69,484,0,0,0,3588,301,1965,94,2282,0,0,0,4642,8230
12,Varese,81,162,2360,51,445,1,0,0,3019,298,1622,78,2291,0,0,0,4289,7308
12,Varese,82,124,2072,39,429,0,0,0,2664,239,1256,82,2183,0,0,0,3760,6424
12,Varese,83,128,1922,28,428,0,0,0,2506,267,1130,58,2257,0,0,0,3712,6218
12,Varese,84,106,1634,27,432,0,0,0,2199,279,887,46,2300,0,0,0,3512,5711
12,Varese,85,86,1406,26,402,0,0,0,1920,254,731,53,2046,0,0,0,3084,5004
12,Varese,86,90,1159,16,394,0,0,0,1659,235,569,39,2140,0,0,0,2983,4642
12,Varese,87,78,1008,15,371,0,0,0,1472,234,459,32,1958,0,0,0,2683,4155
12,Varese,88,58,874,7,320,0,0,0,1259,220,281,19,1962,0,0,0,2482,3741
12,Varese,89,46,573,6,276,0,0,0,901,169,227,25,1683,0,0,0,2104,3005
12,Varese,90,34,455,10,265,0,0,0,764,172,169,19,1450,0,0,0,1810,2574
12,Varese,91,25,356,4,247,0,0,0,632,159,124,19,1269,0,0,0,1571,2203
12,Varese,92,19,237,3,194,0,0,0,453,120,79,11,1121,0,0,0,1331,1784
12,Varese,93,11,191,4,140,0,0,0,346,102,48,7,893,0,0,0,1050,1396
12,Varese,94,10,99,2,112,0,0,0,223,69,32,4,708,0,0,0,813,1036
12,Varese,95,6,78,3,83,0,0,0,170,65,16,3,515,0,0,0,599,769
12,Varese,96,5,48,0,86,0,0,0,139,52,17,6,370,0,0,0,445,584
12,Varese,97,4,35,0,49,0,0,0,88,36,4,2,284,0,0,0,326,414
12,Varese,98,7,21,0,21,0,0,0,49,26,3,1,221,0,0,0,251,300
12,Varese,99,0,5,0,14,0,0,0,19,15,0,0,111,0,0,0,126,145
12,Varese,100,0,9,0,15,0,0,0,24,19,5,1,171,0,0,0,196,220
13,Como,0,2212,0,0,0,0,0,0,2212,2101,0,0,0,0,0,0,2101,4313
13,Como,1,2344,0,0,0,0,0,0,2344,2267,0,0,0,0,0,0,2267,4611
13,Como,2,2479,0,0,0,0,0,0,2479,2447,0,0,0,0,0,0,2447,4926
13,Como,3,2602,0,0,0,0,0,0,2602,2462,0,0,0,0,0,0,2462,5064
13,Como,4,2654,0,0,0,0,0,0,2654,2502,0,0,0,0,0,0,2502,5156
13,Como,5,2749,0,0,0,0,0,0,2749,2533,0,0,0,0,0,0,2533,5282
13,Como,6,2866,0,0,0,0,0,0,2866,2675,0,0,0,0,0,0,2675,5541
13,Como,7,2868,0,0,0,0,0,0,2868,2709,0,0,0,0,0,0,2709,5577
13,Como,8,2960,0,0,0,0,0,0,2960,2786,0,0,0,0,0,0,2786,5746
13,Como,9,3096,0,0,0,0,0,0,3096,2782,0,0,0,0,0,0,2782,5878
13,Como,10,2998,0,0,0,0,0,0,2998,2865,0,0,0,0,0,0,2865,5863
13,Como,11,2946,0,0,0,0,0,0,2946,2817,0,0,0,0,0,0,2817,5763
13,Como,12,2986,0,0,0,0,0,0,2986,2802,0,0,0,0,0,0,2802,5788
13,Como,13,2960,0,0,0,0,0,0,2960,2769,0,0,0,0,0,0,2769,5729
13,Como,14,2965,0,0,0,0,0,0,2965,2780,0,0,0,0,0,0,2780,5745
13,Como,15,2892,0,0,0,0,0,0,2892,2702,0,0,0,0,0,0,2702,5594
13,Como,16,2722,0,0,0,0,0,0,2722,2676,0,0,0,0,0,0,2676,5398
13,Como,17,2980,0,0,0,0,0,0,2980,2691,0,0,0,0,0,0,2691,5671
13,Como,18,3022,0,0,0,0,0,0,3022,2705,1,0,0,0,0,0,2706,5728
13,Como,19,2918,1,0,0,0,0,0,2919,2790,13,0,0,0,0,0,2803,5722
13,Como,20,3020,3,0,0,0,0,0,3023,2583,31,1,0,0,0,0,2615,5638
13,Como,21,2974,8,0,0,0,0,0,2982,2651,45,0,0,0,0,0,2696,5678
13,Como,22,2922,11,0,0,0,0,0,2933,2651,87,1,0,0,0,0,2739,5672
13,Como,23,2854,23,0,0,0,0,0,2877,2614,115,0,0,0,0,0,2729,5606
13,Como,24,2891,46,2,0,0,0,0,2939,2531,177,1,0,1,0,0,2710,5649
13,Como,25,2912,78,2,1,0,0,0,2993,2407,278,7,0,0,0,0,2692,5685
13,Como,26,2887,114,5,0,0,0,0,3006,2426,377,4,2,1,0,0,2810,5816
13,Como,27,2861,188,3,0,1,0,0,3053,2443,565,7,0,2,0,0,3017,6070
13,Como,28,2837,269,3,1,1,0,0,3111,2250,707,15,0,1,0,0,2973,6084
13,Como,29,2690,455,6,0,1,0,0,3152,2145,888,22,3,2,0,0,3060,6212
13,Como,30,2566,587,8,1,3,0,0,3165,1911,1117,29,1,1,0,0,3059,6224
13,Como,31,2365,712,20,0,1,0,0,3098,1677,1326,24,0,4,0,0,3031,6129
13,Como,32,2293,896,10,0,0,0,0,3199,1665,1480,43,5,1,0,0,3194,6393
13,Como,33,2189,1137,31,1,1,0,0,3359,1545,1635,51,1,3,0,0,3235,6594
13,Como,34,1999,1282,32,0,1,0,0,3314,1469,1812,73,3,3,0,0,3360,6674
13,Como,35,2031,1497,38,0,4,0,0,3570,1369,2043,71,9,3,0,0,3495,7065
13,Como,36,1926,1591,37,1,1,0,0,3556,1394,2093,91,8,3,0,0,3589,7145
13,Como,37,1905,1707,65,4,2,0,0,3683,1259,2210,121,10,1,0,0,3601,7284
13,Como,38,1853,1859,57,3,1,0,0,3773,1214,2243,130,18,4,0,0,3609,7382
13,Como,39,1748,2105,89,3,4,0,0,3949,1181,2484,156,16,0,0,0,3837,7786
13,Como,40,1714,2374,102,4,5,1,0,4200,1096,2737,184,21,2,0,0,4040,8240
13,Como,41,1793,2426,129,2,2,0,0,4352,1188,2884,210,16,2,0,0,4300,8652
13,Como,42,1753,2644,137,10,3,0,0,4547,1186,3082,228,40,1,0,0,4537,9084
13,Como,43,1787,2874,201,7,5,0,0,4874,1190,3225,273,40,1,0,0,4729,9603
13,Como,44,1814,2989,208,10,1,0,0,5022,1072,3370,335,45,2,0,0,4824,9846
13,Como,45,1624,3051,235,10,1,0,0,4921,1063,3436,345,45,1,0,0,4890,9811
13,Como,46,1595,3267,243,16,6,0,0,5127,1024,3479,348,65,1,0,0,4917,10044
13,Como,47,1504,3425,260,11,2,0,1,5203,912,3446,364,63,1,0,0,4786,9989
13,Como,48,1270,3188,290,19,5,0,1,4773,861,3465,392,75,3,0,0,4796,9569
13,Como,49,1338,3446,298,15,0,0,0,5097,883,3782,368,97,0,0,0,5130,10227
13,Como,50,1248,3462,306,27,4,0,0,5047,828,3629,407,101,0,0,0,4965,10012
13,Como,51,1124,3680,329,18,10,0,0,5161,737,3674,421,107,2,0,0,4941,10102
13,Como,52,1069,3890,320,28,5,0,0,5312,750,3806,408,121,5,0,0,5090,10402
13,Como,53,978,3717,383,27,4,0,0,5109,686,3789,397,135,2,0,0,5009,10118
13,Como,54,918,3845,332,28,3,0,0,5126,673,3820,416,166,0,0,0,5075,10201
13,Como,55,796,3416,340,51,3,0,0,4606,570,3601,398,202,2,0,0,4773,9379
13,Como,56,747,3353,309,50,2,0,0,4461,511,3340,380,163,0,0,0,4394,8855
13,Como,57,624,3391,275,45,3,0,0,4338,512,3299,381,206,1,0,0,4399,8737
13,Como,58,574,3156,305,47,1,0,0,4083,429,3322,323,220,2,0,0,4296,8379
13,Como,59,556,3182,258,63,3,0,0,4062,432,3125,322,270,0,0,0,4149,8211
13,Como,60,467,2941,261,60,1,0,0,3730,360,2957,295,282,1,0,0,3895,7625
13,Como,61,456,2946,225,73,3,0,0,3703,320,2949,283,311,2,0,0,3865,7568
13,Como,62,363,2842,269,81,2,0,0,3557,336,2909,260,348,0,0,0,3853,7410
13,Como,63,394,2723,201,97,2,0,0,3417,324,2882,217,342,0,0,0,3765,7182
13,Como,64,355,2708,164,89,3,0,0,3319,297,2741,221,409,1,0,0,3669,6988
13,Como,65,331,2740,174,111,1,0,0,3357,254,2693,197,444,1,0,0,3589,6946
13,Como,66,334,2764,165,102,1,0,0,3366,281,2776,172,481,0,0,0,3710,7076
13,Como,67,315,2772,149,117,1,0,0,3354,247,2621,184,528,0,0,0,3580,6934
13,Como,68,299,2785,124,133,1,0,0,3342,264,2708,169,600,2,0,0,3743,7085
13,Como,69,285,2962,154,140,3,0,1,3545,273,2661,186,646,0,0,0,3766,7311
13,Como,70,306,2891,128,174,0,0,0,3499,262,2578,167,760,0,0,0,3767,7266
13,Como,71,266,2826,108,189,1,0,0,3390,253,2438,146,853,0,0,0,3690,7080
13,Como,72,271,2728,123,194,2,0,0,3318,277,2476,145,958,0,0,0,3856,7174
13,Como,73,171,2106,69,172,2,0,0,2520,183,1689,105,741,0,0,0,2718,5238
13,Como,74,163,2086,77,189,1,0,0,2516,182,1712,113,890,0,0,0,2897,5413
13,Como,75,167,1993,54,199,0,0,0,2413,205,1638,82,984,0,0,0,2909,5322
13,Como,76,183,1936,50,201,0,0,0,2370,194,1568,69,988,0,0,0,2819,5189
13,Como,77,164,1969,38,255,1,0,0,2427,170,1556,68,1166,1,0,0,2961,5388
13,Como,78,178,2164,58,276,0,0,0,2676,238,1480,73,1338,0,0,0,3129,5805
13,Como,79,149,1919,46,278,1,0,0,2393,207,1450,61,1444,0,0,0,3162,5555
13,Como,80,152,1755,35,313,0,0,0,2255,202,1247,54,1487,0,0,0,2990,5245
13,Como,81,113,1477,24,294,0,0,0,1908,222,967,43,1375,1,0,0,2608,4516
13,Como,82,97,1284,26,311,0,0,0,1718,210,822,45,1324,0,0,0,2401,4119
13,Como,83,89,1208,21,266,1,0,0,1585,198,695,33,1409,0,0,0,2335,3920
13,Como,84,82,999,16,294,0,0,0,1391,207,576,27,1465,0,0,0,2275,3666
13,Como,85,70,856,18,230,1,0,0,1175,173,442,16,1440,0,0,0,2071,3246
13,Como,86,57,736,8,276,0,0,0,1077,194,329,23,1361,0,0,0,1907,2984
13,Como,87,53,646,11,222,0,0,0,932,178,283,27,1269,0,0,0,1757,2689
13,Como,88,32,567,8,232,0,0,0,839,177,210,17,1298,0,0,0,1702,2541
13,Como,89,38,366,3,197,0,0,0,604,148,141,15,1137,0,0,0,1441,2045
13,Como,90,34,290,1,187,0,0,0,512,145,102,13,940,0,0,0,1200,1712
13,Como,91,14,219,4,144,0,0,0,381,105,71,10,801,0,0,0,987,1368
13,Como,92,14,147,1,116,0,0,0,278,93,48,7,658,0,0,0,806,1084
13,Como,93,13,93,1,90,0,0,0,197,80,32,6,530,0,0,0,648,845
13,Como,94,9,79,2,69,0,0,0,159,55,24,3,462,0,0,0,544,703
13,Como,95,6,59,0,51,0,0,0,116,66,8,5,343,0,0,0,422,538
13,Como,96,2,25,0,36,0,0,0,63,39,8,3,280,0,0,0,330,393
13,Como,97,3,19,0,35,0,0,0,57,25,2,1,188,0,0,0,216,273
13,Como,98,1,7,0,21,0,0,0,29,20,3,1,134,0,0,0,158,187
13,Como,99,0,1,0,7,0,0,0,8,12,0,1,73,0,0,0,86,94
13,Como,100,0,4,0,8,0,0,0,12,13,0,1,113,0,0,0,127,139
14,Sondrio,0,703,0,0,0,0,0,0,703,642,0,0,0,0,0,0,642,1345
14,Sondrio,1,727,0,0,0,0,0,0,727,693,0,0,0,0,0,0,693,1420
14,Sondrio,2,768,0,0,0,0,0,0,768,690,0,0,0,0,0,0,690,1458
14,Sondrio,3,712,0,0,0,0,0,0,712,737,0,0,0,0,0,0,737,1449
14,Sondrio,4,798,0,0,0,0,0,0,798,723,0,0,0,0,0,0,723,1521
14,Sondrio,5,779,0,0,0,0,0,0,779,708,0,0,0,0,0,0,708,1487
14,Sondrio,6,838,0,0,0,0,0,0,838,749,0,0,0,0,0,0,749,1587
14,Sondrio,7,854,0,0,0,0,0,0,854,773,0,0,0,0,0,0,773,1627
14,Sondrio,8,877,0,0,0,0,0,0,877,766,0,0,0,0,0,0,766,1643
14,Sondrio,9,785,0,0,0,0,0,0,785,757,0,0,0,0,0,0,757,1542
14,Sondrio,10,899,0,0,0,0,0,0,899,792,0,0,0,0,0,0,792,1691
14,Sondrio,11,833,0,0,0,0,0,0,833,791,0,0,0,0,0,0,791,1624
14,Sondrio,12,897,0,0,0,0,0,0,897,831,0,0,0,0,0,0,831,1728
14,Sondrio,13,833,0,0,0,0,0,0,833,821,0,0,0,0,0,0,821,1654
14,Sondrio,14,845,0,0,0,0,0,0,845,827,0,0,0,0,0,0,827,1672
14,Sondrio,15,869,0,0,0,0,0,0,869,856,0,0,0,0,0,0,856,1725
14,Sondrio,16,901,0,0,0,0,0,0,901,808,0,0,0,0,0,0,808,1709
14,Sondrio,17,850,0,0,0,0,0,0,850,829,0,0,0,0,0,0,829,1679
14,Sondrio,18,920,0,0,0,0,0,0,920,878,1,0,0,0,0,0,879,1799
14,Sondrio,19,938,0,0,0,0,0,0,938,846,1,0,0,0,0,0,847,1785
14,Sondrio,20,974,1,0,0,0,0,0,975,848,13,0,0,0,0,0,861,1836
14,Sondrio,21,968,6,0,0,0,0,0,974,881,21,1,0,0,0,0,903,1877
14,Sondrio,22,998,2,0,0,0,0,0,1000,921,32,0,0,0,0,0,953,1953
14,Sondrio,23,978,13,0,0,0,0,0,991,792,48,0,0,0,0,0,840,1831
14,Sondrio,24,899,8,1,0,0,0,0,908,779,64,0,0,1,0,0,844,1752
14,Sondrio,25,923,19,0,0,0,0,0,942,788,102,0,0,0,0,0,890,1832
14,Sondrio,26,912,56,0,0,1,0,0,969,749,151,2,0,1,0,0,903,1872
14,Sondrio,27,934,63,1,0,0,0,0,998,674,169,5,0,0,0,0,848,1846
14,Sondrio,28,887,101,1,0,0,0,0,989,700,223,1,0,0,0,0,924,1913
14,Sondrio,29,799,166,1,0,1,0,0,967,573,279,9,0,0,0,0,861,1828
14,Sondrio,30,753,177,1,0,0,0,0,931,545,324,10,0,1,0,0,880,1811
14,Sondrio,31,694,213,4,0,0,0,0,911,511,387,14,2,0,0,0,914,1825
14,Sondrio,32,640,300,3,0,0,0,0,943,476,434,14,0,0,0,0,924,1867
14,Sondrio,33,649,278,10,0,1,0,0,938,454,461,19,1,0,0,0,935,1873
14,Sondrio,34,621,359,6,0,0,0,0,986,424,520,27,4,1,0,0,976,1962
14,Sondrio,35,622,404,9,0,0,0,0,1035,367,523,28,2,1,0,0,921,1956
14,Sondrio,36,599,431,11,1,1,0,0,1043,386,581,28,3,1,1,0,1000,2043
14,Sondrio,37,586,485,14,0,1,0,0,1086,387,607,30,6,0,0,0,1030,2116
14,Sondrio,38,550,517,16,4,0,0,0,1087,345,657,32,1,0,0,0,1035,2122
14,Sondrio,39,492,506,17,0,0,0,0,1015,318,685,42,11,0,0,0,1056,2071
14,Sondrio,40,514,612,25,2,0,0,0,1153,306,737,51,5,0,0,0,1099,2252
14,Sondrio,41,532,642,32,1,0,0,0,1207,322,772,57,5,1,0,0,1157,2364
14,Sondrio,42,527,712,36,3,1,0,0,1279,305,865,60,12,1,0,0,1243,2522
14,Sondrio,43,506,737,51,0,0,0,0,1294,335,948,74,12,0,0,0,1369,2663
14,Sondrio,44,514,791,54,2,0,0,0,1361,320,882,97,13,0,0,0,1312,2673
14,Sondrio,45,509,832,45,2,0,0,0,1388,286,1000,81,23,0,0,0,1390,2778
14,Sondrio,46,496,871,49,1,1,0,0,1418,297,976,86,17,1,0,0,1377,2795
14,Sondrio,47,441,898,80,6,0,0,0,1425,272,1065,96,25,0,0,0,1458,2883
14,Sondrio,48,401,940,81,4,0,0,0,1426,266,1023,87,26,0,0,0,1402,2828
14,Sondrio,49,421,938,86,7,0,0,0,1452,282,1045,119,40,0,0,0,1486,2938
14,Sondrio,50,427,978,80,10,0,0,0,1495,242,1076,124,39,1,0,0,1482,2977
14,Sondrio,51,398,1012,87,9,0,0,0,1506,228,1072,132,45,1,0,0,1478,2984
14,Sondrio,52,374,1077,105,20,1,0,0,1577,246,1135,112,50,1,0,0,1544,3121
14,Sondrio,53,378,1067,108,9,0,0,0,1562,216,1113,123,57,2,0,0,1511,3073
14,Sondrio,54,332,1105,95,15,0,0,0,1547,225,1142,119,69,0,0,0,1555,3102
14,Sondrio,55,277,1103,105,15,0,0,0,1500,191,1124,109,75,1,0,0,1500,3000
14,Sondrio,56,243,1031,78,14,0,0,0,1366,175,1079,103,81,0,0,0,1438,2804
14,Sondrio,57,249,980,108,16,0,0,0,1353,178,1089,124,87,0,0,0,1478,2831
14,Sondrio,58,225,986,78,20,0,0,0,1309,166,1016,120,94,0,0,0,1396,2705
14,Sondrio,59,236,985,84,23,0,0,0,1328,143,1048,81,125,0,0,0,1397,2725
14,Sondrio,60,186,982,94,23,0,0,0,1285,138,971,84,119,0,0,0,1312,2597
14,Sondrio,61,159,976,69,24,0,0,0,1228,124,925,74,134,0,0,0,1257,2485
14,Sondrio,62,204,900,84,22,0,0,0,1210,123,896,79,118,0,0,0,1216,2426
14,Sondrio,63,161,870,68,31,1,0,0,1131,119,881,69,147,0,0,0,1216,2347
14,Sondrio,64,158,882,76,34,2,0,0,1152,102,862,86,154,0,0,0,1204,2356
14,Sondrio,65,140,881,60,35,1,0,0,1117,112,826,53,157,0,0,0,1148,2265
14,Sondrio,66,144,845,56,35,1,0,0,1081,88,771,64,177,0,0,0,1100,2181
14,Sondrio,67,136,882,59,55,0,0,0,1132,88,807,40,210,0,0,0,1145,2277
14,Sondrio,68,131,927,55,33,0,0,0,1146,74,801,48,233,0,0,0,1156,2302
14,Sondrio,69,124,914,44,59,0,0,0,1141,76,701,31,247,0,0,0,1055,2196
14,Sondrio,70,108,845,31,48,0,0,0,1032,70,773,43,287,0,0,0,1173,2205
14,Sondrio,71,110,793,35,70,0,0,0,1008,94,672,37,297,0,0,0,1100,2108
14,Sondrio,72,123,778,37,73,0,0,0,1011,90,708,30,325,0,0,0,1153,2164
14,Sondrio,73,78,595,20,53,0,0,0,746,42,459,25,303,0,0,0,829,1575
14,Sondrio,74,81,618,21,53,0,0,0,773,53,481,29,317,0,0,0,880,1653
14,Sondrio,75,84,587,22,65,0,0,0,758,62,453,21,337,0,0,0,873,1631
14,Sondrio,76,71,615,13,62,0,0,0,761,63,425,21,378,0,0,0,887,1648
14,Sondrio,77,81,573,21,78,0,0,0,753,44,442,20,394,0,0,0,900,1653
14,Sondrio,78,86,586,10,83,1,0,0,766,59,400,24,471,0,0,0,954,1720
14,Sondrio,79,79,550,15,82,0,0,0,726,67,366,10,481,0,0,0,924,1650
14,Sondrio,80,77,483,8,98,0,0,0,666,60,351,15,456,0,0,0,882,1548
14,Sondrio,81,70,434,8,83,0,0,0,595,46,276,13,492,0,0,0,827,1422
14,Sondrio,82,57,382,7,99,0,0,0,545,57,212,14,468,0,0,0,751,1296
14,Sondrio,83,46,374,6,90,0,0,0,516,53,195,12,508,0,0,0,768,1284
14,Sondrio,84,45,297,4,74,0,0,0,420,54,165,7,479,0,0,0,705,1125
14,Sondrio,85,31,245,4,83,0,0,0,363,65,109,9,468,0,0,0,651,1014
14,Sondrio,86,33,225,2,72,0,0,0,332,55,106,7,480,0,0,0,648,980
14,Sondrio,87,19,184,5,69,0,0,0,277,57,85,8,451,0,0,0,601,878
14,Sondrio,88,22,127,4,62,0,0,0,215,42,65,4,435,0,0,0,546,761
14,Sondrio,89,12,117,2,61,0,0,0,192,44,38,4,350,0,0,0,436,628
14,Sondrio,90,13,83,1,53,0,0,0,150,34,29,1,327,0,0,0,391,541
14,Sondrio,91,5,62,1,49,0,0,0,117,32,17,0,273,0,0,0,322,439
14,Sondrio,92,5,59,0,32,0,0,0,96,27,15,1,253,0,0,0,296,392
14,Sondrio,93,5,19,1,31,0,0,0,56,17,11,0,174,0,0,0,202,258
14,Sondrio,94,1,18,0,23,0,0,0,42,19,6,1,157,0,0,0,183,225
14,Sondrio,95,0,5,0,13,0,0,0,18,14,3,0,124,0,0,0,141,159
14,Sondrio,96,1,8,0,10,0,0,0,19,12,2,0,83,0,0,0,97,116
14,Sondrio,97,0,5,1,6,0,0,0,12,7,1,0,84,0,0,0,92,104
14,Sondrio,98,0,6,0,4,0,0,0,10,4,3,0,45,0,0,0,52,62
14,Sondrio,99,0,2,0,4,0,0,0,6,5,0,0,23,0,0,0,28,34
14,Sondrio,100,0,0,0,4,0,0,0,4,4,1,0,32,0,0,0,37,41
15,Milano,0,12726,0,0,0,0,0,0,12726,12159,0,0,0,0,0,0,12159,24885
15,Milano,1,13487,0,0,0,0,0,0,13487,12782,0,0,0,0,0,0,12782,26269
15,Milano,2,13967,0,0,0,0,0,0,13967,13174,0,0,0,0,0,0,13174,27141
15,Milano,3,14376,0,0,0,0,0,0,14376,13386,0,0,0,0,0,0,13386,27762
15,Milano,4,14590,0,0,0,0,0,0,14590,14036,0,0,0,0,0,0,14036,28626
15,Milano,5,14679,0,0,0,0,0,0,14679,13984,0,0,0,0,0,0,13984,28663
15,Milano,6,15352,0,0,0,0,0,0,15352,14261,0,0,0,0,0,0,14261,29613
15,Milano,7,15508,0,0,0,0,0,0,15508,14465,0,0,0,0,0,0,14465,29973
15,Milano,8,15914,0,0,0,0,0,0,15914,14724,0,0,0,0,0,0,14724,30638
15,Milano,9,15962,0,0,0,0,0,0,15962,15391,0,0,0,0,0,0,15391,31353
15,Milano,10,16138,0,0,0,0,0,0,16138,15346,0,0,0,0,0,0,15346,31484
15,Milano,11,15922,0,0,0,0,0,0,15922,15104,0,0,0,0,0,0,15104,31026
15,Milano,12,16167,0,0,0,0,0,0,16167,15098,0,0,0,0,0,0,15098,31265
15,Milano,13,15798,0,0,0,0,0,0,15798,14665,0,0,0,0,0,0,14665,30463
15,Milano,14,15667,0,0,0,0,0,0,15667,15007,0,0,0,0,0,0,15007,30674
15,Milano,15,15510,0,0,0,0,0,0,15510,14236,0,0,0,0,0,0,14236,29746
15,Milano,16,15072,0,0,0,0,0,0,15072,14082,0,0,0,0,0,0,14082,29154
15,Milano,17,15205,0,0,0,0,0,0,15205,14265,0,0,0,0,0,0,14265,29470
15,Milano,18,15506,0,0,0,0,0,0,15506,14322,11,0,0,0,0,0,14333,29839
15,Milano,19,15620,7,1,0,0,0,0,15628,13856,58,0,0,0,0,0,13914,29542
15,Milano,20,15985,11,1,0,0,0,0,15997,13761,115,0,0,0,0,0,13876,29873
15,Milano,21,15701,33,0,0,0,0,0,15734,13788,238,0,0,2,0,0,14028,29762
15,Milano,22,15637,51,1,0,0,1,0,15690,13794,398,1,0,3,0,0,14196,29886
15,Milano,23,15475,116,0,0,4,0,0,15595,13273,586,2,0,3,0,0,13864,29459
15,Milano,24,15445,208,3,0,5,0,0,15661,13502,916,5,1,3,0,0,14427,30088
15,Milano,25,15501,363,3,0,8,0,0,15875,13381,1233,8,1,2,0,0,14625,30500
15,Milano,26,16091,589,3,0,6,0,0,16689,14031,1892,26,1,4,0,0,15954,32643
15,Milano,27,16212,947,8,0,7,0,0,17174,12791,2383,31,3,4,0,0,15212,32386
15,Milano,28,16267,1454,17,0,21,0,0,17759,13715,3429,55,1,5,0,0,17205,34964
15,Milano,29,15882,2177,40,0,14,1,0,18114,13499,4367,82,2,4,1,0,17955,36069
15,Milano,30,15962,3059,33,1,29,0,0,19084,12556,5676,116,12,6,0,0,18366,37450
15,Milano,31,14796,3817,66,0,26,0,0,18705,11338,6673,174,15,5,0,0,18205,36910
15,Milano,32,14053,4985,83,2,31,0,0,19154,10727,7557,208,21,11,0,0,18524,37678
15,Milano,33,13567,5902,126,5,26,0,0,19626,10005,8827,290,18,10,0,0,19150,38776
15,Milano,34,12866,7103,167,5,27,0,0,20168,9524,9707,313,24,18,0,0,19586,39754
15,Milano,35,12332,8018,216,5,39,0,0,20610,9251,10527,415,40,11,0,0,20244,40854
15,Milano,36,11952,9204,254,15,23,0,0,21448,8799,11767,488,50,17,0,0,21121,42569
15,Milano,37,11282,9894,338,10,35,0,1,21560,8454,12026,607,62,15,1,0,21165,42725
15,Milano,38,10923,10311,351,21,26,0,0,21632,7768,12217,700,58,23,0,1,20767,42399
15,Milano,39,10339,11087,408,18,43,0,0,21895,7759,12904,754,61,17,0,0,21495,43390
15,Milano,40,10480,11858,512,16,36,0,1,22903,7702,13436,920,76,13,0,0,22147,45050
15,Milano,41,10382,12694,555,33,51,0,0,23715,7824,14542,1017,120,27,0,0,23530,47245
15,Milano,42,10387,13314,730,35,22,1,1,24490,7729,15224,1152,135,20,1,0,24261,48751
15,Milano,43,10492,14377,840,42,35,0,0,25786,7856,16283,1439,163,15,0,0,25756,51542
15,Milano,44,10425,15488,956,56,57,0,1,26983,7893,17266,1500,189,19,0,0,26867,53850
15,Milano,45,10037,16024,1033,64,46,0,0,27204,7660,17582,1696,217,14,0,0,27169,54373
15,Milano,46,9394,16417,1157,70,52,0,0,27090,7126,18043,1953,221,21,0,0,27364,54454
15,Milano,47,8990,17100,1307,79,52,1,1,27530,6684,18396,1966,290,28,0,0,27364,54894
15,Milano,48,8232,17178,1388,95,61,0,0,26954,6332,18447,2145,321,16,0,0,27261,54215
15,Milano,49,7807,17948,1622,101,53,0,0,27531,6083,18981,2284,406,13,0,0,27767,55298
15,Milano,50,7264,17997,1644,112,51,0,1,27069,5620,18895,2354,478,17,1,0,27365,54434
15,Milano,51,6870,17854,1651,123,44,0,1,26543,5391,18982,2446,524,18,0,0,27361,53904
15,Milano,52,6708,18457,1769,204,53,0,0,27191,5105,19405,2586,611,14,0,0,27721,54912
15,Milano,53,6155,18620,1848,190,47,0,0,26860,4825,19292,2643,732,16,0,0,27508,54368
15,Milano,54,5440,18861,1964,205,47,0,1,26518,4643,19081,2642,767,17,0,0,27150,53668
15,Milano,55,4659,17524,1811,220,48,0,0,24262,3980,18273,2512,822,10,0,0,25597,49859
15,Milano,56,4118,16662,1764,261,56,0,0,22861,3577,17295,2485,949,10,0,0,24316,47177
15,Milano,57,3802,16242,1662,276,57,0,1,22040,3259,16828,2299,1002,9,0,0,23397,45437
15,Milano,58,3307,15984,1471,293,26,0,1,21082,3018,16195,2177,1137,15,0,0,22542,43624
15,Milano,59,2989,15212,1466,280,33,0,1,19981,2749,15783,2135,1292,8,0,0,21967,41948
15,Milano,60,2740,14902,1320,320,39,0,0,19321,2581,15104,1865,1312,8,0,1,20871,40192
15,Milano,61,2440,14664,1274,341,25,0,0,18744,2411,14942,1897,1484,7,0,0,20741,39485
15,Milano,62,2331,14355,1222,415,21,0,0,18344,2244,14207,1752,1711,7,0,0,19921,38265
15,Milano,63,1967,13996,1112,409,22,0,0,17506,1968,14258,1682,1861,8,0,0,19777,37283
15,Milano,64,1910,13654,1098,455,24,0,0,17141,1855,13582,1547,2037,4,0,0,19025,36166
15,Milano,65,1698,13032,912,458,24,0,0,16124,1633,13109,1454,2204,4,0,0,18404,34528
15,Milano,66,1597,12918,889,476,22,0,0,15902,1652,13167,1422,2259,6,0,0,18506,34408
15,Milano,67,1452,12532,841,573,17,0,1,15416,1471,12780,1362,2659,5,0,1,18278,33694
15,Milano,68,1432,13072,787,699,17,0,0,16007,1436,13224,1288,2941,3,0,1,18893,34900
15,Milano,69,1411,13337,709,718,22,0,0,16197,1497,13236,1291,3341,4,0,1,19370,35567
15,Milano,70,1352,14257,750,878,26,0,0,17263,1459,13557,1336,3946,3,0,0,20301,37564
15,Milano,71,1297,13836,694,963,20,0,0,16810,1400,13155,1263,4406,4,0,0,20228,37038
15,Milano,72,1260,14385,677,1111,12,0,0,17445,1368,13365,1251,4973,1,0,1,20959,38404
15,Milano,73,889,10642,508,909,7,0,0,12955,1077,9447,851,4258,0,0,0,15633,28588
15,Milano,74,926,11039,477,1003,9,0,0,13454,1091,10018,901,4750,1,0,0,16761,30215
15,Milano,75,819,10630,449,1067,11,0,0,12976,1128,9432,813,5064,2,0,0,16439,29415
15,Milano,76,855,10545,389,1135,9,0,0,12933,1086,9124,819,5759,1,0,0,16789,29722
15,Milano,77,777,10464,368,1357,10,0,0,12976,1126,8814,761,6481,0,0,0,17182,30158
15,Milano,78,817,11263,373,1576,5,0,1,14035,1200,9031,723,7542,0,0,0,18496,32531
15,Milano,79,682,10654,323,1641,7,0,0,13307,1201,8425,618,7655,1,0,0,17900,31207
15,Milano,80,614,9892,264,1719,2,0,0,12491,1177,7288,588,7965,0,0,0,17018,29509
15,Milano,81,518,8360,223,1687,10,0,0,10798,1024,5926,456,8039,0,0,0,15445,26243
15,Milano,82,417,7279,183,1548,3,0,1,9431,918,4739,452,7572,0,0,1,13682,23113
15,Milano,83,402,6703,167,1601,0,0,0,8873,960,4116,373,8225,0,0,0,13674,22547
15,Milano,84,377,5825,116,1567,3,0,0,7888,899,3449,330,7848,0,0,2,12528,20416
15,Milano,85,298,4873,97,1536,3,0,0,6807,844,2741,274,7643,1,0,0,11503,18310
15,Milano,86,255,4224,82,1372,1,0,1,5935,861,2148,247,7371,0,0,0,10627,16562
15,Milano,87,191,3653,65,1352,6,0,0,5267,786,1672,198,7056,0,0,0,9712,14979
15,Milano,88,163,2934,61,1250,4,0,1,4413,743,1320,215,6745,0,0,0,9023,13436
15,Milano,89,135,2281,50,1117,0,0,1,3584,612,971,139,5809,1,0,1,7533,11117
15,Milano,90,115,1717,32,914,2,0,0,2780,553,644,127,5074,0,0,0,6398,9178
15,Milano,91,78,1188,23,804,0,0,0,2093,456,449,92,4304,0,0,0,5301,7394
15,Milano,92,63,871,11,636,1,0,0,1582,358,298,85,3666,0,0,1,4408,5990
15,Milano,93,43,589,15,506,0,0,0,1153,336,197,62,3108,1,0,1,3705,4858
15,Milano,94,38,388,5,393,0,0,0,824,277,142,54,2437,0,0,0,2910,3734
15,Milano,95,28,257,4,355,0,0,0,644,199,82,33,1991,0,0,0,2305,2949
15,Milano,96,15,157,1,201,0,0,0,374,130,57,33,1436,0,0,1,1657,2031
15,Milano,97,7,97,2,137,0,0,0,243,113,26,14,1152,0,0,0,1305,1548
15,Milano,98,9,68,1,106,0,0,0,184,62,28,16,785,0,0,0,891,1075
15,Milano,99,6,18,0,38,0,0,0,62,28,8,3,370,0,0,0,409,471
15,Milano,100,7,24,1,65,0,0,0,97,72,4,9,619,0,0,0,704,801
16,Bergamo,0,4406,0,0,0,0,0,0,4406,4140,0,0,0,0,0,0,4140,8546
16,Bergamo,1,4664,0,0,0,0,0,0,4664,4482,0,0,0,0,0,0,4482,9146
16,Bergamo,2,4922,0,0,0,0,0,0,4922,4572,0,0,0,0,0,0,4572,9494
16,Bergamo,3,5005,0,0,0,0,0,0,5005,4649,0,0,0,0,0,0,4649,9654
16,Bergamo,4,5192,0,0,0,0,0,0,5192,4959,0,0,0,0,0,0,4959,10151
16,Bergamo,5,5461,0,0,0,0,0,0,5461,4945,0,0,0,0,0,0,4945,10406
16,Bergamo,6,5637,0,0,0,0,0,0,5637,5244,0,0,0,0,0,0,5244,10881
16,Bergamo,7,5803,0,0,0,0,0,0,5803,5517,0,0,0,0,0,0,5517,11320
16,Bergamo,8,5915,0,0,0,0,0,0,5915,5636,0,0,0,0,0,0,5636,11551
16,Bergamo,9,6056,0,0,0,0,0,0,6056,5854,0,0,0,0,0,0,5854,11910
16,Bergamo,10,6008,0,0,0,0,0,0,6008,5768,0,0,0,0,0,0,5768,11776
16,Bergamo,11,5921,0,0,0,0,0,0,5921,5727,0,0,0,0,0,0,5727,11648
16,Bergamo,12,6106,0,0,0,0,0,0,6106,5608,0,0,0,0,0,0,5608,11714
16,Bergamo,13,5935,0,0,0,0,0,0,5935,5559,0,0,0,0,0,0,5559,11494
16,Bergamo,14,5859,0,0,0,0,0,0,5859,5631,0,0,0,0,0,0,5631,11490
16,Bergamo,15,5906,0,0,0,0,0,0,5906,5624,0,0,0,0,0,0,5624,11530
16,Bergamo,16,5880,0,0,0,0,0,0,5880,5460,0,0,0,0,0,0,5460,11340
16,Bergamo,17,5974,0,0,0,0,0,0,5974,5457,0,0,0,0,0,0,5457,11431
16,Bergamo,18,5993,1,0,0,0,0,0,5994,5660,6,0,0,0,0,0,5666,11660
16,Bergamo,19,5893,0,0,0,0,0,0,5893,5465,34,0,0,0,0,0,5499,11392
16,Bergamo,20,6141,4,0,0,1,0,0,6146,5331,79,0,0,0,0,0,5410,11556
16,Bergamo,21,6075,5,0,0,1,0,0,6081,5253,133,2,0,0,0,0,5388,11469
16,Bergamo,22,5735,19,0,0,0,0,0,5754,5181,200,0,0,0,0,0,5381,11135
16,Bergamo,23,5638,52,1,0,2,0,0,5693,5108,289,3,0,0,0,0,5400,11093
16,Bergamo,24,5571,70,1,0,0,0,0,5642,4872,403,3,0,0,0,0,5278,10920
16,Bergamo,25,5544,156,2,0,2,0,0,5704,4635,648,2,4,2,0,0,5291,10995
16,Bergamo,26,5624,255,6,0,1,0,0,5886,4539,939,7,0,0,0,0,5485,11371
16,Bergamo,27,5388,405,2,0,1,0,0,5796,4488,1194,8,1,0,0,0,5691,11487
16,Bergamo,28,5260,644,9,1,3,0,0,5917,4121,1579,23,0,1,0,0,5724,11641
16,Bergamo,29,4923,864,7,0,1,0,0,5795,3830,1918,32,4,4,0,0,5788,11583
16,Bergamo,30,4874,1244,13,1,6,0,0,6138,3628,2312,38,5,2,0,0,5985,12123
16,Bergamo,31,4520,1480,20,0,8,0,0,6028,3076,2750,69,8,3,0,0,5906,11934
16,Bergamo,32,4123,1819,33,2,5,0,0,5982,2806,2962,80,9,3,0,0,5860,11842
16,Bergamo,33,4002,2129,32,2,3,0,0,6168,2727,3409,105,9,4,0,0,6254,12422
16,Bergamo,34,3971,2468,58,2,1,0,0,6500,2574,3711,122,18,4,0,0,6429,12929
16,Bergamo,35,3649,2806,65,6,5,0,0,6531,2403,4034,147,20,4,0,0,6608,13139
16,Bergamo,36,3610,3165,89,1,3,0,0,6868,2187,4259,178,22,4,1,0,6651,13519
16,Bergamo,37,3499,3432,84,4,4,1,0,7024,2190,4359,200,29,2,0,0,6780,13804
16,Bergamo,38,3309,3748,111,7,5,0,1,7181,2094,4650,256,32,4,0,0,7036,14217
16,Bergamo,39,3123,4005,170,7,10,0,0,7315,2015,4861,317,30,2,0,0,7225,14540
16,Bergamo,40,3397,4445,201,6,6,0,0,8055,2039,5312,326,44,4,0,0,7725,15780
16,Bergamo,41,3132,4700,213,14,14,0,0,8073,1947,5489,389,46,5,0,0,7876,15949
16,Bergamo,42,3106,5157,280,11,9,0,0,8563,1856,5698,415,60,1,1,0,8031,16594
16,Bergamo,43,3231,5520,297,16,12,0,0,9076,1913,6236,450,59,5,0,0,8663,17739
16,Bergamo,44,3097,5840,377,11,9,0,0,9334,1871,6231,519,72,3,0,0,8696,18030
16,Bergamo,45,2920,5881,414,20,5,0,0,9240,1731,6490,585,76,4,0,0,8886,18126
16,Bergamo,46,2826,6208,400,16,2,0,0,9452,1645,6414,586,89,3,0,0,8737,18189
16,Bergamo,47,2495,6212,482,33,7,0,0,9229,1502,6501,568,115,2,0,0,8688,17917
16,Bergamo,48,2452,6426,503,34,8,0,0,9423,1380,6607,642,137,4,0,0,8770,18193
16,Bergamo,49,2370,6588,496,27,11,0,0,9492,1356,6677,694,166,1,0,0,8894,18386
16,Bergamo,50,2244,6672,515,48,10,0,0,9489,1235,6806,717,180,4,0,0,8942,18431
16,Bergamo,51,2015,6671,563,46,8,0,0,9303,1330,6958,607,221,2,0,0,9118,18421
16,Bergamo,52,2057,7049,586,66,11,0,1,9770,1235,7115,700,225,4,0,0,9279,19049
16,Bergamo,53,1890,7087,575,79,7,0,0,9638,1194,7075,646,279,1,0,0,9195,18833
16,Bergamo,54,1730,7265,633,79,10,0,0,9717,1081,7100,728,338,2,0,0,9249,18966
16,Bergamo,55,1480,6695,571,84,5,0,0,8835,989,6779,664,318,2,0,0,8752,17587
16,Bergamo,56,1269,6506,520,81,11,1,0,8388,885,6446,594,381,3,0,0,8309,16697
16,Bergamo,57,1181,6180,511,91,3,0,0,7966,848,6147,544,410,3,0,0,7952,15918
16,Bergamo,58,1102,6226,496,115,5,0,0,7944,736,6057,535,445,1,0,0,7774,15718
16,Bergamo,59,940,6109,467,126,6,0,0,7648,746,5857,491,469,2,0,0,7565,15213
16,Bergamo,60,940,5894,407,130,3,1,0,7375,630,5659,451,558,1,0,0,7299,14674
16,Bergamo,61,826,5571,346,141,4,0,0,6888,593,5329,415,536,0,0,0,6873,13761
16,Bergamo,62,739,5506,339,154,5,0,0,6743,577,5405,411,627,0,0,0,7020,13763
16,Bergamo,63,759,5324,307,165,2,0,0,6557,489,5251,327,715,0,0,0,6782,13339
16,Bergamo,64,677,5317,298,170,3,0,0,6465,469,4945,339,793,0,0,0,6546,13011
16,Bergamo,65,636,5176,277,208,1,0,0,6298,446,4838,302,809,0,0,0,6395,12693
16,Bergamo,66,608,5069,209,212,0,0,0,6098,435,4650,279,911,0,0,0,6275,12373
16,Bergamo,67,591,4896,218,222,6,0,0,5933,416,4744,295,950,0,0,0,6405,12338
16,Bergamo,68,638,5262,219,282,4,0,0,6405,425,4837,247,1131,0,0,0,6640,13045
16,Bergamo,69,556,5226,204,321,1,0,1,6309,395,4616,219,1335,0,0,0,6565,12874
16,Bergamo,70,538,5138,190,279,2,0,0,6147,399,4589,214,1481,1,0,0,6684,12831
16,Bergamo,71,461,4821,170,288,1,0,0,5741,370,4130,195,1437,0,0,0,6132,11873
16,Bergamo,72,459,4912,146,374,1,0,0,5892,370,4064,182,1652,0,0,0,6268,12160
16,Bergamo,73,351,3563,101,306,1,0,0,4322,305,2961,99,1429,0,0,0,4794,9116
16,Bergamo,74,342,3676,98,357,2,0,0,4475,297,3017,100,1691,0,0,0,5105,9580
16,Bergamo,75,355,3473,91,354,1,0,0,4274,319,2794,121,1755,0,0,0,4989,9263
16,Bergamo,76,343,3487,104,438,0,0,0,4372,287,2812,99,1971,0,0,0,5169,9541
16,Bergamo,77,327,3333,67,416,0,0,0,4143,342,2497,95,2079,0,0,0,5013,9156
16,Bergamo,78,325,3473,80,555,0,0,0,4433,371,2589,83,2513,0,0,0,5556,9989
16,Bergamo,79,301,3239,65,531,0,0,0,4136,379,2148,82,2467,0,0,0,5076,9212
16,Bergamo,80,261,2903,61,560,0,0,0,3785,354,1922,68,2668,0,0,0,5012,8797
16,Bergamo,81,216,2451,45,503,0,0,0,3215,318,1574,63,2386,0,0,0,4341,7556
16,Bergamo,82,182,1989,24,461,0,0,0,2656,315,1192,44,2328,0,0,0,3879,6535
16,Bergamo,83,177,1903,38,497,0,0,0,2615,339,1094,46,2463,0,0,0,3942,6557
16,Bergamo,84,134,1603,20,483,0,0,0,2240,312,878,37,2356,0,0,0,3583,5823
16,Bergamo,85,143,1351,14,476,0,0,0,1984,307,660,27,2311,0,0,0,3305,5289
16,Bergamo,86,109,1162,12,467,0,0,0,1750,299,531,23,2272,0,0,0,3125,4875
16,Bergamo,87,92,877,9,417,0,0,0,1395,308,407,23,2086,0,0,0,2824,4219
16,Bergamo,88,80,791,9,394,0,0,0,1274,297,284,17,2042,0,0,0,2640,3914
16,Bergamo,89,49,594,9,291,0,0,0,943,254,187,16,1760,0,0,0,2217,3160
16,Bergamo,90,42,419,6,270,0,0,0,737,223,165,9,1513,1,0,0,1911,2648
16,Bergamo,91,36,336,2,229,0,0,0,603,183,90,6,1381,0,0,0,1660,2263
16,Bergamo,92,25,210,3,199,0,0,0,437,156,66,7,1005,0,0,0,1234,1671
16,Bergamo,93,19,138,0,165,0,0,0,322,135,36,2,870,0,0,0,1043,1365
16,Bergamo,94,11,86,5,115,0,0,0,217,98,27,4,754,0,0,0,883,1100
16,Bergamo,95,13,55,0,87,0,0,0,155,97,16,1,517,0,0,0,631,786
16,Bergamo,96,5,28,0,45,0,0,0,78,60,6,2,342,0,0,0,410,488
16,Bergamo,97,6,18,0,48,0,0,0,72,39,5,2,309,0,0,0,355,427
16,Bergamo,98,0,9,0,27,0,0,0,36,25,3,0,181,0,0,0,209,245
16,Bergamo,99,0,5,0,12,0,0,0,17,9,1,0,93,0,0,0,103,120
16,Bergamo,100,1,0,0,11,0,0,0,12,20,2,2,135,0,0,0,159,171
17,Brescia,0,5034,0,0,0,0,0,0,5034,4732,0,0,0,0,0,0,4732,9766
17,Brescia,1,5278,0,0,0,0,0,0,5278,5003,0,0,0,0,0,0,5003,10281
17,Brescia,2,5383,0,0,0,0,0,0,5383,5301,0,0,0,0,0,0,5301,10684
17,Brescia,3,5670,0,0,0,0,0,0,5670,5422,0,0,0,0,0,0,5422,11092
17,Brescia,4,5718,0,0,0,0,0,0,5718,5534,0,0,0,0,0,0,5534,11252
17,Brescia,5,5925,0,0,0,0,0,0,5925,5665,0,0,0,0,0,0,5665,11590
17,Brescia,6,6014,0,0,0,0,0,0,6014,5910,0,0,0,0,0,0,5910,11924
17,Brescia,7,6429,0,0,0,0,0,0,6429,6010,0,0,0,0,0,0,6010,12439
17,Brescia,8,6824,0,0,0,0,0,0,6824,6316,0,0,0,0,0,0,6316,13140
17,Brescia,9,6762,0,0,0,0,0,0,6762,6441,0,0,0,0,0,0,6441,13203
17,Brescia,10,6815,0,0,0,0,0,0,6815,6368,0,0,0,0,0,0,6368,13183
17,Brescia,11,6839,0,0,0,0,0,0,6839,6414,0,0,0,0,0,0,6414,13253
17,Brescia,12,6734,0,0,0,0,0,0,6734,6404,0,0,0,0,0,0,6404,13138
17,Brescia,13,6402,0,0,0,0,0,0,6402,6161,0,0,0,0,0,0,6161,12563
17,Brescia,14,6522,0,0,0,0,0,0,6522,6194,0,0,0,0,0,0,6194,12716
17,Brescia,15,6456,0,0,0,0,0,0,6456,6046,0,0,0,0,0,0,6046,12502
17,Brescia,16,6438,0,0,0,0,0,0,6438,5883,0,0,0,0,0,0,5883,12321
17,Brescia,17,6610,0,0,0,0,0,0,6610,6058,1,0,0,0,0,0,6059,12669
17,Brescia,18,6613,1,0,0,0,0,0,6614,6019,5,1,0,0,0,0,6025,12639
17,Brescia,19,6662,2,0,0,0,0,0,6664,5964,44,0,0,1,0,0,6009,12673
17,Brescia,20,6744,7,0,0,0,0,0,6751,5904,108,0,0,0,0,0,6012,12763
17,Brescia,21,6592,26,0,0,0,0,0,6618,5761,191,3,0,0,0,0,5955,12573
17,Brescia,22,6441,40,0,0,1,0,0,6482,5687,264,4,0,0,0,0,5955,12437
17,Brescia,23,6413,76,0,0,0,0,0,6489,5486,437,6,0,1,0,0,5930,12419
17,Brescia,24,6169,127,2,0,1,0,0,6299,5351,658,5,1,1,0,0,6016,12315
17,Brescia,25,6348,245,1,0,1,0,0,6595,5272,826,10,1,2,0,0,6111,12706
17,Brescia,26,6277,355,4,0,1,0,0,6637,5094,1121,13,1,4,0,0,6233,12870
17,Brescia,27,5840,575,9,1,3,0,0,6428,4846,1458,25,3,2,0,0,6334,12762
17,Brescia,28,5876,851,9,0,2,0,0,6738,4511,2042,28,1,3,0,0,6585,13323
17,Brescia,29,5601,1153,14,0,3,0,0,6771,4096,2400,51,5,6,0,0,6558,13329
17,Brescia,30,5484,1565,19,1,3,0,0,7072,3962,2806,64,3,2,0,0,6837,13909
17,Brescia,31,4997,1801,29,1,7,0,0,6835,3476,3152,81,7,5,0,0,6721,13556
17,Brescia,32,4629,2076,40,1,4,0,0,6750,3179,3540,124,8,1,0,0,6852,13602
17,Brescia,33,4605,2529,65,2,7,0,0,7208,3083,3812,141,17,3,0,0,7056,14264
17,Brescia,34,4394,3027,75,1,3,0,0,7500,2846,4246,170,12,5,0,0,7279,14779
17,Brescia,35,4276,3316,97,2,8,0,0,7699,2834,4472,239,20,7,0,0,7572,15271
17,Brescia,36,4117,3664,134,2,9,0,0,7926,2715,4897,255,21,10,0,0,7898,15824
17,Brescia,37,3949,3882,162,3,6,0,0,8002,2566,5006,335,43,6,0,0,7956,15958
17,Brescia,38,3779,4209,186,9,9,0,0,8192,2512,5332,345,38,3,0,0,8230,16422
17,Brescia,39,3630,4551,205,3,7,0,0,8396,2344,5419,408,45,7,0,0,8223,16619
17,Brescia,40,3563,5061,271,5,15,0,0,8915,2362,5908,441,42,4,0,0,8757,17672
17,Brescia,41,3800,5391,293,7,17,0,0,9508,2198,6190,539,72,5,0,0,9004,18512
17,Brescia,42,3666,5604,358,10,11,0,0,9649,2288,6473,617,77,5,0,0,9460,19109
17,Brescia,43,3702,6362,439,21,12,0,0,10536,2320,6973,692,86,7,0,0,10078,20614
17,Brescia,44,3586,6641,493,16,14,0,0,10750,2208,7251,756,95,4,0,0,10314,21064
17,Brescia,45,3300,6684,543,18,10,0,0,10555,2014,7160,749,121,6,0,0,10050,20605
17,Brescia,46,3154,6922,608,29,10,0,0,10723,1918,7235,779,161,2,0,0,10095,20818
17,Brescia,47,2900,7038,656,30,8,0,0,10632,1830,7163,818,148,10,0,0,9969,20601
17,Brescia,48,2709,7274,670,34,4,0,0,10691,1664,7328,858,156,4,0,0,10010,20701
17,Brescia,49,2584,7470,750,34,12,1,0,10851,1629,7464,894,200,2,0,0,10189,21040
17,Brescia,50,2401,7569,671,46,13,1,0,10701,1495,7654,899,204,6,0,0,10258,20959
17,Brescia,51,2263,7646,738,68,11,0,0,10726,1540,7691,887,239,5,1,0,10363,21089
17,Brescia,52,2169,7652,822,77,8,0,0,10728,1429,7621,944,287,2,0,0,10283,21011
17,Brescia,53,2001,7563,729,65,14,0,0,10372,1345,7725,931,317,1,0,1,10320,20692
17,Brescia,54,1801,7955,719,86,18,0,0,10579,1319,7741,930,361,0,0,0,10351,20930
17,Brescia,55,1622,7308,715,100,13,0,0,9758,1131,7380,851,397,7,0,0,9766,19524
17,Brescia,56,1474,7155,701,110,3,0,0,9443,1033,7054,790,408,2,0,0,9287,18730
17,Brescia,57,1292,7084,648,106,8,0,0,9138,1028,6939,746,460,7,0,0,9180,18318
17,Brescia,58,1186,6786,605,122,12,0,0,8711,929,6623,694,502,1,0,0,8749,17460
17,Brescia,59,1067,6425,577,120,10,0,1,8200,851,6419,652,540,6,1,0,8469,16669
17,Brescia,60,994,6349,511,127,5,0,0,7986,746,6102,594,613,1,0,0,8056,16042
17,Brescia,61,929,6149,511,147,4,0,0,7740,730,6095,570,632,5,0,1,8033,15773
17,Brescia,62,923,6152,463,161,6,0,0,7705,714,5868,537,737,1,0,0,7857,15562
17,Brescia,63,819,5829,436,166,2,0,0,7252,620,5615,501,761,1,0,1,7499,14751
17,Brescia,64,784,5784,395,175,7,0,0,7145,591,5539,457,789,1,0,0,7377,14522
17,Brescia,65,688,5623,331,206,2,0,0,6850,539,5359,419,872,0,0,0,7189,14039
17,Brescia,66,713,5473,338,218,6,0,0,6748,550,5325,334,993,0,0,1,7203,13951
17,Brescia,67,671,5372,291,241,3,0,0,6578,490,5242,333,1099,0,0,0,7164,13742
17,Brescia,68,640,5771,291,270,6,0,0,6978,511,5275,323,1239,2,0,0,7350,14328
17,Brescia,69,644,5636,261,342,6,0,0,6889,501,5221,313,1369,0,0,0,7404,14293
17,Brescia,70,639,5906,233,341,5,0,0,7124,512,5201,292,1616,0,0,0,7621,14745
17,Brescia,71,540,5565,231,379,2,0,0,6717,501,4828,271,1663,3,0,0,7266,13983
17,Brescia,72,573,5530,216,377,1,0,0,6697,470,4782,284,1910,0,0,0,7446,14143
17,Brescia,73,393,3874,148,325,1,0,0,4741,324,3321,190,1554,0,0,0,5389,10130
17,Brescia,74,447,4299,120,404,0,0,0,5270,397,3530,174,1864,1,0,0,5966,11236
17,Brescia,75,388,4133,114,433,4,0,0,5072,355,3364,136,2108,0,0,0,5963,11035
17,Brescia,76,466,4073,88,468,2,0,0,5097,374,3222,146,2190,0,0,0,5932,11029
17,Brescia,77,471,3961,96,507,2,0,0,5037,392,3066,148,2457,0,0,0,6063,11100
17,Brescia,78,411,4053,87,591,0,0,0,5142,452,2992,134,2839,0,0,0,6417,11559
17,Brescia,79,380,3872,82,590,0,0,0,4924,455,2650,117,3027,0,0,0,6249,11173
17,Brescia,80,342,3490,70,634,0,0,0,4536,427,2375,82,3041,0,0,0,5925,10461
17,Brescia,81,273,2854,53,564,0,0,0,3744,390,1811,89,2855,0,0,0,5145,8889
17,Brescia,82,218,2297,31,504,0,0,0,3050,370,1456,54,2756,0,0,0,4636,7686
17,Brescia,83,217,2217,38,548,0,0,0,3020,333,1354,57,2898,0,0,0,4642,7662
17,Brescia,84,208,1798,32,516,0,0,0,2554,331,948,41,2822,1,0,0,4143,6697
17,Brescia,85,172,1536,17,494,1,0,0,2220,319,833,37,2784,0,0,0,3973,6193
17,Brescia,86,167,1406,18,490,0,0,0,2081,314,646,42,2715,0,0,0,3717,5798
17,Brescia,87,124,1045,15,449,0,0,0,1633,298,513,28,2601,1,0,0,3441,5074
17,Brescia,88,103,928,8,441,0,0,0,1480,307,404,42,2494,0,0,0,3247,4727
17,Brescia,89,69,697,8,411,0,0,0,1185,296,287,21,2262,0,0,0,2866,4051
17,Brescia,90,56,500,6,341,0,0,0,903,255,222,15,1994,0,0,0,2486,3389
17,Brescia,91,39,406,5,242,0,0,0,692,230,129,19,1755,0,0,0,2133,2825
17,Brescia,92,34,253,5,224,0,0,0,516,198,79,10,1437,0,0,0,1724,2240
17,Brescia,93,17,199,1,182,0,0,0,399,146,71,12,1155,0,0,1,1385,1784
17,Brescia,94,19,99,1,167,0,0,0,286,115,36,7,929,0,0,0,1087,1373
17,Brescia,95,10,87,0,122,0,0,0,219,85,26,6,733,0,0,0,850,1069
17,Brescia,96,3,41,1,56,0,0,0,101,76,13,2,545,0,0,0,636,737
17,Brescia,97,3,26,0,59,0,0,0,88,51,8,3,390,0,0,0,452,540
17,Brescia,98,3,15,0,36,0,0,0,54,34,1,2,258,0,0,0,295,349
17,Brescia,99,1,7,1,21,0,0,0,30,12,2,0,137,0,0,0,151,181
17,Brescia,100,4,7,1,21,0,0,0,33,22,1,4,186,0,0,0,213,246
18,Pavia,0,1955,0,0,0,0,0,0,1955,1805,0,0,0,0,0,0,1805,3760
18,Pavia,1,2038,0,0,0,0,0,0,2038,1855,0,0,0,0,0,0,1855,3893
18,Pavia,2,2093,0,0,0,0,0,0,2093,1949,0,0,0,0,0,0,1949,4042
18,Pavia,3,2195,0,0,0,0,0,0,2195,2093,0,0,0,0,0,0,2093,4288
18,Pavia,4,2199,0,0,0,0,0,0,2199,2019,0,0,0,0,0,0,2019,4218
18,Pavia,5,2253,0,0,0,0,0,0,2253,2165,0,0,0,0,0,0,2165,4418
18,Pavia,6,2296,0,0,0,0,0,0,2296,2276,0,0,0,0,0,0,2276,4572
18,Pavia,7,2347,0,0,0,0,0,0,2347,2240,0,0,0,0,0,0,2240,4587
18,Pavia,8,2427,0,0,0,0,0,0,2427,2272,0,0,0,0,0,0,2272,4699
18,Pavia,9,2527,0,0,0,0,0,0,2527,2336,0,0,0,0,0,0,2336,4863
18,Pavia,10,2485,0,0,0,0,0,0,2485,2471,0,0,0,0,0,0,2471,4956
18,Pavia,11,2430,0,0,0,0,0,0,2430,2340,0,0,0,0,0,0,2340,4770
18,Pavia,12,2442,0,0,0,0,0,0,2442,2330,0,0,0,0,0,0,2330,4772
18,Pavia,13,2463,0,0,0,0,0,0,2463,2298,0,0,0,0,0,0,2298,4761
18,Pavia,14,2455,0,0,0,0,0,0,2455,2266,0,0,0,0,0,0,2266,4721
18,Pavia,15,2453,0,0,0,0,0,0,2453,2126,0,0,0,0,0,0,2126,4579
18,Pavia,16,2372,0,0,0,0,0,0,2372,2198,0,0,0,0,0,0,2198,4570
18,Pavia,17,2376,0,0,0,0,0,0,2376,2291,0,0,0,0,0,0,2291,4667
18,Pavia,18,2508,0,0,0,0,0,0,2508,2228,5,0,0,0,0,0,2233,4741
18,Pavia,19,2451,1,0,0,0,0,0,2452,2209,16,1,0,1,0,0,2227,4679
18,Pavia,20,2518,6,0,0,0,0,0,2524,2270,38,0,0,0,0,0,2308,4832
18,Pavia,21,2563,10,1,0,0,0,0,2574,2220,83,0,0,0,0,0,2303,4877
18,Pavia,22,2493,18,0,0,1,0,0,2512,2131,112,0,0,1,0,0,2244,4756
18,Pavia,23,2499,27,1,0,0,0,0,2527,2156,188,2,0,1,0,0,2347,4874
18,Pavia,24,2510,56,2,0,0,0,0,2568,2103,226,1,0,0,0,0,2330,4898
18,Pavia,25,2514,73,2,0,0,0,0,2589,2153,311,3,0,0,0,0,2467,5056
18,Pavia,26,2521,128,1,0,2,0,0,2652,2100,417,6,1,0,1,0,2525,5177
18,Pavia,27,2568,197,3,1,0,0,0,2769,2033,512,9,0,2,0,0,2556,5325
18,Pavia,28,2621,315,5,0,1,0,0,2942,2008,644,17,1,0,0,0,2670,5612
18,Pavia,29,2438,425,6,0,1,0,0,2870,1905,818,19,0,1,0,0,2743,5613
18,Pavia,30,2399,546,9,0,1,0,0,2955,1750,1017,25,3,1,0,0,2796,5751
18,Pavia,31,2257,672,14,0,1,0,0,2944,1560,1213,43,3,0,0,0,2819,5763
18,Pavia,32,2111,845,12,0,1,0,0,2969,1493,1277,45,3,2,0,0,2820,5789
18,Pavia,33,1973,950,28,0,2,0,0,2953,1436,1461,54,3,2,0,0,2956,5909
18,Pavia,34,1864,1174,36,1,1,0,0,3076,1365,1557,66,6,1,0,0,2995,6071
18,Pavia,35,1806,1201,38,1,1,0,0,3047,1331,1700,79,8,4,0,0,3122,6169
18,Pavia,36,1863,1444,50,2,0,0,0,3359,1188,1820,92,9,4,0,0,3113,6472
18,Pavia,37,1753,1437,59,0,1,0,0,3250,1246,1839,112,17,2,0,0,3216,6466
18,Pavia,38,1753,1608,65,0,0,0,0,3426,1124,2079,120,9,1,0,0,3333,6759
18,Pavia,39,1738,1795,86,2,1,1,0,3623,1210,2092,171,28,0,0,0,3501,7124
18,Pavia,40,1759,1891,119,4,2,0,0,3775,1139,2302,171,32,2,0,0,3646,7421
18,Pavia,41,1767,2141,136,4,3,0,0,4051,1170,2326,204,18,2,1,1,3722,7773
18,Pavia,42,1761,2306,135,1,4,0,0,4207,1103,2604,249,30,1,0,0,3987,8194
18,Pavia,43,1786,2331,187,4,5,1,0,4314,1183,2701,263,31,3,0,0,4181,8495
18,Pavia,44,1711,2623,201,8,0,0,0,4543,1135,2926,325,40,0,0,0,4426,8969
18,Pavia,45,1572,2663,245,14,3,0,0,4497,1077,3042,321,50,3,0,1,4494,8991
18,Pavia,46,1595,2761,236,10,5,0,0,4607,987,3033,355,67,0,0,0,4442,9049
18,Pavia,47,1483,2806,281,14,1,0,0,4585,923,2997,368,58,1,0,0,4347,8932
18,Pavia,48,1399,2904,262,14,6,0,1,4586,849,2990,363,84,2,0,0,4288,8874
18,Pavia,49,1264,3021,291,22,4,0,0,4602,858,3226,426,83,3,0,0,4596,9198
18,Pavia,50,1267,3026,306,31,8,0,0,4638,756,3232,378,101,2,1,0,4470,9108
18,Pavia,51,1200,3178,358,27,1,0,0,4764,785,3230,432,128,2,0,0,4577,9341
18,Pavia,52,1139,3253,366,37,5,0,0,4800,743,3300,452,139,1,0,0,4635,9435
18,Pavia,53,1076,3205,411,32,1,0,0,4725,644,3181,458,144,0,0,1,4428,9153
18,Pavia,54,904,3245,390,47,1,0,1,4588,629,3403,407,166,0,0,0,4605,9193
18,Pavia,55,889,3121,367,45,3,0,1,4426,564,3255,407,182,0,0,0,4408,8834
18,Pavia,56,800,3093,330,42,3,0,0,4268,515,3139,390,206,0,0,0,4250,8518
18,Pavia,57,664,2978,322,45,2,0,0,4011,513,3016,369,245,1,0,0,4144,8155
18,Pavia,58,626,2843,298,53,6,0,0,3826,497,2916,356,246,0,0,0,4015,7841
18,Pavia,59,600,2944,311,70,2,0,0,3927,420,2877,325,269,1,0,0,3892,7819
18,Pavia,60,527,2732,269,71,0,0,0,3599,394,2757,317,292,1,0,0,3761,7360
18,Pavia,61,474,2773,287,72,1,0,0,3607,379,2732,271,359,1,0,0,3742,7349
18,Pavia,62,466,2749,258,76,0,0,0,3549,341,2662,276,373,0,0,0,3652,7201
18,Pavia,63,421,2650,220,79,4,0,0,3374,340,2588,254,396,0,0,0,3578,6952
18,Pavia,64,375,2541,216,90,1,0,0,3223,293,2517,241,467,1,0,0,3519,6742
18,Pavia,65,390,2526,211,109,2,0,0,3238,255,2348,217,487,0,0,0,3307,6545
18,Pavia,66,367,2463,166,122,1,0,0,3119,274,2303,206,514,0,0,0,3297,6416
18,Pavia,67,317,2544,172,116,1,0,0,3150,228,2357,175,577,0,0,0,3337,6487
18,Pavia,68,345,2608,160,158,2,0,1,3274,235,2462,208,650,0,0,0,3555,6829
18,Pavia,69,312,2521,142,154,1,0,0,3130,219,2273,164,764,0,0,0,3420,6550
18,Pavia,70,315,2613,133,190,4,0,0,3255,230,2360,171,840,0,0,0,3601,6856
18,Pavia,71,276,2616,128,175,1,0,0,3196,213,2257,178,823,0,0,0,3471,6667
18,Pavia,72,262,2388,117,223,2,0,0,2992,216,2113,150,945,0,0,1,3425,6417
18,Pavia,73,190,1732,80,183,1,0,0,2186,142,1454,100,798,0,0,0,2494,4680
18,Pavia,74,185,1859,76,175,1,0,0,2296,134,1521,93,958,0,0,0,2706,5002
18,Pavia,75,197,1875,67,205,0,0,0,2344,165,1470,106,1030,0,0,0,2771,5115
18,Pavia,76,205,1776,74,230,0,0,0,2285,167,1425,81,1064,0,0,0,2737,5022
18,Pavia,77,188,1689,69,260,0,0,0,2206,152,1396,77,1240,0,0,0,2865,5071
18,Pavia,78,234,1904,63,310,0,0,0,2511,205,1396,81,1497,0,0,0,3179,5690
18,Pavia,79,217,1769,48,326,0,0,0,2360,161,1248,59,1546,0,0,0,3014,5374
18,Pavia,80,198,1609,55,320,0,0,0,2182,181,1086,72,1664,0,0,0,3003,5185
18,Pavia,81,160,1411,22,306,1,0,0,1900,155,855,48,1628,0,0,0,2686,4586
18,Pavia,82,144,1122,27,302,0,0,0,1595,144,728,45,1591,0,0,0,2508,4103
18,Pavia,83,136,1103,23,353,0,0,0,1615,150,669,48,1672,0,0,0,2539,4154
18,Pavia,84,121,941,18,292,0,0,0,1372,127,580,35,1653,0,0,0,2395,3767
18,Pavia,85,89,762,10,333,1,0,0,1195,170,459,41,1661,0,0,0,2331,3526
18,Pavia,86,104,679,12,284,0,0,0,1079,152,322,27,1604,0,0,0,2105,3184
18,Pavia,87,81,576,13,264,0,0,0,934,136,297,24,1528,0,0,0,1985,2919
18,Pavia,88,69,461,5,266,0,0,0,801,146,223,17,1447,1,0,0,1834,2635
18,Pavia,89,45,356,7,219,0,0,0,627,130,144,14,1208,0,0,0,1496,2123
18,Pavia,90,41,250,8,189,0,0,0,488,107,110,12,1109,0,0,1,1339,1827
18,Pavia,91,31,206,1,160,0,0,0,398,91,70,5,968,0,0,0,1134,1532
18,Pavia,92,15,144,5,123,0,0,0,287,90,42,5,783,0,0,0,920,1207
18,Pavia,93,13,94,2,124,0,0,0,233,61,43,8,660,0,0,0,772,1005
18,Pavia,94,12,53,1,101,0,0,0,167,58,35,4,556,0,0,0,653,820
18,Pavia,95,9,58,2,72,0,0,0,141,38,13,4,426,0,0,0,481,622
18,Pavia,96,8,31,2,58,0,0,0,99,31,8,3,336,0,0,0,378,477
18,Pavia,97,4,22,0,22,0,0,0,48,17,2,1,243,0,0,0,263,311
18,Pavia,98,0,6,0,20,0,0,0,26,15,2,0,160,0,0,0,177,203
18,Pavia,99,0,4,1,10,0,0,0,15,8,3,0,70,0,0,1,82,97
18,Pavia,100,0,3,0,7,0,0,0,10,10,0,0,118,0,0,0,128,138
19,Cremona,0,1312,0,0,0,0,0,0,1312,1204,0,0,0,0,0,0,1204,2516
19,Cremona,1,1364,0,0,0,0,0,0,1364,1279,0,0,0,0,0,0,1279,2643
19,Cremona,2,1352,0,0,0,0,0,0,1352,1326,0,0,0,0,0,0,1326,2678
19,Cremona,3,1487,0,0,0,0,0,0,1487,1330,0,0,0,0,0,0,1330,2817
19,Cremona,4,1513,0,0,0,0,0,0,1513,1435,0,0,0,0,0,0,1435,2948
19,Cremona,5,1565,0,0,0,0,0,0,1565,1444,0,0,0,0,0,0,1444,3009
19,Cremona,6,1654,0,0,0,0,0,0,1654,1495,0,0,0,0,0,0,1495,3149
19,Cremona,7,1644,0,0,0,0,0,0,1644,1453,0,0,0,0,0,0,1453,3097
19,Cremona,8,1742,0,0,0,0,0,0,1742,1582,0,0,0,0,0,0,1582,3324
19,Cremona,9,1746,0,0,0,0,0,0,1746,1570,0,0,0,0,0,0,1570,3316
19,Cremona,10,1800,0,0,0,0,0,0,1800,1666,0,0,0,0,0,0,1666,3466
19,Cremona,11,1713,0,0,0,0,0,0,1713,1586,0,0,0,0,0,0,1586,3299
19,Cremona,12,1725,0,0,0,0,0,0,1725,1549,0,0,0,0,0,0,1549,3274
19,Cremona,13,1681,0,0,0,0,0,0,1681,1560,0,0,0,0,0,0,1560,3241
19,Cremona,14,1662,0,0,0,0,0,0,1662,1517,0,0,0,0,0,0,1517,3179
19,Cremona,15,1698,0,0,0,0,0,0,1698,1446,0,0,0,0,0,0,1446,3144
19,Cremona,16,1627,0,0,0,0,0,0,1627,1492,0,0,0,0,0,0,1492,3119
19,Cremona,17,1621,0,0,0,0,0,0,1621,1599,0,0,0,0,0,0,1599,3220
19,Cremona,18,1738,0,0,0,0,0,0,1738,1596,2,0,1,0,0,0,1599,3337
19,Cremona,19,1736,0,0,0,0,0,0,1736,1540,13,0,0,0,0,0,1553,3289
19,Cremona,20,1814,0,0,0,0,0,0,1814,1643,22,0,0,0,0,0,1665,3479
19,Cremona,21,1832,7,0,0,0,0,0,1839,1518,36,0,0,0,0,0,1554,3393
19,Cremona,22,1743,7,0,0,0,0,0,1750,1520,63,0,1,0,0,0,1584,3334
19,Cremona,23,1786,22,0,1,0,0,0,1809,1495,103,1,0,0,0,0,1599,3408
19,Cremona,24,1774,28,1,0,1,0,0,1804,1452,152,2,0,0,0,0,1606,3410
19,Cremona,25,1729,49,1,0,0,0,0,1779,1458,198,0,0,1,0,0,1657,3436
19,Cremona,26,1692,107,0,0,0,0,0,1799,1403,308,4,0,1,0,0,1716,3515
19,Cremona,27,1676,160,1,0,1,0,0,1838,1346,411,2,0,0,0,0,1759,3597
19,Cremona,28,1676,200,1,0,1,0,0,1878,1249,542,10,2,0,0,0,1803,3681
19,Cremona,29,1652,298,4,0,1,0,0,1955,1256,643,10,1,0,0,0,1910,3865
19,Cremona,30,1530,425,4,0,0,0,0,1959,995,757,18,0,0,0,0,1770,3729
19,Cremona,31,1419,495,4,1,0,0,0,1919,965,849,14,5,1,0,0,1834,3753
19,Cremona,32,1299,576,8,0,2,0,0,1885,867,994,27,2,1,0,0,1891,3776
19,Cremona,33,1316,675,14,0,0,0,0,2005,880,985,34,4,1,0,0,1904,3909
19,Cremona,34,1274,798,20,2,1,0,0,2095,812,1097,39,6,0,0,0,1954,4049
19,Cremona,35,1101,875,21,1,2,0,0,2000,705,1170,50,4,1,0,0,1930,3930
19,Cremona,36,1146,1010,30,0,1,0,0,2187,738,1282,59,9,0,0,0,2088,4275
19,Cremona,37,1083,1092,37,0,5,1,0,2218,699,1323,58,6,0,0,0,2086,4304
19,Cremona,38,1008,1175,49,0,3,0,0,2235,691,1457,55,9,1,0,0,2213,4448
19,Cremona,39,1027,1266,42,1,0,0,0,2336,659,1443,74,10,0,0,0,2186,4522
19,Cremona,40,1042,1354,42,4,4,0,0,2446,653,1643,115,17,1,0,0,2429,4875
19,Cremona,41,1059,1433,73,6,1,0,0,2572,644,1664,128,16,2,0,0,2454,5026
19,Cremona,42,1056,1534,99,2,1,0,0,2692,689,1797,122,20,1,0,0,2629,5321
19,Cremona,43,1069,1719,90,4,0,0,0,2882,621,1933,152,26,1,0,0,2733,5615
19,Cremona,44,1038,1716,126,2,3,0,0,2885,595,1919,176,22,2,0,0,2714,5599
19,Cremona,45,896,1720,120,8,5,0,0,2749,603,1942,193,32,1,0,0,2771,5520
19,Cremona,46,929,1871,140,5,2,0,0,2947,565,1925,158,36,1,0,0,2685,5632
19,Cremona,47,899,1905,145,10,5,0,0,2964,512,2028,216,39,0,0,0,2795,5759
19,Cremona,48,801,1854,145,11,1,0,0,2812,436,2062,237,51,2,1,0,2789,5601
19,Cremona,49,768,2075,177,11,3,0,0,3034,502,2143,188,65,0,0,0,2898,5932
19,Cremona,50,757,2093,195,16,3,0,0,3064,457,2121,238,69,2,0,0,2887,5951
19,Cremona,51,680,2062,179,18,6,0,0,2945,427,2121,207,78,0,0,0,2833,5778
19,Cremona,52,692,2197,213,18,3,0,0,3123,421,2187,228,76,0,0,0,2912,6035
19,Cremona,53,619,2180,180,36,0,0,0,3015,427,2212,245,70,0,0,0,2954,5969
19,Cremona,54,600,2132,194,22,1,0,0,2949,357,2225,216,103,1,0,0,2902,5851
19,Cremona,55,521,2106,185,27,2,0,0,2841,353,2175,199,126,1,0,0,2854,5695
19,Cremona,56,458,1978,182,30,5,0,0,2653,307,2061,204,118,1,0,0,2691,5344
19,Cremona,57,420,1990,175,30,3,0,0,2618,284,1990,167,181,0,0,0,2622,5240
19,Cremona,58,406,1968,141,35,5,0,0,2555,254,2022,192,155,0,0,0,2623,5178
19,Cremona,59,369,1954,168,48,1,0,0,2540,242,1929,163,169,0,0,0,2503,5043
19,Cremona,60,363,1860,151,53,1,0,0,2428,262,1894,166,173,2,0,0,2497,4925
19,Cremona,61,339,1780,141,40,2,0,0,2302,214,1793,188,193,0,0,0,2388,4690
19,Cremona,62,310,1798,91,57,5,0,1,2262,185,1776,137,249,0,0,0,2347,4609
19,Cremona,63,310,1740,110,50,2,0,0,2212,193,1845,142,256,0,0,0,2436,4648
19,Cremona,64,257,1764,93,65,0,0,0,2179,160,1687,105,277,0,0,0,2229,4408
19,Cremona,65,269,1683,86,60,4,0,0,2102,156,1650,128,289,1,0,0,2224,4326
19,Cremona,66,252,1684,110,73,0,0,0,2119,168,1594,96,321,0,0,0,2179,4298
19,Cremona,67,259,1716,78,72,1,0,0,2126,154,1547,98,350,0,0,0,2149,4275
19,Cremona,68,271,1820,76,97,2,0,0,2266,150,1639,89,380,1,0,0,2259,4525
19,Cremona,69,257,1757,79,118,1,0,0,2212,160,1601,85,480,0,0,0,2326,4538
19,Cremona,70,273,1802,66,124,0,1,0,2266,149,1683,83,495,1,0,0,2411,4677
19,Cremona,71,215,1753,73,124,0,0,0,2165,125,1485,63,568,0,0,1,2242,4407
19,Cremona,72,185,1702,50,140,0,0,0,2077,164,1495,67,616,1,0,0,2343,4420
19,Cremona,73,150,1152,36,101,0,0,0,1439,124,949,57,456,1,0,0,1587,3026
19,Cremona,74,158,1174,31,126,0,0,0,1489,127,1017,41,591,0,0,0,1776,3265
19,Cremona,75,169,1182,27,151,1,0,1,1531,121,975,38,630,0,0,0,1764,3295
19,Cremona,76,171,1205,30,146,1,0,0,1553,130,931,40,740,0,0,0,1841,3394
19,Cremona,77,168,1159,24,164,0,0,0,1515,131,927,40,818,0,0,0,1916,3431
19,Cremona,78,205,1217,22,204,0,0,0,1648,149,895,45,917,0,0,0,2006,3654
19,Cremona,79,157,1200,20,206,0,0,0,1583,122,815,31,1020,0,0,0,1988,3571
19,Cremona,80,140,1066,19,202,0,0,0,1427,143,714,29,1072,1,0,0,1959,3386
19,Cremona,81,125,915,16,184,0,0,0,1240,125,542,23,992,0,0,0,1682,2922
19,Cremona,82,121,768,9,166,0,0,0,1064,134,502,16,961,0,0,0,1613,2677
19,Cremona,83,103,706,10,184,0,0,0,1003,117,428,23,1034,0,0,0,1602,2605
19,Cremona,84,76,596,6,178,1,0,0,857,112,338,7,994,0,0,0,1451,2308
19,Cremona,85,79,524,8,155,0,0,0,766,119,266,11,973,0,0,0,1369,2135
19,Cremona,86,58,403,4,160,0,0,0,625,89,201,23,963,0,0,0,1276,1901
19,Cremona,87,46,366,5,144,0,0,0,561,101,166,8,894,0,0,0,1169,1730
19,Cremona,88,32,288,2,163,0,0,0,485,98,130,7,887,0,0,0,1122,1607
19,Cremona,89,39,235,3,129,0,0,0,406,93,86,6,763,0,0,0,948,1354
19,Cremona,90,24,170,0,112,0,0,0,306,86,64,5,648,0,0,0,803,1109
19,Cremona,91,25,137,3,94,0,0,0,259,63,35,6,606,0,0,0,710,969
19,Cremona,92,23,86,0,92,0,0,0,201,53,43,2,489,0,0,0,587,788
19,Cremona,93,8,58,0,63,0,0,0,129,53,22,2,448,0,0,0,525,654
19,Cremona,94,3,42,0,47,0,0,0,92,48,7,3,335,0,0,0,393,485
19,Cremona,95,4,21,0,52,0,0,0,77,33,8,1,238,0,0,0,280,357
19,Cremona,96,8,12,1,39,0,0,0,60,18,6,1,192,0,0,0,217,277
19,Cremona,97,0,21,1,19,0,0,0,41,17,4,1,145,0,0,0,167,208
19,Cremona,98,1,4,0,16,0,0,0,21,13,2,0,92,0,0,0,107,128
19,Cremona,99,0,2,0,4,0,0,0,6,6,2,0,45,0,0,0,53,59
19,Cremona,100,3,1,0,6,0,0,0,10,4,1,0,57,0,0,0,62,72
20,Mantova,0,1535,0,0,0,0,0,0,1535,1457,0,0,0,0,0,0,1457,2992
20,Mantova,1,1596,0,0,0,0,0,0,1596,1487,0,0,0,0,0,0,1487,3083
20,Mantova,2,1648,0,0,0,0,0,0,1648,1594,0,0,0,0,0,0,1594,3242
20,Mantova,3,1771,0,0,0,0,0,0,1771,1579,0,0,0,0,0,0,1579,3350
20,Mantova,4,1817,0,0,0,0,0,0,1817,1700,0,0,0,0,0,0,1700,3517
20,Mantova,5,1841,0,0,0,0,0,0,1841,1732,0,0,0,0,0,0,1732,3573
20,Mantova,6,1951,0,0,0,0,0,0,1951,1748,0,0,0,0,0,0,1748,3699
20,Mantova,7,2007,0,0,0,0,0,0,2007,1874,0,0,0,0,0,0,1874,3881
20,Mantova,8,2130,0,0,0,0,0,0,2130,1923,0,0,0,0,0,0,1923,4053
20,Mantova,9,2023,0,0,0,0,0,0,2023,1962,0,0,0,0,0,0,1962,3985
20,Mantova,10,2070,0,0,0,0,0,0,2070,1877,0,0,0,0,0,0,1877,3947
20,Mantova,11,2033,0,0,0,0,0,0,2033,1931,0,0,0,0,0,0,1931,3964
20,Mantova,12,2056,0,0,0,0,0,0,2056,1865,0,0,0,0,0,0,1865,3921
20,Mantova,13,1982,0,0,0,0,0,0,1982,1833,0,0,0,0,0,0,1833,3815
20,Mantova,14,1888,0,0,0,0,0,0,1888,1911,0,0,0,0,0,0,1911,3799
20,Mantova,15,1875,0,0,0,0,0,0,1875,1703,0,0,0,0,0,0,1703,3578
20,Mantova,16,1921,0,0,0,0,0,0,1921,1700,0,0,0,0,0,0,1700,3621
20,Mantova,17,1913,0,0,0,0,0,0,1913,1734,0,0,0,0,0,0,1734,3647
20,Mantova,18,1994,1,0,0,0,0,0,1995,1758,2,0,0,0,0,0,1760,3755
20,Mantova,19,2045,1,0,0,0,0,0,2046,1794,19,0,0,1,0,0,1814,3860
20,Mantova,20,2033,7,1,0,0,0,0,2041,1754,41,0,0,0,0,0,1795,3836
20,Mantova,21,1974,4,0,0,0,0,0,1978,1648,61,0,0,0,0,0,1709,3687
20,Mantova,22,1946,20,0,0,0,0,0,1966,1628,114,2,1,0,0,0,1745,3711
20,Mantova,23,1812,24,2,0,0,0,0,1838,1594,140,1,0,0,0,0,1735,3573
20,Mantova,24,1951,49,1,0,1,0,0,2002,1622,185,2,0,0,0,0,1809,3811
20,Mantova,25,1889,73,2,0,0,1,0,1965,1565,285,2,0,0,0,0,1852,3817
20,Mantova,26,1915,121,1,0,0,0,0,2037,1527,381,6,0,2,0,0,1916,3953
20,Mantova,27,1807,181,3,0,0,0,0,1991,1346,502,14,0,0,0,0,1862,3853
20,Mantova,28,1863,259,3,0,2,0,0,2127,1370,620,11,1,0,0,0,2002,4129
20,Mantova,29,1682,352,9,0,1,0,0,2044,1231,703,19,1,1,0,0,1955,3999
20,Mantova,30,1681,516,10,0,0,0,0,2207,1224,914,10,0,0,0,0,2148,4355
20,Mantova,31,1566,647,3,0,3,0,0,2219,1036,1040,26,1,1,0,0,2104,4323
20,Mantova,32,1515,715,10,0,2,0,0,2242,970,1121,26,1,0,0,0,2118,4360
20,Mantova,33,1471,760,18,0,2,0,0,2251,1004,1198,29,5,0,0,0,2236,4487
20,Mantova,34,1430,897,12,0,0,0,0,2339,938,1296,38,8,1,0,0,2281,4620
20,Mantova,35,1365,1027,28,1,2,0,0,2423,874,1317,67,3,2,0,0,2263,4686
20,Mantova,36,1319,1121,31,0,0,0,0,2471,837,1442,68,8,1,0,0,2356,4827
20,Mantova,37,1338,1228,41,2,5,0,0,2614,862,1568,86,6,0,0,0,2522,5136
20,Mantova,38,1325,1350,47,0,4,0,0,2726,919,1739,94,10,1,0,0,2763,5489
20,Mantova,39,1235,1487,68,1,2,1,0,2794,802,1780,118,14,1,0,0,2715,5509
20,Mantova,40,1345,1668,84,4,1,0,0,3102,836,1901,129,12,1,0,0,2879,5981
20,Mantova,41,1321,1765,104,4,1,0,0,3195,893,1916,168,22,0,1,0,3000,6195
20,Mantova,42,1285,1829,122,7,0,0,0,3243,845,2002,170,19,0,0,0,3036,6279
20,Mantova,43,1295,1949,129,5,3,0,0,3381,836,2170,180,25,0,0,0,3211,6592
20,Mantova,44,1276,2067,145,7,3,0,0,3498,809,2258,217,24,2,0,0,3310,6808
20,Mantova,45,1232,2124,173,6,1,0,0,3536,806,2299,244,27,1,0,0,3377,6913
20,Mantova,46,1143,2217,170,15,2,0,0,3547,717,2317,245,36,3,0,0,3318,6865
20,Mantova,47,988,2191,194,11,0,0,0,3384,699,2402,285,43,0,0,0,3429,6813
20,Mantova,48,988,2256,196,7,2,0,0,3449,619,2282,271,49,0,0,0,3221,6670
20,Mantova,49,916,2347,228,15,0,0,0,3506,577,2366,284,57,1,0,0,3285,6791
20,Mantova,50,853,2398,210,16,2,0,0,3479,602,2420,292,70,2,0,0,3386,6865
20,Mantova,51,816,2333,251,16,3,0,0,3419,517,2428,298,66,2,0,0,3311,6730
20,Mantova,52,734,2400,246,22,2,0,0,3404,500,2387,258,77,2,0,0,3224,6628
20,Mantova,53,713,2527,249,27,3,0,0,3519,430,2420,278,101,1,0,0,3230,6749
20,Mantova,54,611,2501,255,31,2,0,0,3400,398,2469,341,113,1,0,0,3322,6722
20,Mantova,55,547,2338,206,41,3,0,0,3135,421,2331,262,104,1,0,0,3119,6254
20,Mantova,56,471,2247,244,38,1,0,0,3001,377,2284,264,141,2,0,0,3068,6069
20,Mantova,57,485,2336,235,33,0,0,0,3089,306,2308,262,145,1,0,0,3022,6111
20,Mantova,58,420,2174,214,37,2,0,0,2847,333,2189,231,169,2,0,0,2924,5771
20,Mantova,59,362,2143,209,37,2,0,0,2753,276,2154,240,184,4,0,0,2858,5611
20,Mantova,60,324,1976,168,52,4,0,0,2524,247,2036,207,214,1,0,0,2705,5229
20,Mantova,61,320,2069,186,49,3,0,0,2627,226,2037,199,234,0,0,0,2696,5323
20,Mantova,62,280,2063,169,53,3,0,0,2568,214,2004,185,263,0,0,0,2666,5234
20,Mantova,63,254,1975,135,49,4,0,0,2417,233,2004,171,236,1,0,0,2645,5062
20,Mantova,64,259,1986,133,72,1,0,0,2451,211,1937,164,292,0,0,0,2604,5055
20,Mantova,65,205,1856,101,76,1,0,0,2239,145,1850,143,312,0,0,0,2450,4689
20,Mantova,66,219,1823,130,84,2,0,0,2258,181,1856,147,344,0,0,0,2528,4786
20,Mantova,67,191,1803,117,104,0,0,0,2215,145,1801,128,337,0,0,0,2411,4626
20,Mantova,68,195,1932,90,91,0,0,1,2309,151,1822,106,439,1,0,0,2519,4828
20,Mantova,69,191,1960,85,114,4,0,0,2354,149,1809,108,472,0,0,0,2538,4892
20,Mantova,70,196,2001,76,136,0,0,0,2409,157,1842,121,562,0,0,0,2682,5091
20,Mantova,71,197,2049,78,134,0,0,0,2458,149,1873,90,627,1,0,0,2740,5198
20,Mantova,72,224,2050,62,163,0,0,0,2499,141,1782,105,656,0,0,0,2684,5183
20,Mantova,73,111,1260,48,105,0,0,0,1524,93,1104,70,528,0,0,0,1795,3319
20,Mantova,74,146,1424,49,135,1,0,0,1755,113,1223,52,691,0,0,0,2079,3834
20,Mantova,75,135,1304,37,133,1,0,0,1610,115,1238,62,693,0,0,0,2108,3718
20,Mantova,76,136,1349,47,138,0,0,0,1670,125,1080,44,753,0,0,0,2002,3672
20,Mantova,77,154,1258,31,163,2,0,0,1608,100,1111,48,835,0,0,0,2094,3702
20,Mantova,78,152,1456,26,204,0,0,0,1838,146,1095,37,973,0,0,0,2251,4089
20,Mantova,79,136,1334,22,186,1,0,0,1679,112,998,38,1016,0,0,0,2164,3843
20,Mantova,80,115,1255,22,204,0,0,0,1596,97,942,31,1140,0,0,0,2210,3806
20,Mantova,81,118,1128,11,176,0,0,0,1433,105,662,26,1115,0,0,0,1908,3341
20,Mantova,82,78,899,17,197,0,0,0,1191,96,611,17,1009,0,0,0,1733,2924
20,Mantova,83,87,899,13,223,0,0,0,1222,95,516,17,1174,0,0,0,1802,3024
20,Mantova,84,72,802,5,217,0,0,0,1096,125,385,14,1168,0,0,0,1692,2788
20,Mantova,85,56,630,9,198,0,0,0,893,87,317,13,1066,0,0,0,1483,2376
20,Mantova,86,55,517,5,196,0,0,0,773,91,245,15,1053,0,0,0,1404,2177
20,Mantova,87,43,494,2,168,0,0,0,707,79,188,5,1075,0,0,0,1347,2054
20,Mantova,88,40,382,2,169,0,0,0,593,81,163,11,1005,0,0,0,1260,1853
20,Mantova,89,25,266,3,154,0,0,0,448,68,84,4,885,0,0,0,1041,1489
20,Mantova,90,29,210,2,126,0,0,0,367,71,68,5,839,0,0,0,983,1350
20,Mantova,91,13,159,0,111,0,0,0,283,55,48,4,731,0,0,0,838,1121
20,Mantova,92,13,126,1,94,0,0,0,234,43,36,2,643,0,0,0,724,958
20,Mantova,93,15,79,1,72,0,0,0,167,45,15,2,514,0,0,0,576,743
20,Mantova,94,10,53,0,52,0,0,0,115,39,13,1,427,0,0,0,480,595
20,Mantova,95,9,33,1,56,0,0,0,99,24,9,2,349,0,0,0,384,483
20,Mantova,96,4,28,0,41,0,0,0,73,21,6,3,247,0,0,0,277,350
20,Mantova,97,4,7,1,31,0,0,0,43,14,6,0,182,0,0,0,202,245
20,Mantova,98,2,10,0,21,0,0,0,33,17,0,1,124,0,0,0,142,175
20,Mantova,99,0,1,0,12,0,0,0,13,3,0,0,71,0,0,0,74,87
20,Mantova,100,0,4,0,11,0,0,0,15,8,1,0,96,0,0,0,105,120
21,Bolzano/Bozen,0,2746,0,0,0,0,0,0,2746,2543,0,0,0,0,0,0,2543,5289
21,Bolzano/Bozen,1,2774,0,0,0,0,0,0,2774,2631,0,0,0,0,0,0,2631,5405
21,Bolzano/Bozen,2,2811,0,0,0,0,0,0,2811,2717,0,0,0,0,0,0,2717,5528
21,Bolzano/Bozen,3,2797,0,0,0,0,0,0,2797,2675,0,0,0,0,0,0,2675,5472
21,Bolzano/Bozen,4,2908,0,0,0,0,0,0,2908,2765,0,0,0,0,0,0,2765,5673
21,Bolzano/Bozen,5,2821,0,0,0,0,0,0,2821,2589,0,0,0,0,0,0,2589,5410
21,Bolzano/Bozen,6,2878,0,0,0,0,0,0,2878,2724,0,0,0,0,0,0,2724,5602
21,Bolzano/Bozen,7,2832,0,0,0,0,0,0,2832,2688,0,0,0,0,0,0,2688,5520
21,Bolzano/Bozen,8,2891,0,0,0,0,0,0,2891,2664,0,0,0,0,0,0,2664,5555
21,Bolzano/Bozen,9,2834,0,0,0,0,0,0,2834,2648,0,0,0,0,0,0,2648,5482
21,Bolzano/Bozen,10,2916,0,0,0,0,0,0,2916,2769,0,0,0,0,0,0,2769,5685
21,Bolzano/Bozen,11,3047,0,0,0,0,0,0,3047,2695,0,0,0,0,0,0,2695,5742
21,Bolzano/Bozen,12,2918,0,0,0,0,0,0,2918,2794,0,0,0,0,0,0,2794,5712
21,Bolzano/Bozen,13,3012,0,0,0,0,0,0,3012,2806,0,0,0,0,0,0,2806,5818
21,Bolzano/Bozen,14,2992,0,0,0,0,0,0,2992,2798,0,0,0,0,0,0,2798,5790
21,Bolzano/Bozen,15,2992,0,0,0,0,0,0,2992,2740,0,0,0,0,0,0,2740,5732
21,Bolzano/Bozen,16,2877,0,0,0,0,0,0,2877,2711,0,0,0,0,0,0,2711,5588
21,Bolzano/Bozen,17,3047,0,0,0,0,0,0,3047,2783,0,0,0,0,0,0,2783,5830
21,Bolzano/Bozen,18,3059,0,0,0,0,0,0,3059,2896,4,0,0,0,0,0,2900,5959
21,Bolzano/Bozen,19,3119,1,0,0,0,0,0,3120,2892,26,0,0,0,0,0,2918,6038
21,Bolzano/Bozen,20,3128,4,0,0,0,0,0,3132,2921,49,0,0,0,0,0,2970,6102
21,Bolzano/Bozen,21,3263,17,0,0,0,0,0,3280,2879,61,0,0,0,0,0,2940,6220
21,Bolzano/Bozen,22,3114,33,0,0,0,0,0,3147,2838,125,1,1,0,0,0,2965,6112
21,Bolzano/Bozen,23,3118,47,1,0,0,0,0,3166,2607,165,2,0,0,0,0,2774,5940
21,Bolzano/Bozen,24,3052,82,2,0,0,0,0,3136,2726,236,0,0,0,0,0,2962,6098
21,Bolzano/Bozen,25,2893,126,1,0,1,0,0,3021,2564,377,3,0,0,0,0,2944,5965
21,Bolzano/Bozen,26,2971,201,1,0,2,0,0,3175,2515,462,11,0,0,0,0,2988,6163
21,Bolzano/Bozen,27,2918,277,5,0,0,0,0,3200,2399,605,14,2,0,0,0,3020,6220
21,Bolzano/Bozen,28,2800,398,5,0,2,0,0,3205,2246,742,14,1,1,0,0,3004,6209
21,Bolzano/Bozen,29,2649,500,7,0,0,0,0,3156,2052,912,19,3,2,0,0,2988,6144
21,Bolzano/Bozen,30,2501,607,16,0,2,0,0,3126,1936,978,15,1,3,0,0,2933,6059
21,Bolzano/Bozen,31,2292,689,18,0,4,0,0,3003,1747,1108,24,0,1,0,0,2880,5883
21,Bolzano/Bozen,32,2163,908,12,0,0,0,0,3083,1588,1310,37,5,4,0,0,2944,6027
21,Bolzano/Bozen,33,2086,1024,20,0,4,0,0,3134,1560,1435,43,1,2,0,0,3041,6175
21,Bolzano/Bozen,34,2068,1083,26,1,2,0,0,3180,1489,1495,50,6,1,0,0,3041,6221
21,Bolzano/Bozen,35,1895,1280,27,1,0,0,0,3203,1518,1562,67,6,1,0,0,3154,6357
21,Bolzano/Bozen,36,1932,1391,28,0,1,0,0,3352,1495,1769,72,7,0,0,0,3343,6695
21,Bolzano/Bozen,37,1860,1472,45,1,0,0,0,3378,1408,1862,78,8,2,0,0,3358,6736
21,Bolzano/Bozen,38,1782,1589,44,1,4,0,0,3420,1246,1978,91,14,3,0,0,3332,6752
21,Bolzano/Bozen,39,1663,1540,39,2,6,0,0,3250,1298,1947,99,3,0,0,0,3347,6597
21,Bolzano/Bozen,40,1601,1761,61,1,2,0,0,3426,1223,2026,112,16,1,0,0,3378,6804
21,Bolzano/Bozen,41,1596,1683,90,2,3,0,0,3374,1155,2075,148,26,1,0,0,3405,6779
21,Bolzano/Bozen,42,1490,1824,91,3,3,0,0,3411,1262,2104,176,12,1,0,0,3555,6966
21,Bolzano/Bozen,43,1552,2043,119,4,1,0,0,3719,1220,2279,196,20,3,0,0,3718,7437
21,Bolzano/Bozen,44,1627,2178,125,7,10,0,0,3947,1253,2418,217,43,0,0,0,3931,7878
21,Bolzano/Bozen,45,1549,2181,175,10,3,0,0,3918,1252,2522,252,29,1,0,0,4056,7974
21,Bolzano/Bozen,46,1581,2375,162,8,4,0,0,4130,1251,2624,269,32,3,0,0,4179,8309
21,Bolzano/Bozen,47,1617,2463,194,15,7,0,0,4296,1150,2691,321,44,2,0,0,4208,8504
21,Bolzano/Bozen,48,1462,2549,206,16,3,0,0,4236,1034,2758,394,54,1,0,0,4241,8477
21,Bolzano/Bozen,49,1565,2747,263,16,1,0,0,4592,1014,2880,355,67,2,0,0,4318,8910
21,Bolzano/Bozen,50,1386,2734,277,19,5,0,0,4421,995,2872,431,66,1,0,0,4365,8786
21,Bolzano/Bozen,51,1239,2735,279,17,2,0,0,4272,936,2893,388,104,1,0,1,4323,8595
21,Bolzano/Bozen,52,1286,2852,297,19,4,0,0,4458,850,2988,394,104,1,0,1,4338,8796
21,Bolzano/Bozen,53,1170,3048,299,24,5,0,0,4546,872,2878,440,109,2,0,0,4301,8847
21,Bolzano/Bozen,54,1075,3003,360,32,5,0,0,4475,737,2980,406,150,0,0,0,4273,8748
21,Bolzano/Bozen,55,929,2850,338,37,4,0,0,4158,691,2851,362,133,0,0,0,4037,8195
21,Bolzano/Bozen,56,809,2789,303,28,2,0,0,3931,615,2781,380,151,0,0,0,3927,7858
21,Bolzano/Bozen,57,764,2640,333,35,1,0,0,3773,601,2727,351,166,1,0,0,3846,7619
21,Bolzano/Bozen,58,691,2632,328,39,2,0,0,3692,517,2575,328,175,0,0,0,3595,7287
21,Bolzano/Bozen,59,582,2653,288,39,0,0,0,3562,483,2426,315,194,1,0,0,3419,6981
21,Bolzano/Bozen,60,571,2405,246,45,1,0,0,3268,452,2288,284,229,1,0,0,3254,6522
21,Bolzano/Bozen,61,491,2230,210,56,1,0,0,2988,447,2352,268,234,0,0,0,3301,6289
21,Bolzano/Bozen,62,478,2207,205,48,1,0,0,2939,375,2168,240,263,1,0,0,3047,5986
21,Bolzano/Bozen,63,420,2129,199,51,0,0,0,2799,337,2048,192,282,1,0,0,2860,5659
21,Bolzano/Bozen,64,383,2008,194,62,1,0,0,2648,314,1968,210,288,2,0,0,2782,5430
21,Bolzano/Bozen,65,345,1977,160,59,1,0,0,2542,288,1962,202,324,0,0,0,2776,5318
21,Bolzano/Bozen,66,343,1878,147,71,0,0,0,2439,278,1907,171,359,0,0,0,2715,5154
21,Bolzano/Bozen,67,292,1943,139,81,0,0,0,2455,230,1754,177,380,0,0,0,2541,4996
21,Bolzano/Bozen,68,317,1857,155,94,1,0,0,2424,282,1766,179,421,1,0,0,2649,5073
21,Bolzano/Bozen,69,271,1833,132,104,1,0,0,2341,240,1732,154,460,0,0,0,2586,4927
21,Bolzano/Bozen,70,268,1927,117,110,3,0,0,2425,246,1787,135,527,0,0,0,2695,5120
21,Bolzano/Bozen,71,240,1776,99,127,0,0,0,2242,218,1700,151,574,0,0,0,2643,4885
21,Bolzano/Bozen,72,260,1920,95,156,0,0,1,2432,282,1772,147,666,0,0,0,2867,5299
21,Bolzano/Bozen,73,172,1469,64,104,1,0,0,1810,189,1220,110,547,0,0,0,2066,3876
21,Bolzano/Bozen,74,205,1648,76,137,0,0,1,2067,211,1465,93,709,1,0,0,2479,4546
21,Bolzano/Bozen,75,210,1877,59,169,0,0,0,2315,232,1452,116,802,0,0,0,2602,4917
21,Bolzano/Bozen,76,197,1728,101,147,0,0,0,2173,232,1417,98,865,0,0,0,2612,4785
21,Bolzano/Bozen,77,199,1728,73,184,0,0,0,2184,208,1359,87,952,0,0,0,2606,4790
21,Bolzano/Bozen,78,179,1492,45,193,0,0,0,1909,207,1101,79,971,0,0,0,2358,4267
21,Bolzano/Bozen,79,171,1429,35,195,0,0,0,1830,188,1043,73,1038,0,0,0,2342,4172
21,Bolzano/Bozen,80,115,1292,34,218,0,0,0,1659,190,847,49,990,0,0,0,2076,3735
21,Bolzano/Bozen,81,122,1128,35,179,0,0,0,1464,192,695,45,938,0,0,0,1870,3334
21,Bolzano/Bozen,82,122,933,18,178,0,0,0,1251,205,572,37,972,0,0,0,1786,3037
21,Bolzano/Bozen,83,103,808,23,187,0,0,0,1121,154,487,30,1011,0,0,0,1682,2803
21,Bolzano/Bozen,84,93,789,16,205,0,0,0,1103,162,399,24,1029,0,0,0,1614,2717
21,Bolzano/Bozen,85,94,691,15,217,0,0,1,1018,175,331,17,1011,0,0,0,1534,2552
21,Bolzano/Bozen,86,61,631,10,201,0,0,0,903,172,283,17,941,0,0,1,1414,2317
21,Bolzano/Bozen,87,60,536,9,181,0,0,0,786,145,244,14,894,0,0,0,1297,2083
21,Bolzano/Bozen,88,55,436,8,191,0,0,0,690,155,176,21,843,0,0,0,1195,1885
21,Bolzano/Bozen,89,36,323,3,130,0,0,0,492,127,157,11,741,1,0,0,1037,1529
21,Bolzano/Bozen,90,34,260,8,155,0,0,0,457,96,78,16,682,0,0,0,872,1329
21,Bolzano/Bozen,91,24,200,0,107,0,0,0,331,103,66,7,579,0,0,0,755,1086
21,Bolzano/Bozen,92,13,149,4,107,0,0,0,273,83,37,4,491,0,0,1,616,889
21,Bolzano/Bozen,93,10,104,2,87,0,0,0,203,66,35,6,424,0,0,0,531,734
21,Bolzano/Bozen,94,7,49,2,63,0,0,0,121,73,23,1,339,0,0,0,436,557
21,Bolzano/Bozen,95,7,46,2,49,0,0,0,104,47,11,0,312,0,0,0,370,474
21,Bolzano/Bozen,96,7,30,0,35,0,0,0,72,36,7,2,243,0,0,0,288,360
21,Bolzano/Bozen,97,3,15,1,17,0,0,0,36,35,4,5,141,0,0,0,185,221
21,Bolzano/Bozen,98,1,9,1,13,0,0,0,24,15,4,0,94,0,0,0,113,137
21,Bolzano/Bozen,99,0,4,0,5,0,0,0,9,9,1,1,41,0,0,0,52,61
21,Bolzano/Bozen,100,1,3,0,6,0,0,0,10,16,1,1,44,0,0,0,62,72
22,Trento,0,2218,0,0,0,0,0,0,2218,2140,0,0,0,0,0,0,2140,4358
22,Trento,1,2344,0,0,0,0,0,0,2344,2198,0,0,0,0,0,0,2198,4542
22,Trento,2,2421,0,0,0,0,0,0,2421,2287,0,0,0,0,0,0,2287,4708
22,Trento,3,2499,0,0,0,0,0,0,2499,2328,0,0,0,0,0,0,2328,4827
22,Trento,4,2533,0,0,0,0,0,0,2533,2371,0,0,0,0,0,0,2371,4904
22,Trento,5,2640,0,0,0,0,0,0,2640,2538,0,0,0,0,0,0,2538,5178
22,Trento,6,2691,0,0,0,0,0,0,2691,2505,0,0,0,0,0,0,2505,5196
22,Trento,7,2723,0,0,0,0,0,0,2723,2633,0,0,0,0,0,0,2633,5356
22,Trento,8,2844,0,0,0,0,0,0,2844,2670,0,0,0,0,0,0,2670,5514
22,Trento,9,2804,0,0,0,0,0,0,2804,2648,0,0,0,0,0,0,2648,5452
22,Trento,10,2843,0,0,0,0,0,0,2843,2722,0,0,0,0,0,0,2722,5565
22,Trento,11,2740,0,0,0,0,0,0,2740,2652,0,0,0,0,0,0,2652,5392
22,Trento,12,2835,0,0,0,0,0,0,2835,2632,0,0,0,0,0,0,2632,5467
22,Trento,13,2910,0,0,0,0,0,0,2910,2601,0,0,0,0,0,0,2601,5511
22,Trento,14,2932,0,0,0,0,0,0,2932,2754,0,0,0,0,0,0,2754,5686
22,Trento,15,2823,0,0,0,0,0,0,2823,2637,0,0,0,0,0,0,2637,5460
22,Trento,16,2837,0,0,0,0,0,0,2837,2639,0,0,0,0,0,0,2639,5476
22,Trento,17,2905,0,0,0,0,0,0,2905,2624,0,0,0,0,0,0,2624,5529
22,Trento,18,2934,0,0,0,0,0,0,2934,2761,0,0,0,0,0,0,2761,5695
22,Trento,19,2952,1,0,0,0,0,0,2953,2712,24,0,0,0,0,0,2736,5689
22,Trento,20,2969,5,0,0,0,0,0,2974,2726,44,0,0,0,0,0,2770,5744
22,Trento,21,2920,5,0,0,0,0,0,2925,2611,52,0,0,0,0,0,2663,5588
22,Trento,22,2928,19,0,0,0,0,0,2947,2609,102,0,0,0,0,0,2711,5658
22,Trento,23,2847,25,0,0,0,0,0,2872,2530,161,1,0,0,0,0,2692,5564
22,Trento,24,2814,54,1,0,1,0,0,2870,2494,228,2,0,0,0,0,2724,5594
22,Trento,25,2786,99,0,0,0,0,0,2885,2434,304,4,0,0,0,0,2742,5627
22,Trento,26,2854,151,1,0,1,0,0,3007,2400,435,5,0,1,0,0,2841,5848
22,Trento,27,2731,229,3,0,0,0,0,2963,2158,611,7,1,0,0,0,2777,5740
22,Trento,28,2682,322,5,0,2,0,0,3011,2060,774,14,2,0,0,0,2850,5861
22,Trento,29,2402,460,15,0,0,0,0,2877,1943,951,15,0,1,0,0,2910,5787
22,Trento,30,2351,613,8,0,3,0,0,2975,1819,1091,25,1,1,0,0,2937,5912
22,Trento,31,2156,778,13,0,2,0,0,2949,1714,1225,35,2,2,0,0,2978,5927
22,Trento,32,2073,828,22,0,2,0,0,2925,1466,1384,48,3,1,0,0,2902,5827
22,Trento,33,2039,974,24,0,0,0,0,3037,1409,1475,60,4,3,0,0,2951,5988
22,Trento,34,1844,1177,27,1,1,0,0,3050,1287,1596,65,4,3,0,0,2955,6005
22,Trento,35,1801,1317,36,0,3,0,0,3157,1258,1731,67,3,2,0,0,3061,6218
22,Trento,36,1691,1456,48,2,2,0,0,3199,1149,1864,86,11,1,0,0,3111,6310
22,Trento,37,1597,1506,45,2,4,0,0,3154,1119,1799,98,6,1,0,0,3023,6177
22,Trento,38,1515,1597,53,2,4,0,0,3171,1054,1969,118,9,3,0,0,3153,6324
22,Trento,39,1501,1704,53,1,5,0,0,3264,981,2135,163,12,1,0,0,3292,6556
22,Trento,40,1545,1887,90,6,2,0,0,3530,1055,2297,176,24,0,0,0,3552,7082
22,Trento,41,1452,2038,116,0,2,0,0,3608,1003,2347,196,19,1,0,0,3566,7174
22,Trento,42,1436,2130,128,5,3,0,0,3702,987,2591,211,20,1,0,0,3810,7512
22,Trento,43,1412,2250,122,6,6,0,0,3796,952,2796,255,27,0,0,0,4030,7826
22,Trento,44,1439,2536,168,6,5,0,0,4154,935,2887,253,41,0,0,0,4116,8270
22,Trento,45,1333,2522,218,12,2,0,0,4087,864,2959,276,43,2,0,0,4144,8231
22,Trento,46,1222,2628,188,11,3,0,0,4052,816,2941,279,49,0,0,0,4085,8137
22,Trento,47,1252,2714,211,14,2,0,0,4193,766,3115,343,77,2,0,0,4303,8496
22,Trento,48,1034,2794,239,8,4,0,0,4079,776,2956,337,59,1,0,0,4129,8208
22,Trento,49,1100,2971,270,14,1,0,0,4356,816,3031,366,67,2,0,0,4282,8638
22,Trento,50,1098,3009,262,13,6,0,0,4388,693,3133,366,70,2,0,0,4264,8652
22,Trento,51,979,3024,297,22,1,0,1,4324,706,3283,387,71,4,0,0,4451,8775
22,Trento,52,1037,3072,270,13,2,0,0,4394,668,3333,383,100,1,0,0,4485,8879
22,Trento,53,954,3260,333,16,2,0,0,4565,657,3300,387,113,1,0,0,4458,9023
22,Trento,54,856,3249,325,42,5,0,0,4477,562,3363,432,155,0,0,0,4512,8989
22,Trento,55,772,3122,317,30,5,0,0,4246,523,3159,369,166,2,0,0,4219,8465
22,Trento,56,670,2881,296,43,2,0,0,3892,472,2996,375,180,0,0,0,4023,7915
22,Trento,57,628,2995,293,48,2,0,0,3966,510,3042,398,185,1,0,0,4136,8102
22,Trento,58,629,2872,296,46,4,0,0,3847,436,2953,317,190,2,0,0,3898,7745
22,Trento,59,540,2882,275,43,1,0,0,3741,383,2921,278,211,0,0,0,3793,7534
22,Trento,60,517,2677,243,58,1,0,0,3496,385,2718,266,257,1,0,0,3627,7123
22,Trento,61,479,2704,241,53,1,0,0,3478,348,2686,286,265,1,0,0,3586,7064
22,Trento,62,470,2713,223,67,2,0,0,3475,314,2586,246,327,1,0,0,3474,6949
22,Trento,63,443,2588,214,60,1,0,0,3306,327,2542,228,285,2,0,0,3384,6690
22,Trento,64,409,2531,182,70,2,0,0,3194,294,2419,210,360,1,0,0,3284,6478
22,Trento,65,408,2508,177,62,1,0,0,3156,306,2336,205,375,0,0,0,3222,6378
22,Trento,66,350,2471,171,95,0,0,0,3087,259,2291,183,429,0,0,1,3163,6250
22,Trento,67,379,2401,145,92,1,0,0,3018,241,2206,175,457,0,0,0,3079,6097
22,Trento,68,336,2485,146,96,1,0,0,3064,247,2296,161,551,1,0,0,3256,6320
22,Trento,69,316,2385,146,126,1,0,0,2974,237,2079,154,523,0,0,0,2993,5967
22,Trento,70,330,2446,140,133,0,0,0,3049,207,2121,135,604,1,0,0,3068,6117
22,Trento,71,305,2292,126,148,1,0,0,2872,229,2083,127,659,0,0,0,3098,5970
22,Trento,72,285,2456,101,157,0,0,0,2999,242,2111,124,790,0,0,0,3267,6266
22,Trento,73,180,1661,82,151,0,0,0,2074,151,1417,89,604,0,0,0,2261,4335
22,Trento,74,188,1869,82,144,0,0,0,2283,193,1514,82,762,1,0,0,2552,4835
22,Trento,75,253,1782,47,165,1,0,0,2248,206,1555,70,857,0,0,0,2688,4936
22,Trento,76,202,1767,77,202,0,0,0,2248,195,1398,61,942,1,0,0,2597,4845
22,Trento,77,211,1665,62,194,0,0,0,2132,199,1332,70,1008,0,0,0,2609,4741
22,Trento,78,214,1622,48,207,0,0,0,2091,215,1222,62,1176,0,0,1,2676,4767
22,Trento,79,203,1479,38,227,0,0,0,1947,224,1014,51,1150,0,0,0,2439,4386
22,Trento,80,173,1365,36,222,0,0,0,1796,237,946,40,1171,0,0,0,2394,4190
22,Trento,81,140,1198,28,203,0,0,0,1569,206,740,31,1135,0,0,0,2112,3681
22,Trento,82,127,1027,25,204,0,0,0,1383,171,630,38,1172,0,0,0,2011,3394
22,Trento,83,133,979,19,189,0,0,0,1320,202,532,29,1244,0,0,0,2007,3327
22,Trento,84,114,820,13,192,0,0,0,1139,189,439,30,1238,0,0,0,1896,3035
22,Trento,85,107,730,11,206,0,0,0,1054,174,341,16,1196,0,0,0,1727,2781
22,Trento,86,81,622,17,200,0,0,0,920,184,300,13,1135,0,0,0,1632,2552
22,Trento,87,66,575,17,177,0,0,0,835,164,218,14,1127,0,0,0,1523,2358
22,Trento,88,77,474,8,173,0,0,0,732,189,220,15,1152,0,0,0,1576,2308
22,Trento,89,68,359,11,142,0,0,0,580,163,132,9,968,0,0,0,1272,1852
22,Trento,90,47,266,3,167,0,0,0,483,131,97,10,921,0,0,0,1159,1642
22,Trento,91,38,229,0,130,0,0,0,397,141,72,8,760,0,0,0,981,1378
22,Trento,92,23,146,2,103,0,0,0,274,130,49,6,653,0,0,0,838,1112
22,Trento,93,22,112,3,91,0,0,0,228,96,21,5,564,0,0,0,686,914
22,Trento,94,12,77,2,82,0,0,0,173,84,22,5,456,0,0,0,567,740
22,Trento,95,10,46,0,88,0,0,0,144,72,9,4,418,0,0,0,503,647
22,Trento,96,6,34,1,56,0,0,0,97,52,8,5,323,0,0,0,388,485
22,Trento,97,4,21,0,45,0,0,0,70,36,5,1,221,0,0,0,263,333
22,Trento,98,6,12,0,21,0,0,0,39,30,4,1,155,0,0,0,190,229
22,Trento,99,1,6,0,13,0,0,0,20,9,1,0,77,0,0,0,87,107
22,Trento,100,1,2,0,12,0,0,0,15,15,1,0,75,0,0,0,91,106
23,Verona,0,3795,0,0,0,0,0,0,3795,3592,0,0,0,0,0,0,3592,7387
23,Verona,1,3916,0,0,0,0,0,0,3916,3739,0,0,0,0,0,0,3739,7655
23,Verona,2,4114,0,0,0,0,0,0,4114,3816,0,0,0,0,0,0,3816,7930
23,Verona,3,4193,0,0,0,0,0,0,4193,3933,0,0,0,0,0,0,3933,8126
23,Verona,4,4257,0,0,0,0,0,0,4257,4036,0,0,0,0,0,0,4036,8293
23,Verona,5,4231,0,0,0,0,0,0,4231,4031,0,0,0,0,0,0,4031,8262
23,Verona,6,4447,0,0,0,0,0,0,4447,4164,0,0,0,0,0,0,4164,8611
23,Verona,7,4554,0,0,0,0,0,0,4554,4266,0,0,0,0,0,0,4266,8820
23,Verona,8,4718,0,0,0,0,0,0,4718,4485,0,0,0,0,0,0,4485,9203
23,Verona,9,4776,0,0,0,0,0,0,4776,4416,0,0,0,0,0,0,4416,9192
23,Verona,10,4754,0,0,0,0,0,0,4754,4604,0,0,0,0,0,0,4604,9358
23,Verona,11,4723,0,0,0,0,0,0,4723,4450,0,0,0,0,0,0,4450,9173
23,Verona,12,4700,0,0,0,0,0,0,4700,4439,0,0,0,0,0,0,4439,9139
23,Verona,13,4695,0,0,0,0,0,0,4695,4409,0,0,0,0,0,0,4409,9104
23,Verona,14,4667,0,0,0,0,0,0,4667,4417,0,0,0,0,0,0,4417,9084
23,Verona,15,4440,0,0,0,0,0,0,4440,4309,0,0,0,0,0,0,4309,8749
23,Verona,16,4594,0,0,0,0,0,0,4594,4222,0,0,0,0,0,0,4222,8816
23,Verona,17,4457,0,0,0,0,0,0,4457,4297,0,0,0,0,0,0,4297,8754
23,Verona,18,4576,0,0,0,0,0,0,4576,4365,9,0,0,0,0,0,4374,8950
23,Verona,19,4739,2,0,0,0,0,0,4741,4351,29,0,0,0,0,0,4380,9121
23,Verona,20,4678,4,0,0,0,0,0,4682,4282,46,0,1,0,0,0,4329,9011
23,Verona,21,4639,10,0,0,0,0,0,4649,4245,115,1,0,0,0,0,4361,9010
23,Verona,22,4656,31,1,0,0,0,0,4688,4081,184,0,0,1,0,0,4266,8954
23,Verona,23,4689,55,1,0,2,0,0,4747,4016,274,3,0,0,0,0,4293,9040
23,Verona,24,4485,73,3,0,0,0,0,4561,4050,386,3,0,0,0,0,4439,9000
23,Verona,25,4448,169,0,0,1,0,0,4618,3958,537,6,2,0,0,0,4503,9121
23,Verona,26,4561,258,2,0,0,0,0,4821,3806,790,13,1,1,0,0,4611,9432
23,Verona,27,4391,381,5,0,0,0,0,4777,3660,1057,18,1,1,0,0,4737,9514
23,Verona,28,4365,587,5,0,1,0,0,4958,3489,1410,23,1,1,0,0,4924,9882
23,Verona,29,4170,882,8,1,3,0,0,5064,3187,1712,38,4,4,0,0,4945,10009
23,Verona,30,4103,1159,14,0,1,0,0,5277,2876,2167,51,4,5,0,0,5103,10380
23,Verona,31,3614,1366,25,1,2,0,0,5008,2667,2384,60,5,4,0,0,5120,10128
23,Verona,32,3433,1626,24,0,2,0,0,5085,2498,2558,84,3,2,0,0,5145,10230
23,Verona,33,3422,2023,48,2,4,0,0,5499,2305,2967,106,8,7,0,0,5393,10892
23,Verona,34,3128,2165,34,1,2,0,0,5330,2167,3121,128,15,2,0,0,5433,10763
23,Verona,35,2948,2486,57,0,3,0,0,5494,2144,3173,134,18,4,0,0,5473,10967
23,Verona,36,2896,2685,63,2,4,0,0,5650,2015,3528,192,16,1,0,0,5752,11402
23,Verona,37,2882,2948,110,4,2,0,0,5946,1940,3664,179,22,1,0,0,5806,11752
23,Verona,38,2659,3280,146,5,6,0,0,6096,1745,3819,238,23,2,0,0,5827,11923
23,Verona,39,2682,3363,144,2,4,0,0,6195,1845,4053,282,22,10,0,0,6212,12407
23,Verona,40,2685,3565,168,6,3,0,0,6427,1787,4295,320,34,4,0,0,6440,12867
23,Verona,41,2665,3804,215,7,5,0,0,6696,1690,4409,383,36,3,0,0,6521,13217
23,Verona,42,2550,4120,232,8,5,0,0,6915,1600,4806,402,42,2,0,0,6852,13767
23,Verona,43,2564,4461,287,12,5,0,0,7329,1642,5070,471,54,3,0,0,7240,14569
23,Verona,44,2609,4807,315,16,3,0,0,7750,1687,5225,549,71,1,0,0,7533,15283
23,Verona,45,2404,4705,388,19,5,0,0,7521,1571,5090,589,75,4,0,0,7329,14850
23,Verona,46,2313,5029,410,19,10,0,0,7781,1416,5280,611,79,4,0,0,7390,15171
23,Verona,47,2198,5087,421,27,9,0,0,7742,1438,5303,664,97,4,0,0,7506,15248
23,Verona,48,2120,5178,446,27,0,0,0,7771,1297,5250,698,110,1,0,0,7356,15127
23,Verona,49,1898,5416,540,31,7,0,0,7892,1263,5689,698,122,3,0,0,7775,15667
23,Verona,50,1762,5371,543,40,3,0,0,7719,1132,5558,692,147,0,0,0,7529,15248
23,Verona,51,1597,5596,563,35,4,0,0,7795,1172,5549,704,172,2,0,0,7599,15394
23,Verona,52,1536,5504,589,49,6,0,0,7684,1082,5637,767,181,4,1,0,7672,15356
23,Verona,53,1386,5626,599,60,4,0,0,7675,1026,5628,749,213,7,0,0,7623,15298
23,Verona,54,1318,5653,645,42,3,0,0,7661,999,5673,778,275,1,0,0,7726,15387
23,Verona,55,1290,5348,574,55,6,0,0,7273,841,5353,680,271,5,0,0,7150,14423
23,Verona,56,1055,5085,546,67,7,0,0,6760,765,5009,693,299,2,0,0,6768,13528
23,Verona,57,950,5036,533,77,8,0,0,6604,747,4986,634,335,2,0,0,6704,13308
23,Verona,58,905,4774,461,82,4,0,0,6226,614,4765,594,363,3,0,0,6339,12565
23,Verona,59,808,4753,481,88,3,0,0,6133,602,4864,460,373,4,0,0,6303,12436
23,Verona,60,712,4506,446,80,3,0,0,5747,536,4624,470,410,1,0,0,6041,11788
23,Verona,61,690,4448,391,92,2,0,0,5623,540,4494,453,475,2,0,0,5964,11587
23,Verona,62,648,4443,413,101,2,0,0,5607,501,4283,457,551,0,0,0,5792,11399
23,Verona,63,576,4330,349,113,4,0,0,5372,414,4290,390,544,0,0,0,5638,11010
23,Verona,64,530,4231,322,127,3,0,0,5213,413,4087,368,604,0,0,0,5472,10685
23,Verona,65,487,4140,265,126,2,0,0,5020,334,3846,317,628,0,0,0,5125,10145
23,Verona,66,480,3952,257,157,5,0,0,4851,342,3775,271,715,0,0,0,5103,9954
23,Verona,67,421,3957,205,186,1,0,0,4770,341,3738,293,765,0,0,0,5137,9907
23,Verona,68,438,4062,214,203,0,0,0,4917,345,3834,290,878,1,0,0,5348,10265
23,Verona,69,391,3883,196,223,3,0,0,4696,335,3753,275,979,1,0,0,5343,10039
23,Verona,70,387,4176,180,239,2,0,0,4984,304,3934,232,1097,1,0,0,5568,10552
23,Verona,71,397,4053,157,257,1,0,0,4865,321,3597,228,1269,0,0,0,5415,10280
23,Verona,72,460,4315,200,293,1,0,0,5269,391,3888,231,1454,0,0,0,5964,11233
23,Verona,73,262,2785,99,226,2,0,0,3374,257,2369,148,1030,0,0,0,3804,7178
23,Verona,74,316,3121,114,270,2,0,0,3823,315,2781,125,1274,0,0,0,4495,8318
23,Verona,75,318,3183,122,275,1,0,0,3899,321,2726,154,1523,0,0,0,4724,8623
23,Verona,76,307,3040,93,285,1,0,0,3726,306,2544,150,1532,0,0,0,4532,8258
23,Verona,77,239,2936,83,341,2,0,0,3601,323,2268,112,1656,0,0,1,4360,7961
23,Verona,78,294,2984,87,386,2,0,0,3753,313,2168,104,1975,0,0,0,4560,8313
23,Verona,79,247,2887,66,429,0,0,0,3629,333,2042,97,2106,0,0,0,4578,8207
23,Verona,80,271,2591,65,398,0,0,0,3325,297,1820,90,2214,0,0,0,4421,7746
23,Verona,81,208,2340,44,415,1,0,0,3008,278,1462,66,2113,0,0,0,3919,6927
23,Verona,82,197,1943,28,386,0,0,0,2554,248,1180,49,2091,0,0,0,3568,6122
23,Verona,83,182,1821,39,374,1,0,0,2417,281,1001,46,2216,0,1,0,3545,5962
23,Verona,84,183,1582,25,391,0,0,0,2181,243,853,46,2144,0,0,0,3286,5467
23,Verona,85,153,1344,17,385,0,0,0,1899,271,632,39,2008,0,0,0,2950,4849
23,Verona,86,105,1123,15,351,0,0,0,1594,252,503,28,2168,0,0,0,2951,4545
23,Verona,87,117,948,14,309,0,0,0,1388,243,426,21,1995,0,0,0,2685,4073
23,Verona,88,79,774,11,328,0,0,0,1192,245,337,23,1950,0,0,0,2555,3747
23,Verona,89,72,599,13,278,0,0,0,962,213,205,25,1687,0,0,0,2130,3092
23,Verona,90,52,485,7,243,0,0,0,787,180,144,15,1492,0,0,0,1831,2618
23,Verona,91,44,362,5,226,0,0,0,637,179,110,10,1377,0,0,0,1676,2313
23,Verona,92,32,281,4,180,0,0,0,497,146,74,9,1096,0,0,0,1325,1822
23,Verona,93,23,174,0,159,0,0,0,356,120,49,5,907,0,0,0,1081,1437
23,Verona,94,16,112,3,108,0,0,0,239,103,28,8,782,0,0,0,921,1160
23,Verona,95,17,83,1,101,0,0,0,202,77,18,4,601,0,0,0,700,902
23,Verona,96,6,46,0,51,0,0,0,103,68,8,2,430,0,0,0,508,611
23,Verona,97,10,26,0,46,0,0,0,82,47,3,1,321,0,0,0,372,454
23,Verona,98,5,19,0,35,0,0,0,59,41,2,1,233,0,0,0,277,336
23,Verona,99,2,9,0,11,0,0,0,22,19,0,0,103,0,0,0,122,144
23,Verona,100,2,6,0,15,0,0,0,23,27,1,2,162,0,0,0,192,215
24,Vicenza,0,3325,0,0,0,0,0,0,3325,3097,0,0,0,0,0,0,3097,6422
24,Vicenza,1,3428,0,0,0,0,0,0,3428,3198,0,0,0,0,0,0,3198,6626
24,Vicenza,2,3472,0,0,0,0,0,0,3472,3358,0,0,0,0,0,0,3358,6830
24,Vicenza,3,3619,0,0,0,0,0,0,3619,3554,0,0,0,0,0,0,3554,7173
24,Vicenza,4,3854,0,0,0,0,0,0,3854,3650,0,0,0,0,0,0,3650,7504
24,Vicenza,5,3790,0,0,0,0,0,0,3790,3781,0,0,0,0,0,0,3781,7571
24,Vicenza,6,4006,0,0,0,0,0,0,4006,3947,0,0,0,0,0,0,3947,7953
24,Vicenza,7,4099,0,0,0,0,0,0,4099,3975,0,0,0,0,0,0,3975,8074
24,Vicenza,8,4288,0,0,0,0,0,0,4288,4026,0,0,0,0,0,0,4026,8314
24,Vicenza,9,4400,0,0,0,0,0,0,4400,4186,0,0,0,0,0,0,4186,8586
24,Vicenza,10,4521,0,0,0,0,0,0,4521,4227,0,0,0,0,0,0,4227,8748
24,Vicenza,11,4393,0,0,0,0,0,0,4393,4271,0,0,0,0,0,0,4271,8664
24,Vicenza,12,4493,0,0,0,0,0,0,4493,4203,0,0,0,0,0,0,4203,8696
24,Vicenza,13,4505,0,0,0,0,0,0,4505,4284,0,0,0,0,0,0,4284,8789
24,Vicenza,14,4587,0,0,0,0,0,0,4587,4410,0,0,0,0,0,0,4410,8997
24,Vicenza,15,4381,0,0,0,0,0,0,4381,4235,0,0,0,0,0,0,4235,8616
24,Vicenza,16,4460,0,0,0,0,0,0,4460,4321,0,0,0,0,0,0,4321,8781
24,Vicenza,17,4542,0,0,0,0,0,0,4542,4150,1,0,0,0,0,0,4151,8693
24,Vicenza,18,4631,0,0,0,0,0,0,4631,4291,10,0,0,0,0,0,4301,8932
24,Vicenza,19,4434,0,0,0,0,0,0,4434,4351,28,0,0,0,0,0,4379,8813
24,Vicenza,20,4708,3,0,0,0,0,0,4711,4171,64,0,0,0,0,0,4235,8946
24,Vicenza,21,4816,18,0,0,0,0,0,4834,4237,121,1,0,0,0,0,4359,9193
24,Vicenza,22,4647,29,0,0,1,0,0,4677,4093,142,0,0,0,0,0,4235,8912
24,Vicenza,23,4530,51,0,0,0,0,0,4581,3941,260,2,0,0,0,0,4203,8784
24,Vicenza,24,4447,101,0,0,0,0,0,4548,3841,359,5,1,1,0,0,4207,8755
24,Vicenza,25,4377,164,1,0,2,0,0,4544,3960,457,11,1,0,0,0,4429,8973
24,Vicenza,26,4565,232,1,0,1,0,0,4799,3643,681,9,0,4,0,0,4337,9136
24,Vicenza,27,4116,355,3,0,1,0,0,4475,3455,890,16,2,0,0,0,4363,8838
24,Vicenza,28,4185,534,2,0,3,0,0,4724,3183,1138,16,3,0,0,0,4340,9064
24,Vicenza,29,3951,734,8,0,4,0,0,4697,2960,1436,29,2,1,0,0,4428,9125
24,Vicenza,30,3668,876,18,2,2,0,0,4566,2728,1824,46,4,2,0,0,4604,9170
24,Vicenza,31,3301,1123,11,1,4,0,0,4440,2361,1856,39,3,1,0,0,4260,8700
24,Vicenza,32,3147,1332,21,1,3,0,0,4504,2228,2118,60,3,2,0,0,4411,8915
24,Vicenza,33,3033,1500,29,2,3,0,0,4567,2147,2345,80,6,4,0,0,4582,9149
24,Vicenza,34,2821,1742,39,1,7,0,0,4610,2018,2556,83,4,1,0,0,4662,9272
24,Vicenza,35,2717,1941,47,0,3,0,0,4708,1795,2772,101,17,2,0,0,4687,9395
24,Vicenza,36,2682,2132,74,2,3,0,0,4893,1802,3024,127,13,4,0,0,4970,9863
24,Vicenza,37,2575,2430,70,1,3,0,0,5079,1763,3150,144,20,1,0,0,5078,10157
24,Vicenza,38,2604,2542,86,2,2,0,0,5236,1607,3239,166,19,1,0,0,5032,10268
24,Vicenza,39,2406,2838,127,2,6,0,0,5379,1586,3528,209,25,2,0,0,5350,10729
24,Vicenza,40,2555,3183,109,3,4,0,0,5854,1648,3827,250,23,2,0,0,5750,11604
24,Vicenza,41,2578,3351,166,2,7,0,0,6104,1608,4052,259,40,1,0,0,5960,12064
24,Vicenza,42,2459,3576,185,9,2,0,0,6231,1492,4309,356,43,3,0,0,6203,12434
24,Vicenza,43,2527,3856,204,9,6,0,0,6602,1499,4537,371,48,3,0,0,6458,13060
24,Vicenza,44,2592,4356,233,6,10,0,0,7197,1455,4890,420,54,1,0,0,6820,14017
24,Vicenza,45,2382,4323,283,17,4,0,0,7009,1399,4948,422,77,2,0,0,6848,13857
24,Vicenza,46,2206,4689,323,29,8,0,0,7255,1306,5067,441,89,5,0,0,6908,14163
24,Vicenza,47,2153,4759,367,26,1,0,0,7306,1357,5226,465,84,1,0,1,7134,14440
24,Vicenza,48,1969,5032,376,24,4,0,0,7405,1138,5245,497,104,0,0,0,6984,14389
24,Vicenza,49,1924,5146,428,39,5,0,0,7542,1194,5466,498,113,2,0,0,7273,14815
24,Vicenza,50,1789,5255,407,25,3,0,0,7479,1193,5423,538,132,1,0,0,7287,14766
24,Vicenza,51,1679,5510,437,46,3,0,0,7675,1008,5496,559,150,3,0,0,7216,14891
24,Vicenza,52,1589,5566,462,47,10,0,0,7674,937,5634,575,167,1,0,0,7314,14988
24,Vicenza,53,1468,5640,474,43,3,0,0,7628,879,5601,608,227,2,0,0,7317,14945
24,Vicenza,54,1334,5610,496,61,1,0,0,7502,890,5684,579,216,2,0,0,7371,14873
24,Vicenza,55,1148,5220,452,68,2,0,0,6890,766,5362,528,247,1,0,0,6904,13794
24,Vicenza,56,1014,5156,448,73,3,0,0,6694,743,5018,530,284,2,0,0,6577,13271
24,Vicenza,57,965,5002,455,68,3,0,0,6493,666,4908,469,302,1,0,0,6346,12839
24,Vicenza,58,820,4815,392,75,7,0,0,6109,639,4779,452,302,1,0,0,6173,12282
24,Vicenza,59,785,4734,398,88,1,0,0,6006,544,4540,448,383,0,0,0,5915,11921
24,Vicenza,60,698,4384,320,78,4,0,0,5484,479,4263,380,385,1,0,0,5508,10992
24,Vicenza,61,668,4324,309,101,2,0,0,5404,463,4110,380,417,0,0,0,5370,10774
24,Vicenza,62,601,4083,292,117,3,0,0,5096,458,4067,327,438,0,0,0,5290,10386
24,Vicenza,63,576,4063,272,109,1,0,0,5021,367,3929,311,512,1,0,0,5120,10141
24,Vicenza,64,569,4030,228,139,2,0,0,4968,367,3772,295,555,0,0,0,4989,9957
24,Vicenza,65,466,3849,233,137,1,0,0,4686,341,3741,257,619,0,0,0,4958,9644
24,Vicenza,66,452,3868,203,142,1,0,0,4666,323,3632,246,619,1,0,0,4821,9487
24,Vicenza,67,470,3887,199,138,2,0,0,4696,299,3545,207,694,0,0,1,4746,9442
24,Vicenza,68,435,3936,201,178,3,0,0,4753,329,3714,216,827,1,0,0,5087,9840
24,Vicenza,69,376,3902,187,188,0,0,0,4653,298,3565,173,915,0,0,0,4951,9604
24,Vicenza,70,406,3860,160,207,0,0,0,4633,365,3549,197,1014,0,0,0,5125,9758
24,Vicenza,71,368,3598,133,224,1,0,0,4324,330,3283,180,1096,0,0,0,4889,9213
24,Vicenza,72,387,4035,143,277,2,0,0,4844,333,3605,181,1325,0,0,0,5444,10288
24,Vicenza,73,266,2692,92,207,2,0,0,3259,228,2394,118,1044,0,0,0,3784,7043
24,Vicenza,74,293,3080,85,223,0,0,0,3681,258,2546,120,1326,0,0,0,4250,7931
24,Vicenza,75,273,3093,86,261,0,0,0,3713,257,2648,120,1503,0,0,0,4528,8241
24,Vicenza,76,278,2893,87,328,0,0,0,3586,305,2376,105,1507,0,0,0,4293,7879
24,Vicenza,77,297,2766,85,345,0,0,0,3493,273,2204,85,1658,0,0,0,4220,7713
24,Vicenza,78,257,2851,78,373,1,0,0,3560,288,2137,77,1934,0,0,0,4436,7996
24,Vicenza,79,264,2745,47,397,0,0,0,3453,257,1775,83,2048,0,0,0,4163,7616
24,Vicenza,80,219,2489,45,349,0,0,0,3102,288,1584,59,2113,0,0,0,4044,7146
24,Vicenza,81,171,2087,28,341,0,0,0,2627,262,1310,65,1972,0,0,0,3609,6236
24,Vicenza,82,156,1687,24,343,0,0,0,2210,264,1046,44,1985,0,0,0,3339,5549
24,Vicenza,83,147,1644,28,326,0,0,0,2145,252,854,37,2026,0,0,0,3169,5314
24,Vicenza,84,120,1405,28,343,0,0,0,1896,267,751,26,2014,0,0,0,3058,4954
24,Vicenza,85,115,1116,18,339,0,0,0,1588,220,510,27,1857,0,0,0,2614,4202
24,Vicenza,86,110,943,9,316,0,0,0,1378,233,451,30,1837,0,0,0,2551,3929
24,Vicenza,87,69,803,8,320,0,0,0,1200,207,312,15,1782,0,0,0,2316,3516
24,Vicenza,88,74,696,8,282,1,0,0,1061,231,228,19,1720,0,0,0,2198,3259
24,Vicenza,89,55,525,5,225,0,0,0,810,177,164,13,1449,0,0,0,1803,2613
24,Vicenza,90,49,396,4,196,0,0,0,645,164,128,10,1341,0,0,0,1643,2288
24,Vicenza,91,35,294,2,197,0,0,0,528,170,91,7,1165,0,0,0,1433,1961
24,Vicenza,92,24,202,2,153,0,0,0,381,128,54,5,973,0,0,0,1160,1541
24,Vicenza,93,20,129,1,138,0,0,0,288,119,39,4,841,0,0,0,1003,1291
24,Vicenza,94,17,84,1,100,0,0,0,202,103,20,4,588,0,0,0,715,917
24,Vicenza,95,5,68,2,68,0,0,0,143,73,9,5,517,0,0,0,604,747
24,Vicenza,96,7,49,0,49,0,0,0,105,62,10,0,388,0,0,0,460,565
24,Vicenza,97,3,21,0,43,0,0,0,67,35,5,1,268,0,0,0,309,376
24,Vicenza,98,4,6,0,25,0,0,0,35,33,1,1,167,0,0,0,202,237
24,Vicenza,99,0,7,0,12,0,0,0,19,19,0,0,76,0,0,0,95,114
24,Vicenza,100,1,5,0,13,0,0,0,19,20,3,0,137,0,0,0,160,179
25,Belluno,0,640,0,0,0,0,0,0,640,635,0,0,0,0,0,0,635,1275
25,Belluno,1,697,0,0,0,0,0,0,697,602,0,0,0,0,0,0,602,1299
25,Belluno,2,686,0,0,0,0,0,0,686,645,0,0,0,0,0,0,645,1331
25,Belluno,3,714,0,0,0,0,0,0,714,688,0,0,0,0,0,0,688,1402
25,Belluno,4,705,0,0,0,0,0,0,705,682,0,0,0,0,0,0,682,1387
25,Belluno,5,746,0,0,0,0,0,0,746,703,0,0,0,0,0,0,703,1449
25,Belluno,6,808,0,0,0,0,0,0,808,755,0,0,0,0,0,0,755,1563
25,Belluno,7,869,0,0,0,0,0,0,869,798,0,0,0,0,0,0,798,1667
25,Belluno,8,863,0,0,0,0,0,0,863,832,0,0,0,0,0,0,832,1695
25,Belluno,9,858,0,0,0,0,0,0,858,815,0,0,0,0,0,0,815,1673
25,Belluno,10,917,0,0,0,0,0,0,917,851,0,0,0,0,0,0,851,1768
25,Belluno,11,907,0,0,0,0,0,0,907,797,0,0,0,0,0,0,797,1704
25,Belluno,12,896,0,0,0,0,0,0,896,881,0,0,0,0,0,0,881,1777
25,Belluno,13,914,0,0,0,0,0,0,914,824,0,0,0,0,0,0,824,1738
25,Belluno,14,925,0,0,0,0,0,0,925,863,0,0,0,0,0,0,863,1788
25,Belluno,15,923,0,0,0,0,0,0,923,858,0,0,0,0,0,0,858,1781
25,Belluno,16,976,0,0,0,0,0,0,976,913,0,0,0,0,0,0,913,1889
25,Belluno,17,893,0,0,0,0,0,0,893,844,0,0,0,0,0,0,844,1737
25,Belluno,18,1000,0,0,0,0,0,0,1000,961,2,0,0,0,0,0,963,1963
25,Belluno,19,958,0,0,0,0,0,0,958,876,5,0,0,0,0,0,881,1839
25,Belluno,20,1014,2,0,0,0,0,0,1016,890,22,0,0,0,0,0,912,1928
25,Belluno,21,1001,6,0,0,0,0,0,1007,851,15,0,0,0,0,0,866,1873
25,Belluno,22,1011,3,0,0,0,0,0,1014,883,32,0,0,0,0,0,915,1929
25,Belluno,23,944,17,0,0,0,0,0,961,831,46,0,0,0,0,0,877,1838
25,Belluno,24,951,31,0,0,0,0,0,982,830,58,0,0,0,0,0,888,1870
25,Belluno,25,950,35,0,0,0,0,0,985,836,74,2,0,1,0,0,913,1898
25,Belluno,26,980,45,0,0,0,0,0,1025,862,115,1,0,0,0,0,978,2003
25,Belluno,27,927,66,0,0,2,0,0,995,758,149,2,0,0,0,0,909,1904
25,Belluno,28,944,85,1,0,1,0,0,1031,741,199,3,1,0,0,0,944,1975
25,Belluno,29,892,117,0,1,0,0,0,1010,673,232,5,1,1,0,0,912,1922
25,Belluno,30,831,140,0,0,3,0,0,974,678,236,10,1,0,0,0,925,1899
25,Belluno,31,791,199,3,0,0,0,0,993,585,323,14,3,0,0,0,925,1918
25,Belluno,32,707,213,3,0,1,0,0,924,591,343,16,0,0,0,0,950,1874
25,Belluno,33,728,244,3,0,0,0,0,975,543,389,13,1,0,0,0,946,1921
25,Belluno,34,700,264,5,1,1,0,0,971,550,437,12,1,0,0,0,1000,1971
25,Belluno,35,768,330,12,0,1,0,0,1111,514,464,22,1,0,0,0,1001,2112
25,Belluno,36,684,350,17,1,0,0,0,1052,527,492,27,2,1,0,0,1049,2101
25,Belluno,37,694,397,12,1,1,0,0,1105,511,523,19,3,1,0,0,1057,2162
25,Belluno,38,652,408,10,0,1,0,0,1071,458,550,36,5,0,0,0,1049,2120
25,Belluno,39,657,483,14,1,1,0,0,1156,468,533,44,5,1,0,0,1051,2207
25,Belluno,40,684,496,24,1,0,0,0,1205,439,677,56,4,0,0,0,1176,2381
25,Belluno,41,657,544,36,1,1,0,0,1239,458,760,60,10,0,0,0,1288,2527
25,Belluno,42,663,642,46,0,2,0,0,1353,474,802,70,7,0,0,0,1353,2706
25,Belluno,43,666,692,43,4,1,0,0,1406,466,921,84,12,1,0,0,1484,2890
25,Belluno,44,699,772,62,5,0,0,0,1538,481,949,88,17,2,0,0,1537,3075
25,Belluno,45,688,808,79,4,1,0,0,1580,423,1053,98,18,1,0,0,1593,3173
25,Belluno,46,586,912,78,2,0,0,0,1578,459,1084,114,21,0,0,0,1678,3256
25,Belluno,47,600,939,96,5,0,0,0,1640,413,1095,130,24,0,0,0,1662,3302
25,Belluno,48,548,954,97,8,2,0,0,1609,409,1113,156,24,1,0,0,1703,3312
25,Belluno,49,516,1027,104,7,0,0,0,1654,337,1183,148,35,0,0,0,1703,3357
25,Belluno,50,510,1060,105,6,1,0,0,1682,354,1179,136,41,0,0,0,1710,3392
25,Belluno,51,443,1061,119,4,1,0,0,1628,338,1227,149,38,0,0,0,1752,3380
25,Belluno,52,423,1100,129,9,0,0,0,1661,333,1236,147,47,0,0,0,1763,3424
25,Belluno,53,454,1158,131,13,1,0,0,1757,277,1197,161,47,0,0,0,1682,3439
25,Belluno,54,401,1125,137,15,1,0,0,1679,303,1259,166,56,0,0,0,1784,3463
25,Belluno,55,361,1137,128,12,0,0,0,1638,268,1213,149,65,0,0,0,1695,3333
25,Belluno,56,301,1104,145,22,2,0,0,1574,227,1180,120,68,0,0,0,1595,3169
25,Belluno,57,327,1120,107,25,2,0,0,1581,234,1143,144,102,0,1,0,1624,3205
25,Belluno,58,275,1121,103,15,0,0,0,1514,198,1132,125,93,0,0,0,1548,3062
25,Belluno,59,274,1131,118,21,3,0,0,1547,202,1116,126,114,0,0,0,1558,3105
25,Belluno,60,270,1009,95,28,0,0,0,1402,179,1053,94,122,0,0,0,1448,2850
25,Belluno,61,255,1031,96,20,1,0,0,1403,160,1043,104,144,0,0,0,1451,2854
25,Belluno,62,214,1030,78,23,0,0,0,1345,155,1083,96,124,0,0,0,1458,2803
25,Belluno,63,215,1018,93,45,0,0,0,1371,166,1091,68,129,0,0,0,1454,2825
25,Belluno,64,202,1067,73,38,0,0,0,1380,133,1053,94,177,0,0,0,1457,2837
25,Belluno,65,193,1093,68,39,0,0,0,1393,121,925,75,204,0,0,0,1325,2718
25,Belluno,66,163,1018,67,39,0,0,0,1287,135,979,80,203,0,0,0,1397,2684
25,Belluno,67,144,1043,48,50,0,0,0,1285,119,981,62,228,0,0,0,1390,2675
25,Belluno,68,159,1024,70,57,0,0,0,1310,136,1088,71,267,0,0,0,1562,2872
25,Belluno,69,173,1046,60,64,0,0,0,1343,105,918,65,279,0,0,0,1367,2710
25,Belluno,70,156,1031,50,70,0,0,1,1308,121,945,65,340,0,0,0,1471,2779
25,Belluno,71,139,1103,50,99,0,0,0,1391,110,943,55,358,0,0,0,1466,2857
25,Belluno,72,166,1095,44,109,1,0,0,1415,106,944,45,407,0,0,0,1502,2917
25,Belluno,73,104,735,35,75,0,0,0,949,86,643,30,318,0,0,0,1077,2026
25,Belluno,74,99,809,30,81,0,0,0,1019,64,664,37,414,0,0,0,1179,2198
25,Belluno,75,93,801,25,99,0,0,0,1018,85,666,29,408,0,0,0,1188,2206
25,Belluno,76,105,753,20,87,0,0,0,965,92,594,29,475,0,0,0,1190,2155
25,Belluno,77,98,776,26,100,0,0,0,1000,87,528,33,537,0,0,0,1185,2185
25,Belluno,78,111,728,25,120,0,0,0,984,90,527,30,553,0,0,0,1200,2184
25,Belluno,79,83,763,19,132,0,0,0,997,89,465,15,620,0,0,0,1189,2186
25,Belluno,80,80,607,20,121,0,0,0,828,87,405,18,604,0,0,0,1114,1942
25,Belluno,81,68,502,7,124,0,0,0,701,91,336,11,538,0,0,0,976,1677
25,Belluno,82,56,456,7,94,0,0,0,613,87,285,12,537,0,0,0,921,1534
25,Belluno,83,36,370,9,99,0,0,0,514,68,205,11,608,0,0,0,892,1406
25,Belluno,84,46,366,5,119,0,0,0,536,62,202,9,557,0,0,0,830,1366
25,Belluno,85,44,279,8,98,0,0,0,429,76,119,12,572,0,0,0,779,1208
25,Belluno,86,36,239,13,101,0,0,0,389,64,134,9,583,0,0,0,790,1179
25,Belluno,87,29,228,4,101,0,0,0,362,53,69,8,552,0,0,0,682,1044
25,Belluno,88,31,195,4,81,0,0,0,311,59,63,5,531,0,0,0,658,969
25,Belluno,89,28,128,3,81,0,0,0,240,51,44,4,481,0,0,0,580,820
25,Belluno,90,11,107,3,58,0,0,0,179,41,23,2,447,0,0,0,513,692
25,Belluno,91,10,84,0,61,0,0,0,155,35,29,2,370,0,0,0,436,591
25,Belluno,92,9,64,0,52,0,0,0,125,33,15,0,330,0,0,0,378,503
25,Belluno,93,8,30,0,38,0,0,0,76,28,15,1,229,0,0,0,273,349
25,Belluno,94,1,18,1,25,0,0,0,45,28,5,0,206,0,0,0,239,284
25,Belluno,95,2,19,0,32,0,0,0,53,14,6,3,174,0,0,0,197,250
25,Belluno,96,1,16,0,23,0,0,0,40,13,3,1,136,0,0,0,153,193
25,Belluno,97,2,11,0,15,0,0,0,28,5,0,0,98,0,0,0,103,131
25,Belluno,98,2,1,0,3,0,0,0,6,11,1,0,89,0,0,0,101,107
25,Belluno,99,0,0,0,5,0,0,0,5,4,0,0,20,0,0,0,24,29
25,Belluno,100,0,0,0,3,0,0,0,3,9,0,0,42,0,0,0,51,54
26,Treviso,0,3451,0,0,0,0,0,0,3451,3194,0,0,0,0,0,0,3194,6645
26,Treviso,1,3643,0,0,0,0,0,0,3643,3382,0,0,0,0,0,0,3382,7025
26,Treviso,2,3761,0,0,0,0,0,0,3761,3498,0,0,0,0,0,0,3498,7259
26,Treviso,3,3844,0,0,0,0,0,0,3844,3573,0,0,0,0,0,0,3573,7417
26,Treviso,4,3937,0,0,0,0,0,0,3937,3854,0,0,0,0,0,0,3854,7791
26,Treviso,5,4043,0,0,0,0,0,0,4043,3941,0,0,0,0,0,0,3941,7984
26,Treviso,6,4285,0,0,0,0,0,0,4285,4109,0,0,0,0,0,0,4109,8394
26,Treviso,7,4362,0,0,0,0,0,0,4362,4111,0,0,0,0,0,0,4111,8473
26,Treviso,8,4607,0,0,0,0,0,0,4607,4210,0,0,0,0,0,0,4210,8817
26,Treviso,9,4556,0,0,0,0,0,0,4556,4336,0,0,0,0,0,0,4336,8892
26,Treviso,10,4569,0,0,0,0,0,0,4569,4571,0,0,0,0,0,0,4571,9140
26,Treviso,11,4670,0,0,0,0,0,0,4670,4464,0,0,0,0,0,0,4464,9134
26,Treviso,12,4708,0,0,0,0,0,0,4708,4472,0,0,0,0,0,0,4472,9180
26,Treviso,13,4658,0,0,0,0,0,0,4658,4438,0,0,0,0,0,0,4438,9096
26,Treviso,14,4771,0,0,0,0,0,0,4771,4301,0,0,0,0,0,0,4301,9072
26,Treviso,15,4576,0,0,0,0,0,0,4576,4463,0,0,0,0,0,0,4463,9039
26,Treviso,16,4601,0,0,0,0,0,0,4601,4263,0,0,0,0,0,0,4263,8864
26,Treviso,17,4490,0,0,0,0,0,0,4490,4102,0,0,0,0,0,0,4102,8592
26,Treviso,18,4778,0,0,0,0,0,0,4778,4413,14,0,0,0,0,0,4427,9205
26,Treviso,19,4542,2,0,0,0,0,0,4544,4229,51,0,0,0,0,0,4280,8824
26,Treviso,20,4806,8,0,1,0,0,0,4815,4179,75,1,1,0,0,0,4256,9071
26,Treviso,21,4693,17,0,2,0,0,0,4712,4101,125,0,0,0,0,0,4226,8938
26,Treviso,22,4752,34,1,1,0,0,0,4788,4049,212,0,0,0,0,0,4261,9049
26,Treviso,23,4479,62,2,1,0,0,0,4544,3764,316,0,2,0,0,0,4082,8626
26,Treviso,24,4527,108,2,2,1,0,0,4640,3844,386,4,2,0,0,0,4236,8876
26,Treviso,25,4350,186,1,1,1,0,0,4539,3613,536,7,1,0,0,0,4157,8696
26,Treviso,26,4347,264,4,3,1,0,0,4619,3694,676,9,3,1,0,0,4383,9002
26,Treviso,27,4155,429,5,0,1,0,0,4590,3462,923,10,0,2,0,0,4397,8987
26,Treviso,28,4157,559,3,1,1,0,0,4721,3164,1156,13,4,1,0,0,4338,9059
26,Treviso,29,3764,793,9,2,2,0,0,4570,2991,1481,24,1,0,0,0,4497,9067
26,Treviso,30,3642,946,12,3,2,0,0,4605,2733,1816,22,4,0,0,0,4575,9180
26,Treviso,31,3270,1223,18,3,1,0,0,4515,2457,1905,47,4,1,0,0,4414,8929
26,Treviso,32,3146,1315,19,1,5,1,0,4487,2242,2173,52,6,0,0,0,4473,8960
26,Treviso,33,3027,1625,35,4,2,0,0,4693,2191,2481,78,12,2,0,1,4765,9458
26,Treviso,34,2919,1867,38,2,3,0,0,4829,2002,2678,80,12,2,0,0,4774,9603
26,Treviso,35,2800,2003,41,4,4,0,0,4852,1893,2936,98,10,2,0,0,4939,9791
26,Treviso,36,2724,2352,58,1,2,0,0,5137,1898,3116,121,15,1,0,0,5151,10288
26,Treviso,37,2619,2510,62,3,3,0,0,5197,1831,3145,166,15,1,0,0,5158,10355
26,Treviso,38,2562,2769,84,7,1,0,0,5423,1751,3351,169,16,2,0,0,5289,10712
26,Treviso,39,2522,2858,103,7,0,0,0,5490,1669,3571,195,22,2,0,0,5459,10949
26,Treviso,40,2674,3232,156,6,1,0,0,6069,1859,3929,232,28,1,0,0,6049,12118
26,Treviso,41,2555,3478,133,7,4,0,0,6177,1745,4168,260,34,1,0,0,6208,12385
26,Treviso,42,2594,3645,185,8,10,0,0,6442,1718,4360,278,50,2,0,0,6408,12850
26,Treviso,43,2537,4073,226,10,3,0,0,6849,1715,4621,363,60,6,0,0,6765,13614
26,Treviso,44,2656,4414,241,14,1,0,0,7326,1834,4972,415,80,1,0,0,7302,14628
26,Treviso,45,2458,4549,305,18,4,0,0,7334,1581,5058,408,62,2,0,0,7111,14445
26,Treviso,46,2330,4700,304,19,1,0,0,7354,1641,4980,434,79,2,0,0,7136,14490
26,Treviso,47,2298,4754,325,21,2,0,0,7400,1459,5448,503,93,4,0,0,7507,14907
26,Treviso,48,2064,5051,341,20,2,0,0,7478,1361,5448,483,85,2,0,0,7379,14857
26,Treviso,49,1921,5300,409,25,4,0,0,7659,1295,5577,579,112,3,0,0,7566,15225
26,Treviso,50,1829,5184,412,33,2,0,0,7460,1239,5533,554,126,3,0,0,7455,14915
26,Treviso,51,1673,5440,402,46,2,0,1,7564,1190,5611,585,157,0,0,0,7543,15107
26,Treviso,52,1664,5588,436,56,2,0,0,7746,1091,5600,581,156,3,0,0,7431,15177
26,Treviso,53,1480,5621,475,60,6,0,0,7642,1074,5730,585,184,0,0,0,7573,15215
26,Treviso,54,1369,5702,468,64,4,1,0,7608,974,5688,589,200,1,0,0,7452,15060
26,Treviso,55,1163,5369,429,48,2,0,0,7011,884,5402,557,219,1,0,0,7063,14074
26,Treviso,56,999,5265,457,65,3,0,0,6789,783,5149,509,273,0,0,0,6714,13503
26,Treviso,57,1024,5115,422,77,1,0,0,6639,722,5118,506,295,1,0,0,6642,13281
26,Treviso,58,847,4938,390,97,5,0,0,6277,628,4909,466,308,1,0,0,6312,12589
26,Treviso,59,796,4869,373,98,1,0,0,6137,602,4989,397,373,0,0,0,6361,12498
26,Treviso,60,732,4579,327,90,0,0,0,5728,501,4742,377,355,1,0,0,5976,11704
26,Treviso,61,652,4518,311,91,4,0,0,5576,482,4381,366,410,2,0,0,5641,11217
26,Treviso,62,618,4433,274,102,3,0,0,5430,441,4288,365,469,1,0,0,5564,10994
26,Treviso,63,527,4365,287,133,1,0,0,5313,415,4300,326,508,1,0,0,5550,10863
26,Treviso,64,534,4263,245,157,1,0,0,5200,394,4139,310,555,1,0,0,5399,10599
26,Treviso,65,458,4161,242,147,1,0,0,5009,350,4056,292,591,1,0,1,5291,10300
26,Treviso,66,454,3948,198,166,1,0,0,4767,344,3853,234,660,0,0,0,5091,9858
26,Treviso,67,426,3949,203,165,1,0,0,4744,288,3726,239,705,0,0,0,4958,9702
26,Treviso,68,445,4078,175,195,2,0,0,4895,291,3854,234,789,1,0,0,5169,10064
26,Treviso,69,377,4023,169,198,0,0,0,4767,288,3606,215,836,0,0,0,4945,9712
26,Treviso,70,397,4032,170,243,2,0,0,4844,259,3717,203,934,0,0,0,5113,9957
26,Treviso,71,343,3865,144,268,3,0,0,4623,284,3551,203,1099,0,0,0,5137,9760
26,Treviso,72,383,4215,146,268,2,0,0,5014,287,3827,165,1308,0,0,0,5587,10601
26,Treviso,73,245,2820,101,221,0,0,0,3387,204,2573,122,1020,0,0,0,3919,7306
26,Treviso,74,269,3271,102,273,2,0,0,3917,225,2723,121,1342,0,0,0,4411,8328
26,Treviso,75,284,3182,92,297,3,0,0,3858,222,2687,119,1449,0,0,0,4477,8335
26,Treviso,76,241,2913,74,305,1,0,0,3534,223,2413,96,1506,0,0,0,4238,7772
26,Treviso,77,273,2847,69,337,0,0,0,3526,224,2220,93,1666,0,0,0,4203,7729
26,Treviso,78,243,2956,59,376,0,0,0,3634,232,2238,97,1863,0,0,0,4430,8064
26,Treviso,79,245,2844,64,394,0,0,0,3547,239,1986,69,1974,0,0,0,4268,7815
26,Treviso,80,216,2522,48,397,1,0,0,3184,208,1698,69,2027,0,0,0,4002,7186
26,Treviso,81,155,2156,34,376,0,0,0,2721,214,1350,58,2053,0,0,0,3675,6396
26,Treviso,82,159,1902,34,319,0,0,0,2414,227,1070,40,1978,0,0,0,3315,5729
26,Treviso,83,145,1743,28,358,0,0,0,2274,225,926,48,2083,0,0,0,3282,5556
26,Treviso,84,129,1535,24,335,0,0,0,2023,198,766,31,2036,0,0,0,3031,5054
26,Treviso,85,107,1150,21,327,0,0,0,1605,188,570,36,1885,0,0,0,2679,4284
26,Treviso,86,94,997,16,319,0,0,0,1426,211,460,30,1921,0,0,0,2622,4048
26,Treviso,87,76,873,10,307,0,0,0,1266,169,376,20,1861,0,0,0,2426,3692
26,Treviso,88,69,758,14,296,0,0,0,1137,169,287,22,1912,0,0,0,2390,3527
26,Treviso,89,59,600,6,269,0,0,0,934,150,194,20,1556,0,0,0,1920,2854
26,Treviso,90,43,441,3,188,0,0,0,675,141,137,12,1546,0,0,0,1836,2511
26,Treviso,91,32,326,6,212,0,0,0,576,136,118,11,1321,0,0,0,1586,2162
26,Treviso,92,22,224,5,173,0,0,0,424,107,62,12,1129,0,0,0,1310,1734
26,Treviso,93,24,158,2,121,0,0,0,305,89,50,4,968,0,0,0,1111,1416
26,Treviso,94,17,117,3,126,0,0,0,263,94,29,3,717,0,0,0,843,1106
26,Treviso,95,6,91,3,100,0,0,0,200,59,23,3,598,0,0,0,683,883
26,Treviso,96,9,40,1,62,0,0,0,112,48,12,1,432,0,0,0,493,605
26,Treviso,97,5,23,0,53,0,0,0,81,35,5,3,314,0,0,0,357,438
26,Treviso,98,1,13,2,37,0,0,0,53,17,2,1,207,0,0,0,227,280
26,Treviso,99,1,6,0,13,0,0,0,20,11,0,2,92,0,0,0,105,125
26,Treviso,100,0,3,0,17,0,0,0,20,19,3,2,119,0,0,0,143,163
27,Venezia,0,2901,0,0,0,0,0,0,2901,2764,0,0,0,0,0,0,2764,5665
27,Venezia,1,3052,0,0,0,0,0,0,3052,2868,0,0,0,0,0,0,2868,5920
27,Venezia,2,3186,0,0,0,0,0,0,3186,3001,0,0,0,0,0,0,3001,6187
27,Venezia,3,3239,0,0,0,0,0,0,3239,3051,0,0,0,0,0,0,3051,6290
27,Venezia,4,3278,0,0,0,0,0,0,3278,3087,0,0,0,0,0,0,3087,6365
27,Venezia,5,3517,0,0,0,0,0,0,3517,3192,0,0,0,0,0,0,3192,6709
27,Venezia,6,3733,0,0,0,0,0,0,3733,3457,0,0,0,0,0,0,3457,7190
27,Venezia,7,3800,0,0,0,0,0,0,3800,3661,0,0,0,0,0,0,3661,7461
27,Venezia,8,3830,0,0,0,0,0,0,3830,3613,0,0,0,0,0,0,3613,7443
27,Venezia,9,3938,0,0,0,0,0,0,3938,3646,0,0,0,0,0,0,3646,7584
27,Venezia,10,4083,0,0,0,0,0,0,4083,3775,0,0,0,0,0,0,3775,7858
27,Venezia,11,3999,0,0,0,0,0,0,3999,3809,0,0,0,0,0,0,3809,7808
27,Venezia,12,3967,0,0,0,0,0,0,3967,3717,0,0,0,0,0,0,3717,7684
27,Venezia,13,3956,0,0,0,0,0,0,3956,3637,0,0,0,0,0,0,3637,7593
27,Venezia,14,4018,0,0,0,0,0,0,4018,3853,0,0,0,0,0,0,3853,7871
27,Venezia,15,4106,0,0,0,0,0,0,4106,3719,0,0,0,0,0,0,3719,7825
27,Venezia,16,3923,0,0,0,0,0,0,3923,3604,0,0,0,0,0,0,3604,7527
27,Venezia,17,4001,0,0,0,0,0,0,4001,3622,0,0,0,0,0,0,3622,7623
27,Venezia,18,4151,0,0,0,0,0,0,4151,3726,8,0,0,0,0,0,3734,7885
27,Venezia,19,4049,1,0,0,0,0,0,4050,3721,19,0,0,0,0,0,3740,7790
27,Venezia,20,4181,2,1,0,0,0,0,4184,3789,45,1,0,0,0,0,3835,8019
27,Venezia,21,4103,8,0,0,0,0,0,4111,3744,88,1,0,1,0,0,3834,7945
27,Venezia,22,3978,27,0,0,0,0,0,4005,3510,145,1,0,3,0,0,3659,7664
27,Venezia,23,4052,60,0,0,0,0,0,4112,3314,204,2,0,2,0,0,3522,7634
27,Venezia,24,3884,62,0,0,0,0,0,3946,3356,327,2,0,0,0,0,3685,7631
27,Venezia,25,3759,129,0,0,2,0,0,3890,3441,394,3,1,0,0,0,3839,7729
27,Venezia,26,3868,209,2,0,0,0,0,4079,3316,569,8,1,2,0,0,3896,7975
27,Venezia,27,3873,284,6,0,1,0,0,4164,3165,779,12,1,2,0,0,3959,8123
27,Venezia,28,3813,446,4,0,2,0,0,4265,3084,982,14,2,2,0,0,4084,8349
27,Venezia,29,3387,560,7,0,0,0,0,3954,2815,1227,26,4,3,0,0,4075,8029
27,Venezia,30,3444,839,13,0,0,0,0,4296,2645,1459,29,1,4,0,0,4138,8434
27,Venezia,31,3127,1006,20,1,4,0,0,4158,2415,1601,43,3,3,0,0,4065,8223
27,Venezia,32,2965,1154,14,2,4,0,0,4139,2295,1876,48,3,5,0,0,4227,8366
27,Venezia,33,2971,1357,31,0,2,0,0,4361,2193,2134,78,5,1,0,0,4411,8772
27,Venezia,34,2762,1548,40,1,2,0,0,4353,1991,2256,72,9,2,0,0,4330,8683
27,Venezia,35,2639,1801,39,3,1,0,0,4483,1903,2404,107,8,1,0,0,4423,8906
27,Venezia,36,2541,2010,49,1,2,0,0,4603,1905,2625,125,21,1,0,0,4677,9280
27,Venezia,37,2485,2216,80,9,4,0,0,4794,1731,2784,129,16,4,0,0,4664,9458
27,Venezia,38,2396,2417,79,3,5,0,0,4900,1679,2895,169,26,3,0,0,4772,9672
27,Venezia,39,2472,2714,105,5,4,0,0,5300,1707,3211,196,24,3,0,0,5141,10441
27,Venezia,40,2659,2888,131,4,8,0,0,5690,1813,3333,241,30,2,0,0,5419,11109
27,Venezia,41,2492,3058,129,10,8,0,0,5697,1878,3699,245,41,2,0,0,5865,11562
27,Venezia,42,2669,3346,182,4,1,0,0,6202,1766,3981,322,35,2,0,0,6106,12308
27,Venezia,43,2587,3722,190,8,6,0,0,6513,1804,4262,347,43,5,0,0,6461,12974
27,Venezia,44,2667,3945,245,14,7,0,0,6878,1961,4546,377,49,3,0,0,6936,13814
27,Venezia,45,2490,4103,287,17,3,0,0,6900,1774,4719,377,59,4,0,0,6933,13833
27,Venezia,46,2458,4315,316,21,4,0,0,7114,1696,4836,427,81,4,0,0,7044,14158
27,Venezia,47,2334,4424,310,20,3,0,0,7091,1523,4973,482,93,4,0,0,7075,14166
27,Venezia,48,2080,4567,348,24,7,0,0,7026,1467,5176,462,97,1,0,0,7203,14229
27,Venezia,49,1999,4946,440,28,5,0,0,7418,1386,5235,499,129,2,0,0,7251,14669
27,Venezia,50,1869,4864,372,30,4,0,0,7139,1289,5327,550,182,0,0,0,7348,14487
27,Venezia,51,1749,5077,396,36,1,0,0,7259,1270,5372,595,148,3,0,0,7388,14647
27,Venezia,52,1610,5193,432,51,4,0,0,7290,1201,5508,568,186,4,0,0,7467,14757
27,Venezia,53,1560,5272,462,47,5,0,0,7346,1136,5544,597,197,4,0,0,7478,14824
27,Venezia,54,1381,5505,490,55,3,0,0,7434,1012,5865,609,268,1,0,0,7755,15189
27,Venezia,55,1253,5091,477,55,5,0,0,6881,894,5547,621,242,1,0,0,7305,14186
27,Venezia,56,1117,5097,455,82,4,0,0,6755,847,5446,541,295,0,0,0,7129,13884
27,Venezia,57,1021,5030,421,106,2,0,0,6580,755,5358,577,309,0,0,0,6999,13579
27,Venezia,58,865,4901,377,83,8,0,0,6234,639,5062,508,361,0,0,0,6570,12804
27,Venezia,59,797,4886,393,90,5,0,0,6171,631,5002,501,416,0,0,0,6550,12721
27,Venezia,60,715,4517,350,95,5,0,0,5682,539,4801,427,446,0,0,0,6213,11895
27,Venezia,61,682,4412,362,99,6,0,0,5561,558,4693,381,509,2,0,0,6143,11704
27,Venezia,62,595,4423,281,114,5,0,0,5418,519,4497,340,556,1,0,0,5913,11331
27,Venezia,63,547,4203,245,117,4,0,0,5116,442,4285,400,559,2,0,0,5688,10804
27,Venezia,64,492,4168,272,149,2,0,0,5083,404,4283,327,626,1,0,0,5641,10724
27,Venezia,65,437,4181,252,164,3,0,0,5037,363,3976,315,646,1,0,0,5301,10338
27,Venezia,66,407,4085,225,199,0,0,0,4916,356,3964,280,764,0,0,0,5364,10280
27,Venezia,67,378,3910,196,183,7,0,1,4675,313,3935,251,754,2,0,0,5255,9930
27,Venezia,68,407,4028,169,185,3,0,0,4792,318,3981,276,931,0,0,0,5506,10298
27,Venezia,69,364,4183,209,270,1,0,0,5027,305,3922,254,1025,1,0,0,5507,10534
27,Venezia,70,381,4205,193,258,4,0,0,5041,295,3957,208,1194,0,0,0,5654,10695
27,Venezia,71,337,4252,154,294,0,0,0,5037,293,3759,242,1350,0,0,0,5644,10681
27,Venezia,72,368,4489,168,342,2,0,0,5369,304,3934,199,1544,0,0,0,5981,11350
27,Venezia,73,219,2926,102,253,1,0,0,3501,211,2633,160,1167,0,0,0,4171,7672
27,Venezia,74,309,3515,111,326,0,0,0,4261,249,2993,127,1517,0,0,0,4886,9147
27,Venezia,75,266,3346,90,391,2,0,0,4095,268,2846,134,1628,0,0,0,4876,8971
27,Venezia,76,301,3200,88,387,2,0,0,3978,254,2635,136,1799,0,0,0,4824,8802
27,Venezia,77,279,3145,75,407,1,0,0,3907,264,2388,122,1896,0,0,0,4670,8577
27,Venezia,78,228,3241,74,420,0,0,0,3963,274,2508,115,2146,0,0,0,5043,9006
27,Venezia,79,263,2922,60,445,0,0,0,3690,244,2112,110,2209,0,0,0,4675,8365
27,Venezia,80,206,2605,60,480,0,0,0,3351,244,1900,87,2382,0,0,0,4613,7964
27,Venezia,81,181,2314,44,435,1,0,0,2975,221,1495,73,2350,0,0,0,4139,7114
27,Venezia,82,158,1932,27,412,1,0,0,2530,238,1236,65,2298,0,0,0,3837,6367
27,Venezia,83,115,1939,32,437,0,0,0,2523,210,1032,62,2299,0,0,0,3603,6126
27,Venezia,84,129,1628,29,435,0,0,0,2221,184,868,44,2315,0,0,0,3411,5632
27,Venezia,85,109,1303,26,387,0,0,0,1825,155,612,47,2184,0,0,0,2998,4823
27,Venezia,86,74,1149,12,403,0,0,0,1638,172,528,25,2112,0,0,0,2837,4475
27,Venezia,87,71,947,9,363,0,0,0,1390,185,403,21,1967,0,0,0,2576,3966
27,Venezia,88,69,805,5,345,0,0,0,1224,178,305,29,2025,0,0,0,2537,3761
27,Venezia,89,55,562,6,275,0,0,0,898,153,203,19,1628,0,0,0,2003,2901
27,Venezia,90,40,450,7,290,0,0,0,787,143,147,16,1549,0,0,0,1855,2642
27,Venezia,91,28,337,4,245,0,0,0,614,137,101,12,1387,0,0,0,1637,2251
27,Venezia,92,25,248,3,170,0,0,0,446,96,68,12,1124,0,0,0,1300,1746
27,Venezia,93,17,164,2,161,0,0,0,344,92,44,12,896,0,0,0,1044,1388
27,Venezia,94,14,106,2,122,0,0,0,244,73,24,11,697,0,0,0,805,1049
27,Venezia,95,6,81,2,112,0,0,0,201,56,20,6,610,0,0,0,692,893
27,Venezia,96,2,36,0,84,0,0,0,122,40,9,1,422,0,0,0,472,594
27,Venezia,97,6,25,0,38,0,0,0,69,29,1,2,327,0,0,0,359,428
27,Venezia,98,1,12,0,33,0,0,0,46,23,4,2,195,0,0,0,224,270
27,Venezia,99,1,2,0,14,0,0,0,17,8,0,0,108,0,0,0,116,133
27,Venezia,100,2,5,0,21,0,0,0,28,18,0,1,153,0,0,0,172,200
28,Padova,0,3398,0,0,0,0,0,0,3398,3322,0,0,0,0,0,0,3322,6720
28,Padova,1,3549,0,0,0,0,0,0,3549,3436,0,0,0,0,0,0,3436,6985
28,Padova,2,3815,0,0,0,0,0,0,3815,3502,0,0,0,0,0,0,3502,7317
28,Padova,3,3811,0,0,0,0,0,0,3811,3686,0,0,0,0,0,0,3686,7497
28,Padova,4,3996,0,0,0,0,0,0,3996,3858,0,0,0,0,0,0,3858,7854
28,Padova,5,4307,0,0,0,0,0,0,4307,3947,0,0,0,0,0,0,3947,8254
28,Padova,6,4373,0,0,0,0,0,0,4373,4122,0,0,0,0,0,0,4122,8495
28,Padova,7,4377,0,0,0,0,0,0,4377,4163,0,0,0,0,0,0,4163,8540
28,Padova,8,4492,0,0,0,0,0,0,4492,4305,0,0,0,0,0,0,4305,8797
28,Padova,9,4599,0,0,0,0,0,0,4599,4406,0,0,0,0,0,0,4406,9005
28,Padova,10,4697,0,0,0,0,0,0,4697,4366,0,0,0,0,0,0,4366,9063
28,Padova,11,4556,0,0,0,0,0,0,4556,4397,0,0,0,0,0,0,4397,8953
28,Padova,12,4647,0,0,0,0,0,0,4647,4378,0,0,0,0,0,0,4378,9025
28,Padova,13,4552,0,0,0,0,0,0,4552,4172,0,0,0,0,0,0,4172,8724
28,Padova,14,4590,0,0,0,0,0,0,4590,4304,0,0,0,0,0,0,4304,8894
28,Padova,15,4583,0,0,0,0,0,0,4583,4235,0,0,0,0,0,0,4235,8818
28,Padova,16,4375,0,0,0,0,0,0,4375,4064,0,0,0,0,0,0,4064,8439
28,Padova,17,4412,0,0,0,0,0,0,4412,4229,0,0,0,0,0,0,4229,8641
28,Padova,18,4582,0,0,0,0,0,0,4582,4320,5,0,0,0,0,0,4325,8907
28,Padova,19,4652,1,0,0,0,0,0,4653,4260,26,0,0,0,0,0,4286,8939
28,Padova,20,4690,4,0,0,0,0,0,4694,4198,48,0,0,0,0,0,4246,8940
28,Padova,21,4582,8,0,0,0,0,0,4590,4160,96,0,0,0,0,0,4256,8846
28,Padova,22,4607,17,0,0,0,0,0,4624,4151,104,2,0,0,0,0,4257,8881
28,Padova,23,4570,37,0,0,1,0,0,4608,4041,190,3,1,0,0,0,4235,8843
28,Padova,24,4500,75,2,0,0,0,0,4577,3931,273,1,1,1,0,0,4207,8784
28,Padova,25,4512,105,0,0,0,0,0,4617,3979,406,3,1,0,0,0,4389,9006
28,Padova,26,4629,200,2,1,1,0,0,4833,4088,581,5,3,0,0,0,4677,9510
28,Padova,27,4608,247,3,0,0,0,0,4858,3826,794,9,1,0,0,0,4630,9488
28,Padova,28,4408,457,1,0,2,0,0,4868,3665,1061,8,5,1,0,0,4740,9608
28,Padova,29,4281,603,7,1,0,0,0,4892,3472,1335,24,2,2,0,0,4835,9727
28,Padova,30,4032,847,11,1,1,0,0,4892,3287,1703,37,3,2,0,0,5032,9924
28,Padova,31,3778,1089,14,1,4,0,0,4886,2785,1903,36,0,2,0,0,4726,9612
28,Padova,32,3511,1318,16,2,6,0,0,4853,2648,2185,48,5,4,0,0,4890,9743
28,Padova,33,3497,1595,30,1,2,0,0,5125,2655,2525,70,3,3,0,0,5256,10381
28,Padova,34,3271,1842,30,0,3,0,0,5146,2506,2710,85,4,2,0,0,5307,10453
28,Padova,35,3187,2120,58,0,7,0,0,5372,2285,2855,104,14,3,0,0,5261,10633
28,Padova,36,2973,2334,48,1,3,0,0,5359,2260,3156,138,16,2,0,0,5572,10931
28,Padova,37,2888,2478,74,4,3,0,0,5447,2107,3318,136,21,6,0,0,5588,11035
28,Padova,38,2977,2835,98,2,1,0,0,5913,2042,3606,191,19,6,0,0,5864,11777
28,Padova,39,2899,3062,123,7,5,0,0,6096,2077,3770,195,18,2,0,0,6062,12158
28,Padova,40,2963,3241,147,9,4,0,1,6365,2087,4040,244,24,2,0,0,6397,12762
28,Padova,41,2874,3508,149,6,2,0,0,6539,2064,4344,297,35,2,0,0,6742,13281
28,Padova,42,2978,3920,181,3,1,0,0,7083,1967,4641,325,38,3,0,0,6974,14057
28,Padova,43,2995,4161,244,8,3,0,0,7411,1970,4702,381,56,2,0,0,7111,14522
28,Padova,44,2792,4529,250,12,5,0,0,7588,2040,5190,401,68,2,0,0,7701,15289
28,Padova,45,2752,4689,284,10,2,0,0,7737,1873,5268,411,66,1,0,0,7619,15356
28,Padova,46,2676,4770,327,27,3,0,0,7803,1777,5273,493,73,2,0,0,7618,15421
28,Padova,47,2438,5002,369,21,4,1,0,7835,1812,5445,458,105,4,1,0,7825,15660
28,Padova,48,2363,5188,356,19,4,0,0,7930,1680,5588,572,89,3,0,0,7932,15862
28,Padova,49,2220,5473,401,33,6,0,0,8133,1523,5847,560,125,2,0,0,8057,16190
28,Padova,50,1971,5610,414,28,7,0,0,8030,1490,5907,579,142,1,0,0,8119,16149
28,Padova,51,2010,5525,456,34,8,0,1,8034,1412,5908,617,134,2,0,0,8073,16107
28,Padova,52,1855,5630,488,45,6,0,0,8024,1319,6044,589,159,3,0,0,8114,16138
28,Padova,53,1684,5852,511,63,7,0,0,8117,1290,6091,604,204,3,0,0,8192,16309
28,Padova,54,1564,5909,511,58,3,0,0,8045,1234,6223,688,263,2,0,0,8410,16455
28,Padova,55,1343,5837,496,56,5,0,0,7737,1056,5848,560,224,2,0,0,7690,15427
28,Padova,56,1196,5640,454,76,8,0,0,7374,1012,5740,508,285,1,0,0,7546,14920
28,Padova,57,1159,5375,445,81,4,0,0,7064,910,5544,581,305,0,0,0,7340,14404
28,Padova,58,960,5161,360,67,3,0,0,6551,829,5270,497,331,1,0,0,6928,13479
28,Padova,59,913,5224,383,88,2,0,0,6610,809,5221,473,366,1,0,0,6870,13480
28,Padova,60,822,4991,368,76,2,0,0,6259,722,4895,422,440,1,0,0,6480,12739
28,Padova,61,754,4924,340,111,2,0,0,6131,656,4703,419,454,1,0,0,6233,12364
28,Padova,62,691,4761,321,115,0,0,0,5888,633,4842,409,489,0,0,0,6373,12261
28,Padova,63,589,4438,277,121,2,1,0,5428,592,4439,329,550,0,0,0,5910,11338
28,Padova,64,611,4505,274,145,8,0,0,5543,494,4345,332,571,0,0,0,5742,11285
28,Padova,65,522,4274,212,150,3,0,0,5161,429,4240,332,605,0,0,0,5606,10767
28,Padova,66,503,4195,230,153,5,0,0,5086,401,4248,267,703,0,0,0,5619,10705
28,Padova,67,469,4239,226,181,4,0,0,5119,400,3951,278,798,1,0,0,5428,10547
28,Padova,68,449,4267,186,183,2,0,0,5087,381,4241,247,879,0,0,0,5748,10835
28,Padova,69,405,4329,194,196,5,0,0,5129,409,3930,197,993,0,0,0,5529,10658
28,Padova,70,417,4244,160,249,1,0,0,5071,379,3960,239,1089,0,0,0,5667,10738
28,Padova,71,368,4128,162,255,3,0,0,4916,347,3640,199,1208,0,0,0,5394,10310
28,Padova,72,387,4335,153,303,1,0,0,5179,337,3859,196,1374,0,0,0,5766,10945
28,Padova,73,260,3047,104,243,0,0,0,3654,283,2747,159,1102,0,0,0,4291,7945
28,Padova,74,291,3470,102,268,1,0,0,4132,296,2885,129,1358,0,0,0,4668,8800
28,Padova,75,312,3420,70,341,0,0,0,4143,306,2851,134,1569,0,0,0,4860,9003
28,Padova,76,286,3206,78,344,2,0,1,3917,337,2580,141,1596,0,0,0,4654,8571
28,Padova,77,278,3015,58,353,2,0,0,3706,297,2383,102,1831,0,0,0,4613,8319
28,Padova,78,290,3108,78,409,0,0,0,3885,286,2389,109,2079,0,0,0,4863,8748
28,Padova,79,254,2992,61,402,1,0,0,3710,310,2115,85,2093,0,0,0,4603,8313
28,Padova,80,220,2693,39,403,0,0,0,3355,328,1806,87,2301,0,0,0,4522,7877
28,Padova,81,192,2277,41,380,1,0,0,2891,268,1479,66,2182,0,0,0,3995,6886
28,Padova,82,193,1957,43,382,1,0,0,2576,278,1186,58,2242,0,0,0,3764,6340
28,Padova,83,150,1924,15,440,0,0,0,2529,248,1139,37,2411,0,0,0,3835,6364
28,Padova,84,127,1706,11,378,1,0,0,2223,257,870,45,2350,0,0,0,3522,5745
28,Padova,85,126,1372,21,383,0,0,0,1902,245,637,27,2162,0,0,0,3071,4973
28,Padova,86,115,1139,12,366,0,0,0,1632,204,544,32,2096,0,0,0,2876,4508
28,Padova,87,71,905,10,362,0,0,0,1348,213,385,21,2009,0,0,0,2628,3976
28,Padova,88,81,834,5,330,0,0,0,1250,216,306,21,2012,0,0,0,2555,3805
28,Padova,89,58,593,6,299,0,0,0,956,175,201,17,1690,0,0,0,2083,3039
28,Padova,90,43,479,5,256,0,0,0,783,163,146,13,1639,0,0,0,1961,2744
28,Padova,91,35,389,5,219,0,0,0,648,168,106,14,1391,0,0,0,1679,2327
28,Padova,92,33,242,4,175,0,0,0,454,113,59,15,1146,0,0,0,1333,1787
28,Padova,93,24,178,2,151,0,0,0,355,102,39,8,957,0,0,0,1106,1461
28,Padova,94,10,112,0,144,0,0,0,266,71,28,1,702,0,0,0,802,1068
28,Padova,95,11,73,0,111,0,0,0,195,73,17,5,547,0,0,0,642,837
28,Padova,96,8,42,0,70,0,0,0,120,44,17,5,394,0,0,0,460,580
28,Padova,97,4,18,1,42,0,0,0,65,40,4,0,279,0,0,0,323,388
28,Padova,98,3,11,0,26,0,0,0,40,22,3,1,206,0,0,0,232,272
28,Padova,99,2,7,0,14,0,0,0,23,16,0,1,92,0,0,0,109,132
28,Padova,100,1,8,0,16,0,0,0,25,21,2,2,143,0,0,0,168,193
29,Rovigo,0,691,0,0,0,0,0,0,691,637,0,0,0,0,0,0,637,1328
29,Rovigo,1,806,0,0,0,0,0,0,806,708,0,0,0,0,0,0,708,1514
29,Rovigo,2,705,0,0,0,0,0,0,705,773,0,0,0,0,0,0,773,1478
29,Rovigo,3,774,0,0,0,0,0,0,774,798,0,0,0,0,0,0,798,1572
29,Rovigo,4,799,0,0,0,0,0,0,799,792,0,0,0,0,0,0,792,1591
29,Rovigo,5,879,0,0,0,0,0,0,879,803,0,0,0,0,0,0,803,1682
29,Rovigo,6,976,0,0,0,0,0,0,976,867,0,0,0,0,0,0,867,1843
29,Rovigo,7,904,0,0,0,0,0,0,904,887,0,0,0,0,0,0,887,1791
29,Rovigo,8,1019,0,0,0,0,0,0,1019,921,0,0,0,0,0,0,921,1940
29,Rovigo,9,1001,0,0,0,0,0,0,1001,938,0,0,0,0,0,0,938,1939
29,Rovigo,10,1038,0,0,0,0,0,0,1038,926,0,0,0,0,0,0,926,1964
29,Rovigo,11,949,0,0,0,0,0,0,949,918,0,0,0,0,0,0,918,1867
29,Rovigo,12,953,0,0,0,0,0,0,953,857,0,0,0,0,0,0,857,1810
29,Rovigo,13,968,0,0,0,0,0,0,968,898,0,0,0,0,0,0,898,1866
29,Rovigo,14,945,0,0,0,0,0,0,945,905,0,0,0,0,0,0,905,1850
29,Rovigo,15,915,0,0,0,0,0,0,915,884,0,0,0,0,0,0,884,1799
29,Rovigo,16,913,0,0,0,0,0,0,913,856,0,0,0,0,0,0,856,1769
29,Rovigo,17,954,0,0,0,0,0,0,954,842,0,0,0,0,0,0,842,1796
29,Rovigo,18,986,0,0,0,0,0,0,986,932,3,0,0,0,0,0,935,1921
29,Rovigo,19,948,0,0,0,0,0,0,948,890,8,0,0,0,0,0,898,1846
29,Rovigo,20,985,0,0,0,0,0,0,985,945,11,0,0,0,0,0,956,1941
29,Rovigo,21,1024,1,0,0,0,0,0,1025,959,19,0,0,0,0,0,978,2003
29,Rovigo,22,1028,4,0,0,0,0,0,1032,930,22,0,0,0,0,0,952,1984
29,Rovigo,23,1007,3,0,0,0,0,0,1010,865,24,1,1,0,0,0,891,1901
29,Rovigo,24,1024,10,0,0,0,0,0,1034,865,65,1,0,0,0,0,931,1965
29,Rovigo,25,946,29,0,0,0,0,0,975,858,61,3,0,0,0,0,922,1897
29,Rovigo,26,1056,28,1,0,1,0,0,1086,903,104,1,0,0,0,0,1008,2094
29,Rovigo,27,1020,47,0,0,0,0,0,1067,933,173,1,0,0,0,0,1107,2174
29,Rovigo,28,1072,72,1,0,0,0,0,1145,916,215,4,0,0,0,0,1135,2280
29,Rovigo,29,1020,101,0,0,0,0,0,1121,840,235,8,0,0,0,0,1083,2204
29,Rovigo,30,1006,146,1,0,1,0,0,1154,829,326,10,1,0,0,0,1166,2320
29,Rovigo,31,975,189,2,0,0,0,0,1166,692,394,7,1,0,0,0,1094,2260
29,Rovigo,32,906,242,4,0,0,0,0,1152,701,397,10,1,1,0,0,1110,2262
29,Rovigo,33,953,250,6,0,0,0,0,1209,719,482,17,4,0,0,0,1222,2431
29,Rovigo,34,850,354,4,0,0,0,0,1208,631,559,23,1,0,0,0,1214,2422
29,Rovigo,35,889,408,6,0,0,0,0,1303,570,565,21,2,0,0,0,1158,2461
29,Rovigo,36,777,469,21,0,1,0,0,1268,583,707,26,3,0,0,0,1319,2587
29,Rovigo,37,788,488,28,1,0,0,0,1305,598,764,52,9,0,0,0,1423,2728
29,Rovigo,38,821,539,22,0,1,0,0,1383,574,795,58,5,1,0,0,1433,2816
29,Rovigo,39,785,639,29,0,1,0,0,1454,548,845,57,7,0,0,0,1457,2911
29,Rovigo,40,849,766,31,1,0,0,0,1647,637,962,69,12,0,0,0,1680,3327
29,Rovigo,41,836,834,46,1,0,0,0,1717,546,980,89,16,1,0,0,1632,3349
29,Rovigo,42,846,913,49,5,0,0,0,1813,534,1056,73,10,0,0,0,1673,3486
29,Rovigo,43,824,931,79,2,1,0,0,1837,499,1132,111,14,0,0,0,1756,3593
29,Rovigo,44,788,1061,78,1,0,0,0,1928,516,1229,112,17,1,0,0,1875,3803
29,Rovigo,45,719,1041,80,3,1,0,0,1844,484,1286,114,18,1,0,0,1903,3747
29,Rovigo,46,712,1096,87,3,0,0,0,1898,437,1225,129,26,0,0,0,1817,3715
29,Rovigo,47,643,1157,105,4,1,0,0,1910,373,1317,122,15,0,0,0,1827,3737
29,Rovigo,48,621,1151,108,9,1,0,0,1890,322,1350,135,26,0,0,0,1833,3723
29,Rovigo,49,572,1223,128,2,0,0,0,1925,348,1365,139,39,0,0,0,1891,3816
29,Rovigo,50,516,1324,112,8,2,0,0,1962,283,1423,141,37,1,0,0,1885,3847
29,Rovigo,51,477,1340,108,16,1,0,0,1942,313,1453,127,44,1,0,0,1938,3880
29,Rovigo,52,433,1441,114,11,1,0,0,2000,303,1494,151,53,0,0,0,2001,4001
29,Rovigo,53,426,1409,123,17,0,0,0,1975,276,1475,146,64,0,0,0,1961,3936
29,Rovigo,54,392,1463,143,19,0,0,0,2017,283,1585,149,65,0,0,0,2082,4099
29,Rovigo,55,372,1434,123,23,0,0,0,1952,232,1588,132,80,0,0,0,2032,3984
29,Rovigo,56,332,1440,113,26,1,0,0,1912,226,1544,138,98,0,0,0,2006,3918
29,Rovigo,57,328,1473,129,22,0,0,0,1952,204,1565,144,107,0,0,0,2020,3972
29,Rovigo,58,310,1401,98,16,1,0,0,1826,151,1493,123,98,1,0,0,1866,3692
29,Rovigo,59,276,1467,117,33,0,0,0,1893,157,1539,98,119,1,0,0,1914,3807
29,Rovigo,60,221,1453,89,28,0,0,0,1791,147,1399,104,144,0,0,0,1794,3585
29,Rovigo,61,202,1430,83,34,1,0,0,1750,132,1464,112,157,0,0,0,1865,3615
29,Rovigo,62,208,1438,101,32,1,0,0,1780,153,1448,90,191,0,0,0,1882,3662
29,Rovigo,63,180,1371,78,41,0,0,0,1670,140,1422,73,178,0,0,0,1813,3483
29,Rovigo,64,157,1333,78,48,0,0,0,1616,111,1317,76,239,0,0,0,1743,3359
29,Rovigo,65,136,1391,51,53,1,0,0,1632,113,1330,67,244,0,0,0,1754,3386
29,Rovigo,66,136,1354,64,61,0,0,0,1615,101,1275,69,213,0,0,0,1658,3273
29,Rovigo,67,136,1293,56,69,0,0,0,1554,100,1107,52,235,0,0,0,1494,3048
29,Rovigo,68,162,1344,66,70,0,0,0,1642,94,1205,47,288,0,0,0,1634,3276
29,Rovigo,69,137,1280,42,81,0,0,1,1541,97,1207,39,293,0,0,0,1636,3177
29,Rovigo,70,125,1367,38,89,1,0,0,1620,96,1165,50,371,0,0,0,1682,3302
29,Rovigo,71,128,1248,43,97,0,0,0,1516,96,1080,51,346,0,0,0,1573,3089
29,Rovigo,72,106,1280,24,97,0,1,0,1508,79,1059,37,421,0,0,0,1596,3104
29,Rovigo,73,67,782,27,64,0,0,0,940,39,611,27,324,0,0,0,1001,1941
29,Rovigo,74,87,927,34,71,0,0,0,1119,69,788,23,444,0,0,0,1324,2443
29,Rovigo,75,81,878,20,93,0,0,0,1072,62,700,22,423,0,0,0,1207,2279
29,Rovigo,76,65,778,15,97,0,0,0,955,81,681,19,509,0,0,0,1290,2245
29,Rovigo,77,89,858,30,88,0,0,0,1065,62,619,22,547,0,0,0,1250,2315
29,Rovigo,78,92,778,4,110,0,0,0,984,82,606,17,627,0,0,0,1332,2316
29,Rovigo,79,66,756,13,127,0,0,0,962,66,527,17,641,0,0,0,1251,2213
29,Rovigo,80,75,741,10,149,1,0,0,976,64,516,15,668,0,0,0,1263,2239
29,Rovigo,81,62,606,4,128,0,1,0,801,69,416,10,687,0,0,0,1182,1983
29,Rovigo,82,58,509,6,106,0,0,0,679,64,322,5,709,0,0,0,1100,1779
29,Rovigo,83,67,549,9,126,0,0,0,751,44,289,6,743,0,0,0,1082,1833
29,Rovigo,84,51,465,5,136,0,0,0,657,62,262,6,739,0,0,0,1069,1726
29,Rovigo,85,37,391,8,126,0,0,0,562,65,210,3,739,0,0,0,1017,1579
29,Rovigo,86,35,302,4,104,0,0,0,445,59,159,5,673,0,0,0,896,1341
29,Rovigo,87,30,278,4,108,0,0,0,420,70,119,3,710,0,0,0,902,1322
29,Rovigo,88,29,221,3,122,0,0,0,375,59,91,5,693,0,0,0,848,1223
29,Rovigo,89,23,154,0,104,0,0,0,281,56,55,6,547,0,0,0,664,945
29,Rovigo,90,13,131,1,73,0,0,0,218,60,45,0,496,0,0,0,601,819
29,Rovigo,91,15,78,4,88,0,0,0,185,42,29,3,466,0,0,0,540,725
29,Rovigo,92,6,62,0,64,0,0,0,132,27,22,2,373,0,0,0,424,556
29,Rovigo,93,10,54,2,60,0,0,0,126,34,15,1,280,0,0,0,330,456
29,Rovigo,94,5,28,0,35,0,0,0,68,27,15,1,204,0,0,0,247,315
29,Rovigo,95,6,13,0,29,0,0,0,48,17,5,3,180,0,0,0,205,253
29,Rovigo,96,3,9,1,21,0,0,0,34,19,2,1,136,0,0,0,158,192
29,Rovigo,97,1,5,0,13,0,0,0,19,13,3,0,93,0,0,0,109,128
29,Rovigo,98,1,6,0,7,0,0,0,14,9,0,0,62,0,0,0,71,85
29,Rovigo,99,0,2,0,5,0,0,0,7,6,0,0,17,0,0,0,23,30
29,Rovigo,100,0,1,0,2,0,0,0,3,9,0,0,46,0,0,0,55,58
30,Udine,0,1665,0,0,0,0,0,0,1665,1561,0,0,0,0,0,0,1561,3226
30,Udine,1,1731,0,0,0,0,0,0,1731,1663,0,0,0,0,0,0,1663,3394
30,Udine,2,1874,0,0,0,0,0,0,1874,1765,0,0,0,0,0,0,1765,3639
30,Udine,3,1823,0,0,0,0,0,0,1823,1827,0,0,0,0,0,0,1827,3650
30,Udine,4,2047,0,0,0,0,0,0,2047,1889,0,0,0,0,0,0,1889,3936
30,Udine,5,2090,0,0,0,0,0,0,2090,1979,0,0,0,0,0,0,1979,4069
30,Udine,6,2131,0,0,0,0,0,0,2131,2100,0,0,0,0,0,0,2100,4231
30,Udine,7,2130,0,0,0,0,0,0,2130,2072,0,0,0,0,0,0,2072,4202
30,Udine,8,2305,0,0,0,0,0,0,2305,2154,0,0,0,0,0,0,2154,4459
30,Udine,9,2274,0,0,0,0,0,0,2274,2285,0,0,0,0,0,0,2285,4559
30,Udine,10,2243,0,0,0,0,0,0,2243,2209,0,0,0,0,0,0,2209,4452
30,Udine,11,2296,0,0,0,0,0,0,2296,2248,0,0,0,0,0,0,2248,4544
30,Udine,12,2350,0,0,0,0,0,0,2350,2263,0,0,0,0,0,0,2263,4613
30,Udine,13,2371,0,0,0,0,0,0,2371,2220,0,0,0,0,0,0,2220,4591
30,Udine,14,2286,0,0,0,0,0,0,2286,2240,0,0,0,0,0,0,2240,4526
30,Udine,15,2445,0,0,0,0,0,0,2445,2199,0,0,0,0,0,0,2199,4644
30,Udine,16,2336,0,0,0,0,0,0,2336,2234,0,0,0,0,0,0,2234,4570
30,Udine,17,2341,0,0,0,0,0,0,2341,2211,0,0,0,0,0,0,2211,4552
30,Udine,18,2471,0,0,0,0,0,0,2471,2280,4,0,0,0,0,0,2284,4755
30,Udine,19,2403,0,0,0,0,0,0,2403,2143,14,0,0,0,0,0,2157,4560
30,Udine,20,2414,4,0,0,0,0,0,2418,2214,20,0,0,0,0,0,2234,4652
30,Udine,21,2364,7,0,0,0,0,0,2371,2134,40,0,0,0,0,0,2174,4545
30,Udine,22,2430,9,0,0,1,0,0,2440,2064,83,0,0,0,0,0,2147,4587
30,Udine,23,2342,24,0,0,2,0,0,2368,2082,129,0,0,0,0,0,2211,4579
30,Udine,24,2328,41,0,0,0,0,0,2369,1995,160,0,1,1,0,0,2157,4526
30,Udine,25,2297,57,0,0,0,0,0,2354,1903,224,5,1,0,0,0,2133,4487
30,Udine,26,2405,115,0,0,3,0,0,2523,2041,333,4,1,1,0,0,2380,4903
30,Udine,27,2272,174,2,0,1,0,0,2449,2000,385,8,1,1,0,0,2395,4844
30,Udine,28,2243,222,4,0,1,0,0,2470,1841,532,10,1,1,0,0,2385,4855
30,Udine,29,2163,350,2,1,1,0,0,2517,1736,698,22,0,1,0,0,2457,4974
30,Udine,30,2074,469,7,0,1,0,0,2551,1675,873,27,2,1,0,0,2578,5129
30,Udine,31,1875,546,10,0,1,0,0,2432,1437,1000,24,3,2,0,0,2466,4898
30,Udine,32,1894,655,14,1,0,0,0,2564,1439,1069,41,5,1,0,0,2555,5119
30,Udine,33,1883,812,19,0,0,0,0,2714,1356,1281,47,4,1,0,0,2689,5403
30,Udine,34,1890,940,24,0,0,0,0,2854,1385,1271,54,6,2,0,0,2718,5572
30,Udine,35,1708,1066,24,1,2,0,0,2801,1261,1420,69,4,4,0,0,2758,5559
30,Udine,36,1722,1198,35,3,2,0,0,2960,1159,1640,76,10,3,0,0,2888,5848
30,Udine,37,1656,1297,55,2,1,0,0,3011,1128,1636,98,8,5,0,0,2875,5886
30,Udine,38,1641,1404,68,1,1,0,0,3115,1141,1748,114,7,2,0,0,3012,6127
30,Udine,39,1622,1586,68,6,1,0,0,3283,1155,1839,113,19,2,0,0,3128,6411
30,Udine,40,1724,1656,87,2,1,0,1,3471,1209,1976,162,23,2,0,0,3372,6843
30,Udine,41,1651,1648,98,0,1,0,0,3398,1158,2141,203,9,0,0,0,3511,6909
30,Udine,42,1628,1833,105,4,2,0,0,3572,1170,2233,211,34,2,0,0,3650,7222
30,Udine,43,1712,2040,156,3,8,0,0,3919,1112,2446,258,42,2,0,0,3860,7779
30,Udine,44,1717,2264,176,6,3,0,1,4167,1193,2691,305,42,2,0,0,4233,8400
30,Udine,45,1614,2262,194,13,1,0,0,4084,1166,2658,302,47,5,0,0,4178,8262
30,Udine,46,1549,2446,202,4,2,0,0,4203,1012,2854,330,63,0,0,0,4259,8462
30,Udine,47,1489,2615,207,11,5,0,0,4327,967,2955,356,66,0,0,0,4344,8671
30,Udine,48,1403,2633,277,15,4,0,0,4332,955,3034,392,66,3,0,0,4450,8782
30,Udine,49,1379,2795,276,17,1,0,0,4468,916,3066,362,75,6,0,0,4425,8893
30,Udine,50,1273,2838,290,16,2,0,0,4419,817,3051,375,94,1,0,0,4338,8757
30,Udine,51,1199,2885,344,21,1,0,0,4450,794,3165,417,98,2,0,0,4476,8926
30,Udine,52,1101,3000,321,31,2,0,0,4455,805,3141,440,129,0,0,0,4515,8970
30,Udine,53,1149,3016,348,25,2,0,0,4540,757,3191,420,118,1,0,0,4487,9027
30,Udine,54,1076,3116,366,34,4,0,0,4596,723,3245,494,138,1,0,0,4601,9197
30,Udine,55,919,2913,346,31,6,0,0,4215,595,3309,459,192,2,0,0,4557,8772
30,Udine,56,862,2849,380,49,2,0,0,4142,533,3066,446,191,0,0,0,4236,8378
30,Udine,57,722,2874,354,45,0,0,0,3995,524,2892,437,216,0,0,0,4069,8064
30,Udine,58,689,2876,314,49,2,0,0,3930,483,2889,384,227,1,0,0,3984,7914
30,Udine,59,640,2839,343,60,2,0,0,3884,449,2899,384,256,1,0,1,3990,7874
30,Udine,60,576,2643,327,58,1,0,0,3605,366,2766,320,320,0,0,1,3773,7378
30,Udine,61,526,2536,280,73,2,0,0,3417,316,2727,315,303,0,0,0,3661,7078
30,Udine,62,507,2566,268,81,1,0,0,3423,334,2679,311,370,0,0,0,3694,7117
30,Udine,63,491,2529,246,103,1,0,0,3370,309,2579,286,392,0,0,0,3566,6936
30,Udine,64,410,2578,237,77,3,0,0,3305,274,2615,258,422,0,0,0,3569,6874
30,Udine,65,403,2541,214,104,1,0,0,3263,244,2604,228,498,0,0,0,3574,6837
30,Udine,66,348,2501,212,105,0,0,0,3166,238,2518,232,523,0,0,0,3511,6677
30,Udine,67,380,2387,177,99,1,0,0,3044,219,2431,189,635,0,0,0,3474,6518
30,Udine,68,380,2687,188,144,1,0,0,3400,226,2508,182,689,0,0,1,3606,7006
30,Udine,69,373,2586,166,157,1,0,0,3283,235,2486,217,735,0,0,2,3675,6958
30,Udine,70,386,2728,143,174,0,0,0,3431,229,2491,190,855,0,0,1,3766,7197
30,Udine,71,335,2745,136,193,1,0,0,3410,228,2452,186,926,0,0,0,3792,7202
30,Udine,72,354,2923,131,239,0,0,0,3647,200,2560,164,1128,0,0,0,4052,7699
30,Udine,73,240,1918,91,190,0,0,0,2439,168,1673,123,829,0,0,1,2794,5233
30,Udine,74,255,2318,96,217,0,0,0,2886,171,1831,123,1109,0,0,0,3234,6120
30,Udine,75,264,2140,96,248,1,0,0,2749,181,1746,129,1110,0,0,0,3166,5915
30,Udine,76,249,2056,96,246,2,0,0,2649,188,1763,94,1244,0,0,0,3289,5938
30,Udine,77,242,2057,80,296,1,0,0,2676,191,1551,78,1351,0,0,0,3171,5847
30,Udine,78,251,2094,68,308,1,0,0,2722,193,1413,78,1538,1,0,1,3224,5946
30,Udine,79,199,1954,60,296,0,0,0,2509,202,1347,80,1496,0,0,0,3125,5634
30,Udine,80,170,1757,46,299,1,0,0,2273,174,1119,68,1556,0,0,0,2917,5190
30,Udine,81,157,1425,39,317,0,0,0,1938,183,869,68,1493,0,0,1,2614,4552
30,Udine,82,118,1254,28,284,0,0,0,1684,139,729,39,1515,0,0,0,2422,4106
30,Udine,83,105,1077,32,301,0,0,0,1515,145,632,33,1554,1,0,0,2365,3880
30,Udine,84,85,950,26,262,0,0,0,1323,171,447,32,1471,0,0,0,2121,3444
30,Udine,85,99,799,13,254,0,0,0,1165,139,345,24,1415,0,0,1,1924,3089
30,Udine,86,72,658,14,230,0,0,0,974,122,314,28,1401,0,0,2,1867,2841
30,Udine,87,55,588,11,229,1,0,0,884,122,236,16,1285,0,0,0,1659,2543
30,Udine,88,65,460,8,217,0,0,0,750,127,187,19,1348,0,0,0,1681,2431
30,Udine,89,40,394,4,186,0,0,0,624,93,110,13,1121,0,0,0,1337,1961
30,Udine,90,34,327,9,140,0,0,0,510,106,97,18,1050,1,0,0,1272,1782
30,Udine,91,23,225,4,153,0,0,0,405,83,65,13,959,0,0,0,1120,1525
30,Udine,92,16,154,2,150,0,0,0,322,71,39,8,836,0,0,0,954,1276
30,Udine,93,17,113,1,103,0,0,0,234,62,35,7,685,0,0,0,789,1023
30,Udine,94,19,85,2,85,0,0,0,191,53,14,7,585,0,0,0,659,850
30,Udine,95,9,47,2,68,0,0,0,126,48,12,5,435,0,0,0,500,626
30,Udine,96,4,33,0,48,0,0,0,85,32,7,0,357,0,0,0,396,481
30,Udine,97,3,25,0,42,0,0,0,70,27,3,1,296,0,0,0,327,397
30,Udine,98,1,4,0,29,0,0,0,34,15,4,3,190,0,0,0,212,246
30,Udine,99,1,6,0,9,0,0,0,16,11,2,2,70,0,0,0,85,101
30,Udine,100,0,3,0,13,0,0,0,16,19,0,0,123,0,0,1,143,159
31,Gorizia,0,462,0,0,0,0,0,0,462,443,0,0,0,0,0,0,443,905
31,Gorizia,1,489,0,0,0,0,0,0,489,488,0,0,0,0,0,0,488,977
31,Gorizia,2,503,0,0,0,0,0,0,503,473,0,0,0,0,0,0,473,976
31,Gorizia,3,509,0,0,0,0,0,0,509,534,0,0,0,0,0,0,534,1043
31,Gorizia,4,521,0,0,0,0,0,0,521,477,0,0,0,0,0,0,477,998
31,Gorizia,5,552,0,0,0,0,0,0,552,466,0,0,0,0,0,0,466,1018
31,Gorizia,6,563,0,0,0,0,0,0,563,513,0,0,0,0,0,0,513,1076
31,Gorizia,7,633,0,0,0,0,0,0,633,527,0,0,0,0,0,0,527,1160
31,Gorizia,8,596,0,0,0,0,0,0,596,596,0,0,0,0,0,0,596,1192
31,Gorizia,9,602,0,0,0,0,0,0,602,532,0,0,0,0,0,0,532,1134
31,Gorizia,10,643,0,0,0,0,0,0,643,557,0,0,0,0,0,0,557,1200
31,Gorizia,11,601,0,0,0,0,0,0,601,611,0,0,0,0,0,0,611,1212
31,Gorizia,12,610,0,0,0,0,0,0,610,612,0,0,0,0,0,0,612,1222
31,Gorizia,13,641,0,0,0,0,0,0,641,564,0,0,0,0,0,0,564,1205
31,Gorizia,14,598,0,0,0,0,0,0,598,566,0,0,0,0,0,0,566,1164
31,Gorizia,15,610,0,0,0,0,0,0,610,591,0,0,0,0,0,0,591,1201
31,Gorizia,16,670,0,0,0,0,0,0,670,539,0,0,0,0,0,0,539,1209
31,Gorizia,17,684,0,0,0,0,0,0,684,572,0,0,0,0,0,0,572,1256
31,Gorizia,18,649,0,0,0,0,0,0,649,594,1,0,0,0,0,0,595,1244
31,Gorizia,19,607,1,0,0,0,0,0,608,565,3,0,0,0,0,0,568,1176
31,Gorizia,20,693,1,0,0,0,0,0,694,525,11,0,0,0,0,0,536,1230
31,Gorizia,21,636,2,0,0,0,0,1,639,548,16,0,0,0,0,0,564,1203
31,Gorizia,22,652,7,0,0,0,0,0,659,532,30,0,0,0,0,0,562,1221
31,Gorizia,23,623,8,0,0,0,0,0,631,535,42,0,0,0,0,0,577,1208
31,Gorizia,24,622,19,0,0,0,0,0,641,501,68,1,1,1,0,0,572,1213
31,Gorizia,25,598,26,1,0,1,0,0,626,517,74,1,0,0,0,0,592,1218
31,Gorizia,26,604,32,2,0,0,0,0,638,514,104,4,0,0,0,0,622,1260
31,Gorizia,27,581,64,3,0,0,0,0,648,494,140,1,0,0,0,0,635,1283
31,Gorizia,28,609,79,1,0,0,0,0,689,433,183,2,0,0,0,0,618,1307
31,Gorizia,29,550,115,1,0,0,0,0,666,431,220,5,0,0,0,0,656,1322
31,Gorizia,30,508,149,2,0,0,0,0,659,365,242,5,0,0,0,0,612,1271
31,Gorizia,31,435,169,4,0,0,0,0,608,348,277,5,2,1,0,0,633,1241
31,Gorizia,32,431,222,4,0,1,0,0,658,284,327,8,4,0,0,0,623,1281
31,Gorizia,33,401,256,4,0,0,0,0,661,284,332,17,0,0,0,0,633,1294
31,Gorizia,34,424,280,11,0,1,0,0,716,265,378,12,2,0,0,0,657,1373
31,Gorizia,35,405,315,8,0,0,0,0,728,252,345,14,3,0,0,0,614,1342
31,Gorizia,36,418,356,13,1,0,0,0,788,285,372,23,4,0,0,0,684,1472
31,Gorizia,37,413,364,17,1,0,0,0,795,257,441,25,1,0,0,0,724,1519
31,Gorizia,38,393,395,15,1,1,0,0,805,236,439,35,0,0,0,0,710,1515
31,Gorizia,39,425,446,19,0,0,0,0,890,233,468,38,5,0,0,0,744,1634
31,Gorizia,40,405,482,32,0,0,0,0,919,274,528,44,1,0,0,0,847,1766
31,Gorizia,41,428,535,26,1,1,0,0,991,268,509,50,1,2,0,0,830,1821
31,Gorizia,42,424,501,30,0,0,0,0,955,248,602,67,8,0,0,0,925,1880
31,Gorizia,43,427,606,51,1,0,0,0,1085,266,620,77,4,1,0,0,968,2053
31,Gorizia,44,493,657,60,3,0,0,0,1213,294,700,88,11,1,0,0,1094,2307
31,Gorizia,45,447,617,75,1,1,0,0,1141,293,740,87,11,1,0,0,1132,2273
31,Gorizia,46,463,706,52,5,1,0,0,1227,242,768,103,18,0,0,0,1131,2358
31,Gorizia,47,419,713,59,2,2,0,0,1195,232,802,85,16,2,0,0,1137,2332
31,Gorizia,48,395,711,77,3,0,0,0,1186,251,749,114,34,1,0,0,1149,2335
31,Gorizia,49,368,761,106,8,1,0,0,1244,244,786,127,21,0,0,0,1178,2422
31,Gorizia,50,351,740,116,4,1,0,0,1212,217,767,119,23,0,0,0,1126,2338
31,Gorizia,51,333,774,102,6,0,0,0,1215,222,828,121,29,0,0,0,1200,2415
31,Gorizia,52,359,774,116,7,2,0,0,1258,187,784,146,44,0,0,0,1161,2419
31,Gorizia,53,309,811,102,5,0,0,0,1227,199,848,140,34,0,0,0,1221,2448
31,Gorizia,54,312,825,116,18,0,0,0,1271,183,863,153,45,0,0,0,1244,2515
31,Gorizia,55,236,868,100,13,1,0,0,1218,163,782,121,45,0,0,0,1111,2329
31,Gorizia,56,211,793,105,13,0,0,0,1122,142,723,114,59,0,0,0,1038,2160
31,Gorizia,57,198,761,105,8,1,0,0,1073,123,775,115,69,0,0,0,1082,2155
31,Gorizia,58,230,782,110,13,0,0,0,1135,119,673,112,54,0,0,0,958,2093
31,Gorizia,59,158,699,108,15,0,0,0,980,88,697,108,67,0,0,0,960,1940
31,Gorizia,60,163,669,92,15,1,0,0,940,93,680,97,65,0,0,0,935,1875
31,Gorizia,61,128,646,80,12,0,0,0,866,94,681,83,70,0,0,0,928,1794
31,Gorizia,62,120,668,74,13,0,0,0,875,73,602,95,89,0,0,0,859,1734
31,Gorizia,63,118,669,84,22,0,0,0,893,87,596,85,96,0,0,0,864,1757
31,Gorizia,64,124,631,54,23,0,0,0,832,74,570,81,116,1,0,0,842,1674
31,Gorizia,65,98,625,56,24,0,0,0,803,70,663,80,124,0,0,0,937,1740
31,Gorizia,66,77,558,50,29,0,0,1,715,56,626,71,116,0,0,0,869,1584
31,Gorizia,67,95,636,60,38,0,0,0,829,50,610,67,134,0,0,0,861,1690
31,Gorizia,68,82,572,69,38,0,0,0,761,57,645,65,181,0,0,0,948,1709
31,Gorizia,69,64,659,57,48,0,0,0,828,42,642,60,193,0,0,0,937,1765
31,Gorizia,70,84,707,50,50,0,0,0,891,61,663,88,226,0,0,0,1038,1929
31,Gorizia,71,74,703,44,36,0,0,0,857,57,652,66,262,0,0,0,1037,1894
31,Gorizia,72,77,713,51,65,0,0,0,906,64,623,46,295,0,0,0,1028,1934
31,Gorizia,73,42,492,23,42,0,0,0,599,33,388,37,209,0,0,0,667,1266
31,Gorizia,74,48,566,35,63,0,0,0,712,58,499,40,300,0,0,0,897,1609
31,Gorizia,75,52,543,36,77,0,0,0,708,50,458,42,283,0,0,0,833,1541
31,Gorizia,76,54,519,22,74,0,0,0,669,41,412,36,330,0,0,0,819,1488
31,Gorizia,77,54,545,24,88,0,0,0,711,51,443,24,367,0,0,0,885,1596
31,Gorizia,78,47,547,30,91,0,0,0,715,61,467,23,399,0,0,0,950,1665
31,Gorizia,79,45,535,15,68,0,0,0,663,55,376,28,415,0,0,0,874,1537
31,Gorizia,80,43,445,22,83,0,0,0,593,58,321,24,450,0,0,1,854,1447
31,Gorizia,81,30,419,17,99,0,0,0,565,56,238,15,418,0,0,0,727,1292
31,Gorizia,82,30,381,7,76,0,0,0,494,36,221,15,456,0,0,0,728,1222
31,Gorizia,83,23,316,8,97,0,0,0,444,41,174,16,427,0,0,0,658,1102
31,Gorizia,84,22,244,5,67,0,0,0,338,42,133,14,451,0,0,0,640,978
31,Gorizia,85,15,218,4,86,0,0,0,323,57,123,9,400,0,0,0,589,912
31,Gorizia,86,23,199,2,58,0,0,0,282,42,104,10,380,0,0,0,536,818
31,Gorizia,87,14,163,3,64,0,0,0,244,32,73,8,385,0,0,0,498,742
31,Gorizia,88,9,160,3,70,0,0,0,242,43,66,5,402,0,0,0,516,758
31,Gorizia,89,6,116,1,58,0,0,0,181,36,54,7,315,0,0,0,412,593
31,Gorizia,90,5,88,1,55,0,0,0,149,32,29,5,268,0,0,0,334,483
31,Gorizia,91,8,72,2,48,0,0,0,130,26,26,5,268,0,0,0,325,455
31,Gorizia,92,3,44,0,34,0,0,0,81,26,15,2,229,0,0,0,272,353
31,Gorizia,93,2,38,0,22,0,0,0,62,17,8,3,201,0,0,0,229,291
31,Gorizia,94,4,19,0,27,0,0,0,50,21,12,6,160,0,0,0,199,249
31,Gorizia,95,0,26,0,31,0,0,0,57,21,0,2,142,0,0,0,165,222
31,Gorizia,96,3,6,1,16,0,0,0,26,8,3,0,98,0,0,0,109,135
31,Gorizia,97,0,4,0,7,0,0,0,11,9,3,1,74,0,0,0,87,98
31,Gorizia,98,1,5,1,10,0,0,0,17,6,0,0,55,0,0,0,61,78
31,Gorizia,99,0,0,0,3,0,0,0,3,3,0,0,23,0,0,0,26,29
31,Gorizia,100,0,0,1,6,0,0,0,7,1,0,1,22,0,0,0,24,31
32,Trieste,0,728,0,0,0,0,0,0,728,712,0,0,0,0,0,0,712,1440
32,Trieste,1,750,0,0,0,0,0,0,750,742,0,0,0,0,0,0,742,1492
32,Trieste,2,777,0,0,0,0,0,0,777,746,0,0,0,0,0,0,746,1523
32,Trieste,3,801,0,0,0,0,0,0,801,716,0,0,0,0,0,0,716,1517
32,Trieste,4,843,0,0,0,0,0,0,843,805,0,0,0,0,0,0,805,1648
32,Trieste,5,839,0,0,0,0,0,0,839,745,0,0,0,0,0,0,745,1584
32,Trieste,6,899,0,0,0,0,0,0,899,882,0,0,0,0,0,0,882,1781
32,Trieste,7,953,0,0,0,0,0,0,953,827,0,0,0,0,0,0,827,1780
32,Trieste,8,935,0,0,0,0,0,0,935,920,0,0,0,0,0,0,920,1855
32,Trieste,9,908,0,0,0,0,0,0,908,889,0,0,0,0,0,0,889,1797
32,Trieste,10,993,0,0,0,0,0,0,993,876,0,0,0,0,0,0,876,1869
32,Trieste,11,965,0,0,0,0,0,0,965,929,0,0,0,0,0,0,929,1894
32,Trieste,12,938,0,0,0,0,0,0,938,938,0,0,0,0,0,0,938,1876
32,Trieste,13,973,0,0,0,0,0,0,973,850,0,0,0,0,0,0,850,1823
32,Trieste,14,1007,0,0,0,0,0,0,1007,909,0,0,0,0,0,0,909,1916
32,Trieste,15,954,0,0,0,0,0,0,954,902,0,0,0,0,0,0,902,1856
32,Trieste,16,918,0,0,0,0,0,0,918,900,0,0,0,0,0,0,900,1818
32,Trieste,17,948,0,0,0,0,0,0,948,895,0,0,0,0,0,0,895,1843
32,Trieste,18,993,0,0,0,0,0,0,993,924,2,0,0,0,0,0,926,1919
32,Trieste,19,1023,0,0,0,0,0,0,1023,898,2,1,0,0,0,0,901,1924
32,Trieste,20,1024,0,0,0,0,0,0,1024,890,6,0,0,0,0,0,896,1920
32,Trieste,21,1095,3,0,0,0,0,0,1098,865,19,0,0,0,0,0,884,1982
32,Trieste,22,1084,7,0,0,0,0,0,1091,934,37,1,0,0,0,0,972,2063
32,Trieste,23,1064,9,0,0,0,0,0,1073,888,39,3,0,0,0,0,930,2003
32,Trieste,24,1048,17,1,0,0,0,0,1066,904,85,1,0,0,0,0,990,2056
32,Trieste,25,1137,43,0,0,0,0,0,1180,899,76,4,0,0,0,0,979,2159
32,Trieste,26,1164,69,1,0,0,0,0,1234,906,122,4,0,0,0,0,1032,2266
32,Trieste,27,1143,86,5,0,1,0,0,1235,892,195,11,0,0,0,0,1098,2333
32,Trieste,28,1164,142,3,0,0,0,0,1309,903,236,8,0,0,0,0,1147,2456
32,Trieste,29,1076,166,7,0,0,0,0,1249,799,291,12,0,1,0,0,1103,2352
32,Trieste,30,1061,230,11,0,1,0,0,1303,759,371,16,1,0,0,0,1147,2450
32,Trieste,31,912,292,4,0,0,0,0,1208,680,401,25,1,0,0,0,1107,2315
32,Trieste,32,944,305,15,0,4,0,0,1268,587,461,25,1,1,0,0,1075,2343
32,Trieste,33,810,404,15,1,0,0,0,1230,597,517,31,1,1,0,0,1147,2377
32,Trieste,34,763,414,17,0,0,0,0,1194,533,589,28,1,1,0,0,1152,2346
32,Trieste,35,744,476,17,1,1,0,0,1239,518,540,29,0,2,0,0,1089,2328
32,Trieste,36,711,490,20,0,2,0,0,1223,501,590,36,3,2,0,0,1132,2355
32,Trieste,37,655,536,24,0,1,0,0,1216,489,623,37,4,2,0,0,1155,2371
32,Trieste,38,653,543,33,1,5,0,0,1235,491,641,60,8,1,0,0,1201,2436
32,Trieste,39,647,523,35,1,1,0,0,1207,486,660,71,4,1,0,0,1222,2429
32,Trieste,40,711,633,46,1,0,0,0,1391,511,734,88,15,0,0,0,1348,2739
32,Trieste,41,678,705,57,1,0,0,0,1441,501,837,84,10,1,0,0,1433,2874
32,Trieste,42,723,767,68,4,3,0,0,1565,537,960,129,15,0,0,0,1641,3206
32,Trieste,43,688,823,81,4,5,0,0,1601,552,1007,137,8,1,0,0,1705,3306
32,Trieste,44,759,914,97,5,5,0,0,1780,548,1019,147,28,1,0,0,1743,3523
32,Trieste,45,684,976,94,7,0,0,0,1761,546,1143,157,19,2,0,0,1867,3628
32,Trieste,46,771,1048,122,7,2,0,0,1950,515,1156,180,27,3,0,0,1881,3831
32,Trieste,47,720,991,121,5,2,0,0,1839,515,1206,206,25,1,0,0,1953,3792
32,Trieste,48,665,1059,130,10,3,0,0,1867,504,1148,230,40,3,0,0,1925,3792
32,Trieste,49,638,1037,161,5,3,0,0,1844,393,1181,227,27,4,0,0,1832,3676
32,Trieste,50,570,1081,170,11,2,0,0,1834,383,1194,255,36,1,0,0,1869,3703
32,Trieste,51,590,1045,157,16,3,0,0,1811,380,1236,283,39,0,0,0,1938,3749
32,Trieste,52,559,1163,191,7,2,0,0,1922,371,1306,281,56,0,0,0,2014,3936
32,Trieste,53,506,1218,218,12,1,0,0,1955,370,1353,315,49,0,0,0,2087,4042
32,Trieste,54,503,1268,208,22,4,0,0,2005,353,1304,288,71,2,0,0,2018,4023
32,Trieste,55,450,1222,215,17,5,0,0,1909,319,1227,263,88,0,0,0,1897,3806
32,Trieste,56,374,1132,238,13,1,0,0,1758,259,1206,275,96,0,0,0,1836,3594
32,Trieste,57,366,1207,199,23,2,0,0,1797,219,1164,281,81,0,0,0,1745,3542
32,Trieste,58,301,1144,202,28,2,0,0,1677,220,1111,275,112,0,0,0,1718,3395
32,Trieste,59,311,1142,173,23,0,0,0,1649,189,1143,254,117,1,0,0,1704,3353
32,Trieste,60,258,1040,176,38,1,0,0,1513,174,1129,252,128,0,0,0,1683,3196
32,Trieste,61,256,1035,176,34,1,0,0,1502,188,1100,249,150,0,0,0,1687,3189
32,Trieste,62,222,1126,191,37,2,0,0,1578,127,1064,233,172,0,0,0,1596,3174
32,Trieste,63,199,1042,177,35,1,0,0,1454,144,1081,227,176,0,0,0,1628,3082
32,Trieste,64,183,1021,149,46,0,0,0,1399,120,1028,186,196,2,0,0,1532,2931
32,Trieste,65,143,988,147,41,0,0,0,1319,134,1025,160,211,0,0,0,1530,2849
32,Trieste,66,144,1032,132,52,2,0,0,1362,112,1061,171,215,0,0,0,1559,2921
32,Trieste,67,138,991,123,54,1,0,0,1307,101,1000,169,273,0,0,0,1543,2850
32,Trieste,68,144,1047,122,70,1,0,0,1384,116,1126,194,323,0,0,0,1759,3143
32,Trieste,69,110,1077,141,80,0,0,0,1408,95,1043,177,322,0,0,0,1637,3045
32,Trieste,70,137,1206,113,83,0,0,0,1539,123,1098,183,381,1,0,0,1786,3325
32,Trieste,71,120,1175,117,88,0,0,0,1500,109,1165,172,457,0,0,0,1903,3403
32,Trieste,72,136,1225,109,95,0,0,0,1565,99,1088,171,480,0,0,0,1838,3403
32,Trieste,73,84,790,87,88,1,0,0,1050,62,723,118,368,0,0,0,1271,2321
32,Trieste,74,88,922,71,88,0,0,0,1169,89,845,121,518,0,0,0,1573,2742
32,Trieste,75,68,976,63,120,0,0,0,1227,59,835,108,530,0,0,0,1532,2759
32,Trieste,76,90,953,71,121,1,0,0,1236,94,772,129,550,0,0,0,1545,2781
32,Trieste,77,81,967,62,132,0,0,0,1242,97,825,116,625,0,0,0,1663,2905
32,Trieste,78,92,998,67,163,0,0,0,1320,98,797,114,744,0,0,0,1753,3073
32,Trieste,79,65,904,45,170,0,0,0,1184,87,693,105,731,0,0,0,1616,2800
32,Trieste,80,58,869,41,165,0,0,0,1133,75,575,94,814,0,0,0,1558,2691
32,Trieste,81,54,743,40,175,0,0,0,1012,65,521,71,779,0,0,0,1436,2448
32,Trieste,82,44,598,33,140,1,0,0,816,89,414,62,747,0,0,0,1312,2128
32,Trieste,83,46,600,23,145,1,0,0,815,84,382,53,753,0,0,0,1272,2087
32,Trieste,84,31,472,34,135,0,0,0,672,72,259,43,747,0,0,0,1121,1793
32,Trieste,85,33,413,17,142,0,0,0,605,64,222,39,732,0,0,0,1057,1662
32,Trieste,86,14,366,21,135,0,0,0,536,58,179,45,698,0,0,0,980,1516
32,Trieste,87,25,323,16,120,0,0,0,484,65,129,32,706,0,0,0,932,1416
32,Trieste,88,25,286,12,136,0,0,0,459,57,132,33,681,0,0,0,903,1362
32,Trieste,89,14,199,5,100,0,0,0,318,55,78,26,615,0,0,0,774,1092
32,Trieste,90,15,148,4,99,0,0,0,266,51,55,17,484,0,0,0,607,873
32,Trieste,91,6,107,7,79,0,0,0,199,39,41,11,449,0,0,0,540,739
32,Trieste,92,5,89,1,68,0,0,0,163,33,22,7,468,0,0,0,530,693
32,Trieste,93,3,63,2,50,0,0,0,118,31,20,14,357,0,0,0,422,540
32,Trieste,94,3,35,0,48,0,0,0,86,26,10,6,267,0,0,0,309,395
32,Trieste,95,1,33,4,37,0,0,0,75,22,6,10,219,0,0,0,257,332
32,Trieste,96,5,19,1,31,0,0,0,56,10,5,3,203,0,0,0,221,277
32,Trieste,97,1,8,0,23,0,0,0,32,13,5,3,170,0,0,0,191,223
32,Trieste,98,3,9,0,16,0,0,0,28,12,1,2,118,0,0,0,133,161
32,Trieste,99,0,2,0,14,0,0,0,16,13,0,3,48,0,0,0,64,80
32,Trieste,100,0,1,1,6,0,0,0,8,6,1,2,71,0,0,0,80,88
33,Piacenza,0,1155,0,0,0,0,0,0,1155,996,0,0,0,0,0,0,996,2151
33,Piacenza,1,1110,0,0,0,0,0,0,1110,992,0,0,0,0,0,0,992,2102
33,Piacenza,2,1143,0,0,0,0,0,0,1143,1077,0,0,0,0,0,0,1077,2220
33,Piacenza,3,1182,0,0,0,0,0,0,1182,1132,0,0,0,0,0,0,1132,2314
33,Piacenza,4,1264,0,0,0,0,0,0,1264,1144,0,0,0,0,0,0,1144,2408
33,Piacenza,5,1207,0,0,0,0,0,0,1207,1244,0,0,0,0,0,0,1244,2451
33,Piacenza,6,1282,0,0,0,0,0,0,1282,1194,0,0,0,0,0,0,1194,2476
33,Piacenza,7,1251,0,0,0,0,0,0,1251,1186,0,0,0,0,0,0,1186,2437
33,Piacenza,8,1315,0,0,0,0,0,0,1315,1199,0,0,0,0,0,0,1199,2514
33,Piacenza,9,1358,0,0,0,0,0,0,1358,1295,0,0,0,0,0,0,1295,2653
33,Piacenza,10,1337,0,0,0,0,0,0,1337,1203,0,0,0,0,0,0,1203,2540
33,Piacenza,11,1347,0,0,0,0,0,0,1347,1215,0,0,0,0,0,0,1215,2562
33,Piacenza,12,1263,0,0,0,0,0,0,1263,1291,0,0,0,0,0,0,1291,2554
33,Piacenza,13,1243,0,0,0,0,0,0,1243,1254,0,0,0,0,0,0,1254,2497
33,Piacenza,14,1256,0,0,0,0,0,0,1256,1228,0,0,0,0,0,0,1228,2484
33,Piacenza,15,1318,0,0,0,0,0,0,1318,1188,0,0,0,0,0,0,1188,2506
33,Piacenza,16,1282,0,0,0,0,0,0,1282,1188,0,0,0,0,0,0,1188,2470
33,Piacenza,17,1268,0,0,0,0,0,0,1268,1191,0,0,0,0,0,0,1191,2459
33,Piacenza,18,1309,0,0,0,0,0,0,1309,1213,2,0,0,0,0,0,1215,2524
33,Piacenza,19,1354,0,0,0,0,0,0,1354,1161,18,0,0,0,0,0,1179,2533
33,Piacenza,20,1457,3,0,0,0,0,0,1460,1176,37,0,0,0,0,0,1213,2673
33,Piacenza,21,1491,1,0,0,1,0,0,1493,1176,57,0,0,0,0,0,1233,2726
33,Piacenza,22,1348,17,0,0,0,0,0,1365,1141,90,1,0,0,0,0,1232,2597
33,Piacenza,23,1341,21,1,0,0,0,0,1363,1103,141,3,1,0,0,0,1248,2611
33,Piacenza,24,1334,47,1,0,1,0,0,1383,1082,177,1,0,0,0,0,1260,2643
33,Piacenza,25,1335,67,0,0,1,0,0,1403,1085,228,8,1,0,0,0,1322,2725
33,Piacenza,26,1325,130,1,0,0,0,0,1456,1111,298,3,0,1,0,0,1413,2869
33,Piacenza,27,1395,161,2,0,1,0,0,1559,1028,378,4,2,0,0,0,1412,2971
33,Piacenza,28,1319,248,2,0,1,0,0,1570,982,513,11,0,0,0,0,1506,3076
33,Piacenza,29,1252,326,1,0,2,0,0,1581,872,577,12,0,3,0,0,1464,3045
33,Piacenza,30,1179,355,4,0,0,1,0,1539,802,619,11,3,0,0,0,1435,2974
33,Piacenza,31,1083,426,3,0,1,0,0,1513,754,723,18,3,0,0,0,1498,3011
33,Piacenza,32,956,502,12,1,0,0,0,1471,706,813,22,1,1,0,0,1543,3014
33,Piacenza,33,926,585,12,0,0,0,0,1523,642,859,34,4,0,0,0,1539,3062
33,Piacenza,34,944,711,10,1,2,0,0,1668,626,905,20,3,0,0,0,1554,3222
33,Piacenza,35,880,696,30,0,3,0,0,1609,563,882,32,5,3,0,0,1485,3094
33,Piacenza,36,880,782,29,1,0,0,0,1692,565,912,64,5,0,0,0,1546,3238
33,Piacenza,37,778,862,36,1,3,0,0,1680,517,1038,51,4,1,0,0,1611,3291
33,Piacenza,38,747,913,33,1,0,0,0,1694,542,1091,79,6,0,0,0,1718,3412
33,Piacenza,39,797,922,39,1,0,0,0,1759,525,1115,79,10,2,0,0,1731,3490
33,Piacenza,40,809,1013,37,1,0,0,0,1860,567,1236,86,7,1,0,0,1897,3757
33,Piacenza,41,821,1021,54,6,1,0,0,1903,562,1249,98,8,0,0,0,1917,3820
33,Piacenza,42,826,1233,65,7,1,0,0,2132,534,1286,100,8,0,0,0,1928,4060
33,Piacenza,43,818,1272,79,5,0,0,0,2174,591,1408,105,17,0,0,0,2121,4295
33,Piacenza,44,846,1396,89,5,1,0,0,2337,578,1557,136,23,0,0,0,2294,4631
33,Piacenza,45,795,1347,83,10,1,0,0,2236,587,1572,160,20,1,0,0,2340,4576
33,Piacenza,46,724,1419,120,6,2,0,0,2271,517,1539,142,43,1,0,0,2242,4513
33,Piacenza,47,702,1493,119,1,0,0,0,2315,498,1597,172,41,0,0,0,2308,4623
33,Piacenza,48,690,1449,129,12,2,1,0,2283,474,1612,165,27,0,0,0,2278,4561
33,Piacenza,49,637,1553,145,7,1,0,0,2343,466,1649,164,41,1,0,0,2321,4664
33,Piacenza,50,658,1592,163,15,3,0,0,2431,422,1665,193,57,3,0,0,2340,4771
33,Piacenza,51,622,1650,145,10,2,0,0,2429,407,1588,189,72,1,0,0,2257,4686
33,Piacenza,52,557,1659,139,14,2,0,0,2371,373,1749,205,82,1,0,0,2410,4781
33,Piacenza,53,557,1645,168,13,4,0,0,2387,357,1748,176,89,0,0,0,2370,4757
33,Piacenza,54,489,1693,175,15,1,0,0,2373,360,1712,196,90,0,0,0,2358,4731
33,Piacenza,55,428,1665,142,13,3,0,0,2251,329,1686,201,91,0,0,0,2307,4558
33,Piacenza,56,367,1576,164,15,1,0,0,2123,298,1599,184,103,1,0,0,2185,4308
33,Piacenza,57,393,1615,132,28,2,0,0,2170,243,1629,174,96,1,0,0,2143,4313
33,Piacenza,58,330,1534,144,38,0,0,0,2046,236,1567,190,98,0,0,0,2091,4137
33,Piacenza,59,302,1491,130,29,0,0,0,1952,227,1528,150,116,0,0,0,2021,3973
33,Piacenza,60,273,1520,121,40,0,0,0,1954,187,1461,161,146,0,0,0,1955,3909
33,Piacenza,61,307,1454,118,30,1,0,0,1910,225,1417,148,130,0,0,0,1920,3830
33,Piacenza,62,251,1474,145,35,2,0,0,1907,182,1450,130,172,1,0,0,1935,3842
33,Piacenza,63,243,1389,103,44,1,0,0,1780,180,1407,122,193,1,0,0,1903,3683
33,Piacenza,64,212,1349,114,47,2,0,0,1724,180,1317,112,201,0,0,1,1811,3535
33,Piacenza,65,193,1266,69,39,0,0,0,1567,139,1206,101,224,1,0,0,1671,3238
33,Piacenza,66,188,1222,86,59,0,0,0,1555,133,1178,99,229,0,0,0,1639,3194
33,Piacenza,67,193,1218,71,51,0,0,0,1533,120,1095,91,280,0,0,0,1586,3119
33,Piacenza,68,195,1268,74,84,0,0,0,1621,117,1215,97,303,0,0,0,1732,3353
33,Piacenza,69,188,1271,81,63,2,0,0,1605,131,1176,75,362,0,0,0,1744,3349
33,Piacenza,70,188,1262,56,80,0,0,0,1586,108,1240,85,400,0,0,0,1833,3419
33,Piacenza,71,237,1260,73,102,0,0,0,1672,116,1153,87,416,0,0,1,1773,3445
33,Piacenza,72,202,1308,62,102,1,0,0,1675,110,1221,62,473,0,0,0,1866,3541
33,Piacenza,73,134,924,51,81,0,0,0,1190,84,867,52,433,0,0,0,1436,2626
33,Piacenza,74,150,1026,50,97,0,0,0,1323,100,872,45,465,0,0,0,1482,2805
33,Piacenza,75,148,1006,41,112,1,0,0,1308,107,848,57,534,0,0,0,1546,2854
33,Piacenza,76,173,1052,31,110,1,0,0,1367,110,822,32,619,1,0,0,1584,2951
33,Piacenza,77,156,982,32,135,1,0,0,1306,118,755,35,681,0,0,0,1589,2895
33,Piacenza,78,157,1027,25,154,0,0,0,1363,125,730,34,757,0,0,0,1646,3009
33,Piacenza,79,159,936,30,159,0,0,0,1284,120,699,36,811,0,0,0,1666,2950
33,Piacenza,80,133,872,23,177,1,0,0,1206,88,660,37,873,0,0,0,1658,2864
33,Piacenza,81,134,749,19,168,0,0,0,1070,90,481,27,823,0,0,0,1421,2491
33,Piacenza,82,119,639,17,136,0,0,0,911,87,434,23,776,0,0,0,1320,2231
33,Piacenza,83,101,636,11,145,0,0,0,893,84,347,16,839,0,0,0,1286,2179
33,Piacenza,84,86,552,10,139,0,0,0,787,98,309,17,822,0,0,0,1246,2033
33,Piacenza,85,91,481,12,141,0,0,0,725,72,252,9,810,0,0,1,1144,1869
33,Piacenza,86,79,385,5,132,0,0,0,601,76,188,11,837,0,0,0,1112,1713
33,Piacenza,87,69,341,5,147,0,0,0,562,88,160,11,803,0,0,0,1062,1624
33,Piacenza,88,70,314,4,150,0,0,0,538,84,131,15,768,0,0,0,998,1536
33,Piacenza,89,49,206,3,123,0,0,0,381,73,80,6,646,0,0,0,805,1186
33,Piacenza,90,55,167,1,79,0,0,0,302,64,40,6,572,0,0,0,682,984
33,Piacenza,91,18,131,4,99,0,0,0,252,60,48,0,536,0,0,0,644,896
33,Piacenza,92,27,92,0,74,0,0,0,193,50,25,2,449,0,0,0,526,719
33,Piacenza,93,20,60,1,63,0,0,0,144,52,15,6,395,0,0,0,468,612
33,Piacenza,94,13,43,1,45,0,0,0,102,34,12,6,300,0,0,0,352,454
33,Piacenza,95,11,28,0,37,0,0,0,76,36,8,1,233,0,0,0,278,354
33,Piacenza,96,5,19,0,36,0,0,0,60,20,0,0,212,0,0,0,232,292
33,Piacenza,97,6,10,0,16,0,0,0,32,18,3,1,125,0,0,0,147,179
33,Piacenza,98,2,11,0,12,0,0,0,25,14,0,0,80,0,0,0,94,119
33,Piacenza,99,0,4,0,6,0,0,0,10,6,1,0,42,0,0,0,49,59
33,Piacenza,100,3,1,0,14,0,0,0,18,10,1,0,68,0,0,0,79,97
34,Parma,0,1792,0,0,0,0,0,0,1792,1635,0,0,0,0,0,0,1635,3427
34,Parma,1,1844,0,0,0,0,0,0,1844,1721,0,0,0,0,0,0,1721,3565
34,Parma,2,1913,0,0,0,0,0,0,1913,1847,0,0,0,0,0,0,1847,3760
34,Parma,3,1975,0,0,0,0,0,0,1975,1863,0,0,0,0,0,0,1863,3838
34,Parma,4,2000,0,0,0,0,0,0,2000,1916,0,0,0,0,0,0,1916,3916
34,Parma,5,2086,0,0,0,0,0,0,2086,1873,0,0,0,0,0,0,1873,3959
34,Parma,6,2078,0,0,0,0,0,0,2078,1946,0,0,0,0,0,0,1946,4024
34,Parma,7,2057,0,0,0,0,0,0,2057,1999,0,0,0,0,0,0,1999,4056
34,Parma,8,2235,0,0,0,0,0,0,2235,2102,0,0,0,0,0,0,2102,4337
34,Parma,9,2219,0,0,0,0,0,0,2219,2134,0,0,0,0,0,0,2134,4353
34,Parma,10,2210,0,0,0,0,0,0,2210,2002,0,0,0,0,0,0,2002,4212
34,Parma,11,2241,0,0,0,0,0,0,2241,2027,0,0,0,0,0,0,2027,4268
34,Parma,12,2115,0,0,0,0,0,0,2115,1965,0,0,0,0,0,0,1965,4080
34,Parma,13,2129,0,0,0,0,0,0,2129,2000,0,0,0,0,0,0,2000,4129
34,Parma,14,2019,0,0,0,0,0,0,2019,1920,0,0,0,0,0,0,1920,3939
34,Parma,15,2043,0,0,0,0,0,0,2043,1838,0,0,0,0,0,0,1838,3881
34,Parma,16,1974,0,0,0,0,0,0,1974,1859,0,0,0,0,0,0,1859,3833
34,Parma,17,2026,0,0,0,0,0,0,2026,1855,0,0,0,0,0,0,1855,3881
34,Parma,18,2111,0,1,0,0,0,0,2112,1879,3,1,0,0,0,0,1883,3995
34,Parma,19,2019,0,0,0,0,0,0,2019,1982,18,0,0,0,0,0,2000,4019
34,Parma,20,2136,1,0,0,0,0,0,2137,1809,32,0,0,0,0,0,1841,3978
34,Parma,21,2234,7,0,0,0,0,0,2241,1851,66,0,0,0,0,0,1917,4158
34,Parma,22,2138,12,0,0,0,0,0,2150,1783,83,0,0,0,0,0,1866,4016
34,Parma,23,2156,32,1,0,0,0,0,2189,1796,153,1,0,0,0,0,1950,4139
34,Parma,24,2110,43,0,0,0,0,0,2153,1747,200,1,0,0,0,0,1948,4101
34,Parma,25,2169,69,1,0,0,0,0,2239,1763,245,7,0,1,0,0,2016,4255
34,Parma,26,2265,136,0,0,1,0,0,2402,1895,354,11,0,1,0,0,2261,4663
34,Parma,27,2216,195,5,0,0,0,0,2416,1821,491,12,2,1,0,0,2327,4743
34,Parma,28,2206,276,4,0,0,0,0,2486,1807,658,9,1,0,0,0,2475,4961
34,Parma,29,2122,377,6,0,0,0,0,2505,1727,727,21,1,3,0,0,2479,4984
34,Parma,30,2060,529,17,0,0,0,0,2606,1560,1008,22,2,2,0,0,2594,5200
34,Parma,31,1850,654,9,1,1,0,0,2515,1469,1079,32,1,0,0,0,2581,5096
34,Parma,32,1845,789,14,0,1,0,0,2649,1283,1221,45,2,1,0,0,2552,5201
34,Parma,33,1781,905,18,0,2,0,0,2706,1251,1348,52,2,4,0,0,2657,5363
34,Parma,34,1659,1114,31,1,1,0,0,2806,1149,1418,66,8,1,0,0,2642,5448
34,Parma,35,1543,1154,37,0,4,0,0,2738,1180,1551,43,13,5,0,0,2792,5530
34,Parma,36,1532,1309,35,0,1,0,0,2877,1107,1688,89,10,2,0,0,2896,5773
34,Parma,37,1356,1397,47,2,1,0,0,2803,1038,1647,88,8,2,0,0,2783,5586
34,Parma,38,1407,1482,48,3,4,0,0,2944,1001,1755,112,12,2,0,0,2882,5826
34,Parma,39,1442,1588,80,2,2,0,0,3114,980,1861,118,15,2,0,0,2976,6090
34,Parma,40,1495,1612,83,4,2,0,0,3196,1055,1962,105,16,2,0,0,3140,6336
34,Parma,41,1377,1764,91,5,3,0,0,3240,963,2128,158,23,0,0,0,3272,6512
34,Parma,42,1428,1928,106,5,5,0,0,3472,1012,2206,176,19,1,0,0,3414,6886
34,Parma,43,1391,2136,140,3,2,0,0,3672,1005,2398,175,28,1,0,0,3607,7279
34,Parma,44,1379,2189,126,8,8,0,0,3710,970,2459,223,42,4,0,0,3698,7408
34,Parma,45,1283,2241,146,8,2,0,0,3680,1021,2370,245,37,0,0,0,3673,7353
34,Parma,46,1293,2281,155,8,3,0,0,3740,831,2583,267,43,0,0,0,3724,7464
34,Parma,47,1138,2284,224,10,3,0,0,3659,863,2531,306,57,1,0,0,3758,7417
34,Parma,48,1121,2440,187,16,9,0,0,3773,788,2520,295,64,0,0,0,3667,7440
34,Parma,49,1032,2487,214,8,2,0,0,3743,765,2632,329,55,2,0,0,3783,7526
34,Parma,50,1038,2489,235,11,5,0,0,3778,728,2599,350,68,1,0,0,3746,7524
34,Parma,51,892,2487,258,20,5,0,0,3662,669,2713,320,81,2,0,0,3785,7447
34,Parma,52,884,2568,275,26,3,0,0,3756,683,2613,336,96,0,0,0,3728,7484
34,Parma,53,798,2585,274,31,4,0,0,3692,638,2607,339,106,3,0,0,3693,7385
34,Parma,54,733,2693,278,23,2,0,0,3729,528,2672,360,116,2,0,0,3678,7407
34,Parma,55,630,2466,249,33,2,0,0,3380,479,2562,332,123,0,0,0,3496,6876
34,Parma,56,521,2448,257,31,6,0,0,3263,469,2496,316,147,2,0,0,3430,6693
34,Parma,57,549,2357,243,46,2,0,0,3197,439,2337,291,157,1,0,0,3225,6422
34,Parma,58,447,2327,233,44,2,0,0,3053,414,2262,284,168,0,0,0,3128,6181
34,Parma,59,437,2213,225,33,2,0,0,2910,379,2297,237,193,0,0,0,3106,6016
34,Parma,60,359,2119,209,51,2,0,0,2740,344,2118,252,233,0,0,0,2947,5687
34,Parma,61,381,2072,177,46,2,0,0,2678,301,2144,224,241,0,0,0,2910,5588
34,Parma,62,347,2045,169,55,2,0,0,2618,279,2053,240,268,1,0,0,2841,5459
34,Parma,63,325,1985,184,52,3,0,0,2549,281,2004,218,242,1,0,0,2746,5295
34,Parma,64,256,1966,130,69,0,0,0,2421,254,1977,209,277,0,0,0,2717,5138
34,Parma,65,272,1878,139,70,1,0,0,2360,209,1858,179,294,0,0,0,2540,4900
34,Parma,66,240,1807,118,88,0,0,0,2253,191,1820,149,322,0,0,0,2482,4735
34,Parma,67,245,1749,122,98,0,0,0,2214,195,1788,158,385,0,0,0,2526,4740
34,Parma,68,223,1935,112,88,0,0,0,2358,203,1920,147,450,0,0,0,2720,5078
34,Parma,69,237,1841,111,91,2,0,0,2282,202,1858,127,444,0,0,0,2631,4913
34,Parma,70,239,2145,100,143,1,0,0,2628,182,1892,135,508,0,0,0,2717,5345
34,Parma,71,236,2061,99,145,4,0,0,2545,169,1821,135,606,0,0,0,2731,5276
34,Parma,72,226,1982,70,162,1,0,0,2441,172,1766,141,670,0,0,0,2749,5190
34,Parma,73,174,1396,63,118,0,0,0,1751,93,1321,78,574,0,0,0,2066,3817
34,Parma,74,180,1571,59,160,1,0,0,1971,152,1384,76,659,0,0,0,2271,4242
34,Parma,75,166,1458,56,155,0,0,0,1835,110,1264,82,725,1,0,0,2182,4017
34,Parma,76,193,1458,41,150,1,0,0,1843,139,1216,77,778,0,0,0,2210,4053
34,Parma,77,180,1425,60,208,0,0,0,1873,145,1207,65,872,0,0,0,2289,4162
34,Parma,78,195,1510,53,226,0,0,0,1984,140,1233,48,1083,0,0,0,2504,4488
34,Parma,79,207,1401,33,244,0,0,0,1885,150,1105,64,1089,0,0,0,2408,4293
34,Parma,80,157,1375,32,246,0,0,0,1810,155,1042,61,1153,0,0,0,2411,4221
34,Parma,81,168,1189,34,265,0,0,0,1656,141,769,50,1068,0,0,0,2028,3684
34,Parma,82,127,969,15,211,0,0,0,1322,99,680,31,1077,0,0,0,1887,3209
34,Parma,83,141,950,11,235,0,0,0,1337,130,590,26,1217,0,0,0,1963,3300
34,Parma,84,102,831,16,229,1,0,0,1179,114,493,25,1181,0,0,0,1813,2992
34,Parma,85,100,718,14,212,0,0,0,1044,104,396,17,1047,0,0,0,1564,2608
34,Parma,86,79,610,11,214,0,0,0,914,92,336,22,1071,0,0,0,1521,2435
34,Parma,87,80,513,8,203,0,0,0,804,99,231,14,1124,0,0,0,1468,2272
34,Parma,88,58,455,7,196,0,0,0,716,82,206,16,1046,0,0,0,1350,2066
34,Parma,89,49,349,4,163,0,0,0,565,79,137,11,928,0,0,0,1155,1720
34,Parma,90,41,250,3,150,0,0,0,444,72,77,10,852,0,0,0,1011,1455
34,Parma,91,24,212,5,135,0,0,0,376,81,90,5,779,0,0,0,955,1331
34,Parma,92,34,157,0,111,0,0,0,302,51,42,8,638,0,0,0,739,1041
34,Parma,93,27,101,0,112,0,0,0,240,59,35,6,543,0,0,0,643,883
34,Parma,94,11,69,1,89,0,0,0,170,52,34,0,442,0,0,0,528,698
34,Parma,95,12,33,5,72,0,0,0,122,29,16,5,384,0,0,0,434,556
34,Parma,96,6,31,1,45,0,0,0,83,32,8,2,248,0,0,0,290,373
34,Parma,97,3,21,0,35,0,0,0,59,23,4,3,220,0,0,0,250,309
34,Parma,98,2,25,1,27,0,0,0,55,10,3,0,119,0,0,0,132,187
34,Parma,99,0,3,0,7,0,0,0,10,5,1,0,75,0,0,0,81,91
34,Parma,100,0,7,0,12,0,0,0,19,12,3,1,110,0,0,0,126,145
35,Reggio nell'Emilia,0,2044,0,0,0,0,0,0,2044,1969,0,0,0,0,0,0,1969,4013
35,Reggio nell'Emilia,1,2230,0,0,0,0,0,0,2230,2071,0,0,0,0,0,0,2071,4301
35,Reggio nell'Emilia,2,2311,0,0,0,0,0,0,2311,2235,0,0,0,0,0,0,2235,4546
35,Reggio nell'Emilia,3,2505,0,0,0,0,0,0,2505,2332,0,0,0,0,0,0,2332,4837
35,Reggio nell'Emilia,4,2422,0,0,0,0,0,0,2422,2355,0,0,0,0,0,0,2355,4777
35,Reggio nell'Emilia,5,2597,0,0,0,0,0,0,2597,2448,0,0,0,0,0,0,2448,5045
35,Reggio nell'Emilia,6,2778,0,0,0,0,0,0,2778,2453,0,0,0,0,0,0,2453,5231
35,Reggio nell'Emilia,7,2649,0,0,0,0,0,0,2649,2665,0,0,0,0,0,0,2665,5314
35,Reggio nell'Emilia,8,2895,0,0,0,0,0,0,2895,2702,0,0,0,0,0,0,2702,5597
35,Reggio nell'Emilia,9,2876,0,0,0,0,0,0,2876,2681,0,0,0,0,0,0,2681,5557
35,Reggio nell'Emilia,10,2849,0,0,0,0,0,0,2849,2766,0,0,0,0,0,0,2766,5615
35,Reggio nell'Emilia,11,2902,0,0,0,0,0,0,2902,2652,0,0,0,0,0,0,2652,5554
35,Reggio nell'Emilia,12,2813,0,0,0,0,0,0,2813,2657,0,0,0,0,0,0,2657,5470
35,Reggio nell'Emilia,13,2778,0,0,0,0,0,0,2778,2617,0,0,0,0,0,0,2617,5395
35,Reggio nell'Emilia,14,2791,0,0,0,0,0,0,2791,2614,0,0,0,0,0,0,2614,5405
35,Reggio nell'Emilia,15,2741,0,0,0,0,0,0,2741,2469,0,0,0,0,0,0,2469,5210
35,Reggio nell'Emilia,16,2813,0,0,0,0,0,0,2813,2502,0,0,0,0,0,0,2502,5315
35,Reggio nell'Emilia,17,2666,0,0,0,0,0,0,2666,2409,1,0,0,0,0,0,2410,5076
35,Reggio nell'Emilia,18,2796,0,0,0,0,0,0,2796,2454,3,0,0,0,0,0,2457,5253
35,Reggio nell'Emilia,19,2695,4,0,0,0,0,0,2699,2397,18,0,0,0,0,0,2415,5114
35,Reggio nell'Emilia,20,2866,2,0,0,0,0,0,2868,2394,46,1,0,0,0,0,2441,5309
35,Reggio nell'Emilia,21,2605,7,0,0,0,0,0,2612,2376,77,0,0,0,0,0,2453,5065
35,Reggio nell'Emilia,22,2648,21,0,0,0,0,0,2669,2316,131,2,0,0,0,0,2449,5118
35,Reggio nell'Emilia,23,2629,31,0,0,0,0,0,2660,2220,173,2,0,0,0,0,2395,5055
35,Reggio nell'Emilia,24,2551,54,2,0,0,0,0,2607,2222,257,3,0,0,0,0,2482,5089
35,Reggio nell'Emilia,25,2578,121,0,0,1,0,0,2700,2172,330,4,0,0,0,0,2506,5206
35,Reggio nell'Emilia,26,2559,160,1,0,1,0,0,2721,2026,475,6,0,0,0,0,2507,5228
35,Reggio nell'Emilia,27,2482,279,2,0,1,0,0,2764,2007,596,9,0,1,0,0,2613,5377
35,Reggio nell'Emilia,28,2464,364,6,0,1,0,0,2835,1916,729,6,3,0,0,0,2654,5489
35,Reggio nell'Emilia,29,2255,502,5,0,2,0,0,2764,1735,930,15,1,0,0,0,2681,5445
35,Reggio nell'Emilia,30,2263,650,5,0,1,0,0,2919,1610,1112,21,3,2,0,0,2748,5667
35,Reggio nell'Emilia,31,2082,780,14,0,1,0,0,2877,1471,1253,29,4,3,0,0,2760,5637
35,Reggio nell'Emilia,32,1920,912,9,0,1,0,0,2842,1365,1354,40,0,5,0,0,2764,5606
35,Reggio nell'Emilia,33,1946,1073,27,3,0,0,0,3049,1308,1577,51,9,2,0,0,2947,5996
35,Reggio nell'Emilia,34,1875,1121,23,1,3,0,0,3023,1283,1740,77,10,1,0,0,3111,6134
35,Reggio nell'Emilia,35,1784,1268,35,0,3,0,0,3090,1198,1853,88,7,4,0,0,3150,6240
35,Reggio nell'Emilia,36,1679,1468,47,2,0,0,0,3196,1207,2005,86,9,5,0,0,3312,6508
35,Reggio nell'Emilia,37,1645,1576,51,3,1,0,0,3276,1154,2059,110,5,1,0,0,3329,6605
35,Reggio nell'Emilia,38,1703,1813,65,5,2,0,0,3588,1158,2088,95,22,1,0,0,3364,6952
35,Reggio nell'Emilia,39,1646,1798,82,3,2,0,0,3531,1105,2291,152,13,0,0,0,3561,7092
35,Reggio nell'Emilia,40,1698,2099,109,3,4,0,0,3913,1202,2455,202,16,2,0,0,3877,7790
35,Reggio nell'Emilia,41,1685,2225,113,4,6,0,0,4033,1199,2585,203,20,3,0,0,4010,8043
35,Reggio nell'Emilia,42,1684,2454,118,8,3,0,0,4267,1294,2796,225,29,6,0,0,4350,8617
35,Reggio nell'Emilia,43,1693,2518,177,7,5,0,0,4400,1208,2830,268,37,1,0,0,4344,8744
35,Reggio nell'Emilia,44,1692,2757,215,9,5,0,0,4678,1168,2958,241,51,5,0,0,4423,9101
35,Reggio nell'Emilia,45,1575,2868,198,12,3,0,0,4656,1133,2970,311,42,2,0,0,4458,9114
35,Reggio nell'Emilia,46,1515,2962,232,9,4,0,0,4722,1010,3114,337,49,3,0,0,4513,9235
35,Reggio nell'Emilia,47,1429,2984,236,15,6,0,0,4670,968,2986,339,57,4,0,0,4354,9024
35,Reggio nell'Emilia,48,1258,2902,225,11,3,0,0,4399,895,3074,370,74,3,0,0,4416,8815
35,Reggio nell'Emilia,49,1201,2954,270,14,4,0,0,4443,868,3101,398,70,2,0,0,4439,8882
35,Reggio nell'Emilia,50,1123,3075,293,22,3,0,0,4516,818,3091,384,93,3,0,0,4389,8905
35,Reggio nell'Emilia,51,1067,2935,284,17,4,0,0,4307,738,2970,380,103,2,0,0,4193,8500
35,Reggio nell'Emilia,52,980,3019,307,28,4,0,0,4338,726,3133,386,114,0,0,0,4359,8697
35,Reggio nell'Emilia,53,850,3096,289,23,3,0,0,4261,647,3058,388,137,2,0,0,4232,8493
35,Reggio nell'Emilia,54,775,3089,319,28,2,0,0,4213,625,3116,422,122,0,0,0,4285,8498
35,Reggio nell'Emilia,55,742,2897,328,39,2,0,0,4008,558,2848,379,142,4,0,0,3931,7939
35,Reggio nell'Emilia,56,662,2746,312,46,4,0,0,3770,524,2906,351,160,1,0,0,3942,7712
35,Reggio nell'Emilia,57,548,2728,265,39,0,0,0,3580,489,2744,357,165,2,0,0,3757,7337
35,Reggio nell'Emilia,58,515,2690,277,56,3,0,0,3541,388,2830,396,184,0,0,0,3798,7339
35,Reggio nell'Emilia,59,467,2648,245,48,5,0,0,3413,409,2586,348,229,1,0,0,3573,6986
35,Reggio nell'Emilia,60,410,2493,247,60,4,0,0,3214,361,2484,300,226,1,0,0,3372,6586
35,Reggio nell'Emilia,61,410,2523,222,50,0,0,0,3205,298,2599,277,251,1,0,0,3426,6631
35,Reggio nell'Emilia,62,343,2465,229,88,1,0,0,3126,292,2428,271,289,0,0,0,3280,6406
35,Reggio nell'Emilia,63,337,2421,194,60,3,0,0,3015,275,2371,233,330,0,0,0,3209,6224
35,Reggio nell'Emilia,64,292,2334,183,88,1,0,0,2898,251,2398,229,349,0,0,0,3227,6125
35,Reggio nell'Emilia,65,280,2246,172,61,3,0,0,2762,232,2224,216,357,1,0,0,3030,5792
35,Reggio nell'Emilia,66,255,2080,135,105,2,0,0,2577,219,2143,169,400,0,0,0,2931,5508
35,Reggio nell'Emilia,67,220,2154,125,104,1,0,0,2604,190,2154,171,407,1,0,0,2923,5527
35,Reggio nell'Emilia,68,218,2221,131,99,0,0,0,2669,180,2257,193,490,0,0,0,3120,5789
35,Reggio nell'Emilia,69,215,2302,142,119,1,0,0,2779,174,2167,165,546,0,0,0,3052,5831
35,Reggio nell'Emilia,70,264,2397,130,133,2,0,0,2926,193,2231,147,699,0,0,0,3270,6196
35,Reggio nell'Emilia,71,227,2285,108,161,1,0,0,2782,183,2136,165,647,1,0,0,3132,5914
35,Reggio nell'Emilia,72,173,2306,81,172,0,0,0,2732,152,2054,141,759,0,0,0,3106,5838
35,Reggio nell'Emilia,73,132,1566,78,136,1,0,0,1913,113,1364,101,612,0,0,0,2190,4103
35,Reggio nell'Emilia,74,146,1756,62,166,0,0,0,2130,102,1442,98,754,0,0,0,2396,4526
35,Reggio nell'Emilia,75,155,1693,62,174,1,0,0,2085,92,1352,85,822,0,0,0,2351,4436
35,Reggio nell'Emilia,76,167,1569,55,179,0,0,0,1970,106,1380,56,860,0,0,0,2402,4372
35,Reggio nell'Emilia,77,173,1576,67,215,2,0,0,2033,132,1302,67,874,0,0,0,2375,4408
35,Reggio nell'Emilia,78,171,1662,46,234,0,0,0,2113,137,1272,58,1109,0,0,0,2576,4689
35,Reggio nell'Emilia,79,173,1534,37,234,0,0,0,1978,122,1184,54,1153,0,0,0,2513,4491
35,Reggio nell'Emilia,80,157,1535,38,272,0,0,0,2002,112,1016,56,1177,0,0,0,2361,4363
35,Reggio nell'Emilia,81,134,1217,32,237,0,0,0,1620,114,830,34,1228,0,0,0,2206,3826
35,Reggio nell'Emilia,82,107,1039,26,223,0,0,0,1395,91,703,33,1166,0,0,0,1993,3388
35,Reggio nell'Emilia,83,139,1156,19,253,0,0,0,1567,103,611,28,1267,0,0,0,2009,3576
35,Reggio nell'Emilia,84,118,931,20,249,0,0,0,1318,86,492,18,1362,0,0,0,1958,3276
35,Reggio nell'Emilia,85,100,782,7,248,0,0,0,1137,91,387,20,1217,0,0,0,1715,2852
35,Reggio nell'Emilia,86,84,633,11,222,0,0,0,950,76,282,17,1136,0,0,0,1511,2461
35,Reggio nell'Emilia,87,83,532,7,262,0,0,0,884,88,219,15,1136,0,0,0,1458,2342
35,Reggio nell'Emilia,88,61,478,12,210,0,0,0,761,76,182,7,1183,0,0,0,1448,2209
35,Reggio nell'Emilia,89,50,395,2,191,0,0,0,638,63,140,6,1010,0,0,0,1219,1857
35,Reggio nell'Emilia,90,47,298,4,167,0,0,0,516,57,96,6,911,0,0,0,1070,1586
35,Reggio nell'Emilia,91,33,193,6,135,0,0,0,367,47,56,9,837,0,0,0,949,1316
35,Reggio nell'Emilia,92,17,148,2,106,0,0,0,273,36,51,6,672,0,0,0,765,1038
35,Reggio nell'Emilia,93,18,86,0,115,0,0,0,219,47,29,6,624,0,0,0,706,925
35,Reggio nell'Emilia,94,14,79,2,97,0,0,0,192,38,23,6,454,0,0,0,521,713
35,Reggio nell'Emilia,95,11,36,0,76,0,0,0,123,33,11,4,374,0,0,0,422,545
35,Reggio nell'Emilia,96,4,37,1,45,0,0,0,87,16,6,4,266,0,0,0,292,379
35,Reggio nell'Emilia,97,4,14,0,45,0,0,0,63,16,4,4,187,0,0,0,211,274
35,Reggio nell'Emilia,98,3,6,0,22,0,0,0,31,8,1,0,118,0,0,0,127,158
35,Reggio nell'Emilia,99,2,6,0,14,0,0,0,22,5,1,1,57,0,0,0,64,86
35,Reggio nell'Emilia,100,1,1,0,11,0,0,0,13,9,0,1,92,0,0,0,102,115
36,Modena,0,2812,0,0,0,0,0,0,2812,2668,0,0,0,0,0,0,2668,5480
36,Modena,1,2904,0,0,0,0,0,0,2904,2745,0,0,0,0,0,0,2745,5649
36,Modena,2,3133,0,0,0,0,0,0,3133,2859,0,0,0,0,0,0,2859,5992
36,Modena,3,3081,0,0,0,0,0,0,3081,2949,0,0,0,0,0,0,2949,6030
36,Modena,4,3107,0,0,0,0,0,0,3107,2975,0,0,0,0,0,0,2975,6082
36,Modena,5,3281,0,0,0,0,0,0,3281,3114,0,0,0,0,0,0,3114,6395
36,Modena,6,3465,0,0,0,0,0,0,3465,3282,0,0,0,0,0,0,3282,6747
36,Modena,7,3592,0,0,0,0,0,0,3592,3331,0,0,0,0,0,0,3331,6923
36,Modena,8,3623,0,0,0,0,0,0,3623,3453,0,0,0,0,0,0,3453,7076
36,Modena,9,3624,0,0,0,0,0,0,3624,3423,0,0,0,0,0,0,3423,7047
36,Modena,10,3752,0,0,0,0,0,0,3752,3402,0,0,0,0,0,0,3402,7154
36,Modena,11,3551,0,0,0,0,0,0,3551,3383,0,0,0,0,0,0,3383,6934
36,Modena,12,3512,0,0,0,0,0,0,3512,3325,0,0,0,0,0,0,3325,6837
36,Modena,13,3447,0,0,0,0,0,0,3447,3332,0,0,0,0,0,0,3332,6779
36,Modena,14,3442,0,0,0,0,0,0,3442,3233,0,0,0,0,0,0,3233,6675
36,Modena,15,3343,0,0,0,0,0,0,3343,3134,0,0,0,0,0,0,3134,6477
36,Modena,16,3385,0,0,0,0,0,0,3385,3126,0,0,0,0,0,0,3126,6511
36,Modena,17,3401,0,0,0,0,0,0,3401,3228,0,0,0,0,0,0,3228,6629
36,Modena,18,3514,0,0,0,0,0,0,3514,3200,6,0,0,0,0,0,3206,6720
36,Modena,19,3399,1,0,0,0,0,0,3400,3073,17,0,0,0,0,0,3090,6490
36,Modena,20,3603,3,0,0,0,0,0,3606,2938,60,1,0,0,0,0,2999,6605
36,Modena,21,3473,15,0,0,0,0,0,3488,3013,111,1,0,0,0,0,3125,6613
36,Modena,22,3463,21,0,0,0,0,0,3484,2921,144,0,0,1,0,0,3066,6550
36,Modena,23,3391,65,0,0,1,0,0,3457,2849,218,2,0,1,0,0,3070,6527
36,Modena,24,3473,61,1,0,0,0,0,3535,2837,287,1,0,0,0,0,3125,6660
36,Modena,25,3427,123,0,0,0,0,0,3550,2806,408,7,0,2,0,0,3223,6773
36,Modena,26,3483,222,2,0,1,0,0,3708,2799,564,8,1,2,0,0,3374,7082
36,Modena,27,3393,271,6,0,0,0,0,3670,2723,733,9,0,1,0,0,3466,7136
36,Modena,28,3450,420,3,0,3,0,0,3876,2614,940,20,3,0,0,0,3577,7453
36,Modena,29,3134,540,11,0,1,0,1,3687,2529,1101,29,2,2,0,0,3663,7350
36,Modena,30,3109,724,10,0,0,0,0,3843,2219,1357,34,5,1,0,0,3616,7459
36,Modena,31,2872,898,12,0,1,0,0,3783,2169,1593,34,3,0,0,0,3799,7582
36,Modena,32,2661,1050,14,1,6,0,0,3732,1849,1749,47,3,1,0,0,3649,7381
36,Modena,33,2570,1238,21,0,3,0,0,3832,1935,1884,72,7,2,0,0,3900,7732
36,Modena,34,2488,1486,41,0,0,0,0,4015,1832,2117,87,2,4,0,0,4042,8057
36,Modena,35,2421,1652,57,0,1,0,0,4131,1647,2287,107,3,2,0,0,4046,8177
36,Modena,36,2445,1788,61,1,0,0,0,4295,1708,2279,117,11,4,0,0,4119,8414
36,Modena,37,2258,1944,60,3,2,0,0,4267,1594,2535,119,12,1,0,0,4261,8528
36,Modena,38,2218,2186,79,2,4,0,0,4489,1605,2678,153,18,2,0,0,4456,8945
36,Modena,39,2158,2286,88,0,4,0,0,4536,1615,2798,198,13,2,0,0,4626,9162
36,Modena,40,2299,2508,123,3,3,0,0,4936,1664,2946,200,22,3,0,0,4835,9771
36,Modena,41,2268,2741,153,6,1,0,0,5169,1696,3096,270,29,0,0,0,5091,10260
36,Modena,42,2310,2752,161,6,3,0,0,5232,1723,3320,289,38,4,0,0,5374,10606
36,Modena,43,2253,3250,217,10,4,0,0,5734,1706,3585,317,34,1,0,0,5643,11377
36,Modena,44,2499,3381,209,7,2,0,0,6098,1737,3645,392,50,4,0,0,5828,11926
36,Modena,45,2220,3529,244,9,7,0,0,6009,1626,3823,410,52,6,0,0,5917,11926
36,Modena,46,2072,3600,283,16,3,0,0,5974,1512,3840,435,58,3,0,0,5848,11822
36,Modena,47,1920,3673,332,16,5,0,0,5946,1535,3866,512,68,4,0,0,5985,11931
36,Modena,48,1773,3594,381,21,7,0,0,5776,1419,3687,447,73,3,0,0,5629,11405
36,Modena,49,1740,3773,356,19,2,0,0,5890,1317,3901,467,87,6,0,0,5778,11668
36,Modena,50,1624,3766,388,27,3,0,0,5808,1199,3829,526,109,1,0,0,5664,11472
36,Modena,51,1468,3835,452,26,0,0,0,5781,1154,3921,524,116,1,0,0,5716,11497
36,Modena,52,1401,3825,427,28,3,0,0,5684,1136,3835,572,144,3,0,0,5690,11374
36,Modena,53,1235,3942,406,46,8,0,0,5637,1063,3859,529,170,0,0,0,5621,11258
36,Modena,54,1160,3962,432,49,1,0,0,5604,949,3988,534,183,3,0,0,5657,11261
36,Modena,55,1015,3874,384,56,3,0,0,5332,960,3836,544,155,2,0,0,5497,10829
36,Modena,56,926,3621,402,49,5,0,0,5003,883,3764,478,188,0,1,0,5314,10317
36,Modena,57,863,3722,400,46,3,0,0,5034,868,3680,496,257,2,0,0,5303,10337
36,Modena,58,796,3538,376,61,4,0,0,4775,756,3530,488,241,2,0,0,5017,9792
36,Modena,59,688,3465,375,68,2,0,0,4598,802,3489,430,278,2,0,0,5001,9599
36,Modena,60,575,3375,313,61,4,0,0,4328,667,3222,395,302,2,1,0,4589,8917
36,Modena,61,559,3321,324,76,6,0,0,4286,634,3331,386,367,1,0,0,4719,9005
36,Modena,62,526,3336,305,81,5,0,0,4253,568,3358,380,386,0,0,0,4692,8945
36,Modena,63,484,3288,285,102,3,0,0,4162,552,3086,330,366,1,0,0,4335,8497
36,Modena,64,419,3180,246,105,3,0,0,3953,516,3122,327,464,0,0,0,4429,8382
36,Modena,65,376,2959,230,106,2,0,1,3674,445,2999,307,443,0,0,0,4194,7868
36,Modena,66,355,2915,204,115,1,0,0,3590,437,2926,273,534,0,0,0,4170,7760
36,Modena,67,380,2862,173,150,2,0,0,3567,341,2835,244,545,1,0,0,3966,7533
36,Modena,68,326,2995,181,154,0,0,0,3656,340,2975,265,671,1,0,0,4252,7908
36,Modena,69,303,3186,210,186,0,0,0,3885,336,2987,254,767,1,0,0,4345,8230
36,Modena,70,338,3302,168,193,2,0,0,4003,322,2985,264,811,1,0,0,4383,8386
36,Modena,71,268,3269,181,213,1,0,0,3932,266,2982,243,857,0,0,0,4348,8280
36,Modena,72,267,3294,145,240,2,0,0,3948,269,2927,190,985,0,0,0,4371,8319
36,Modena,73,186,2173,102,205,1,0,0,2667,167,2011,122,835,0,0,0,3135,5802
36,Modena,74,201,2432,103,196,0,0,0,2932,179,2174,131,999,1,0,0,3484,6416
36,Modena,75,222,2465,81,228,0,0,0,2996,210,2090,131,1015,0,0,0,3446,6442
36,Modena,76,225,2259,89,243,2,0,0,2818,212,1843,99,1122,1,0,0,3277,6095
36,Modena,77,197,2272,73,276,0,0,0,2818,167,1770,115,1233,0,0,0,3285,6103
36,Modena,78,231,2234,79,328,0,0,0,2872,211,1838,97,1432,0,0,0,3578,6450
36,Modena,79,195,2115,72,352,0,0,0,2734,182,1678,83,1575,2,0,0,3520,6254
36,Modena,80,208,2111,60,315,0,0,0,2694,176,1529,71,1665,0,0,0,3441,6135
36,Modena,81,166,1759,33,355,0,0,0,2313,159,1213,63,1602,0,0,0,3037,5350
36,Modena,82,152,1550,34,321,0,0,0,2057,128,1036,66,1584,0,0,0,2814,4871
36,Modena,83,148,1547,22,343,1,0,0,2061,133,906,54,1755,0,0,0,2848,4909
36,Modena,84,150,1363,23,385,0,0,0,1921,148,787,37,1786,0,0,0,2758,4679
36,Modena,85,106,1121,11,341,1,0,0,1580,136,629,36,1627,0,0,0,2428,4008
36,Modena,86,118,956,17,330,0,0,0,1421,114,462,22,1581,0,0,0,2179,3600
36,Modena,87,112,810,3,322,0,0,0,1247,103,377,29,1603,0,0,0,2112,3359
36,Modena,88,78,668,9,303,1,0,0,1059,104,291,36,1533,0,0,0,1964,3023
36,Modena,89,61,538,6,275,0,0,0,880,90,188,8,1365,0,0,0,1651,2531
36,Modena,90,57,405,3,238,0,0,0,703,89,134,11,1278,0,0,0,1512,2215
36,Modena,91,41,292,2,202,0,0,0,537,62,97,15,1143,0,0,0,1317,1854
36,Modena,92,32,223,1,170,0,0,0,426,63,67,6,966,0,0,0,1102,1528
36,Modena,93,19,141,1,134,0,0,0,295,66,45,9,854,0,0,0,974,1269
36,Modena,94,20,107,0,128,0,0,0,255,45,30,3,636,0,0,0,714,969
36,Modena,95,10,66,0,100,0,0,0,176,44,11,4,514,0,0,0,573,749
36,Modena,96,9,29,0,76,0,0,0,114,22,10,2,402,0,0,0,436,550
36,Modena,97,9,30,0,60,0,0,0,99,24,5,1,290,0,0,0,320,419
36,Modena,98,6,17,0,32,0,0,0,55,10,3,2,190,0,0,0,205,260
36,Modena,99,4,7,0,20,0,0,0,31,6,0,0,94,0,0,0,100,131
36,Modena,100,0,8,0,15,0,0,0,23,10,1,3,114,0,0,0,128,151
37,Bologna,0,3879,0,0,0,0,0,0,3879,3661,0,0,0,0,0,0,3661,7540
37,Bologna,1,3950,0,0,0,0,0,0,3950,3729,0,0,0,0,0,0,3729,7679
37,Bologna,2,4166,0,0,0,0,0,0,4166,3910,0,0,0,0,0,0,3910,8076
37,Bologna,3,4288,0,0,0,0,0,0,4288,4040,0,0,0,0,0,0,4040,8328
37,Bologna,4,4390,0,0,0,0,0,0,4390,4203,0,0,0,0,0,0,4203,8593
37,Bologna,5,4320,0,0,0,0,0,0,4320,4257,0,0,0,0,0,0,4257,8577
37,Bologna,6,4499,0,0,0,0,0,0,4499,4251,0,0,0,0,0,0,4251,8750
37,Bologna,7,4571,0,0,0,0,0,0,4571,4359,0,0,0,0,0,0,4359,8930
37,Bologna,8,4672,0,0,0,0,0,0,4672,4313,0,0,0,0,0,0,4313,8985
37,Bologna,9,4826,0,0,0,0,0,0,4826,4587,0,0,0,0,0,0,4587,9413
37,Bologna,10,4663,0,0,0,0,0,0,4663,4434,0,0,0,0,0,0,4434,9097
37,Bologna,11,4750,0,0,0,0,0,0,4750,4465,0,0,0,0,0,0,4465,9215
37,Bologna,12,4814,0,0,0,0,0,0,4814,4404,0,0,0,0,0,0,4404,9218
37,Bologna,13,4649,0,0,0,0,0,0,4649,4309,0,0,0,0,0,0,4309,8958
37,Bologna,14,4641,0,0,0,0,0,0,4641,4344,0,0,0,0,0,0,4344,8985
37,Bologna,15,4429,0,0,0,0,0,0,4429,4163,0,0,0,0,0,0,4163,8592
37,Bologna,16,4536,0,0,0,0,0,0,4536,4202,0,0,0,0,0,0,4202,8738
37,Bologna,17,4578,0,0,0,0,0,0,4578,4221,0,0,0,0,0,0,4221,8799
37,Bologna,18,4694,0,0,0,0,0,0,4694,4217,8,0,0,0,0,0,4225,8919
37,Bologna,19,4601,14,0,0,0,0,0,4615,4187,29,0,0,0,0,0,4216,8831
37,Bologna,20,4593,31,0,0,0,0,0,4624,3926,92,0,0,0,0,0,4018,8642
37,Bologna,21,4512,29,2,0,1,0,0,4544,3916,144,1,0,0,0,0,4061,8605
37,Bologna,22,4394,51,0,0,0,0,0,4445,3985,204,2,0,0,0,0,4191,8636
37,Bologna,23,4383,115,0,0,1,0,0,4499,3746,296,2,0,0,0,0,4044,8543
37,Bologna,24,4401,124,1,0,0,0,0,4526,3878,393,7,1,0,0,0,4279,8805
37,Bologna,25,4454,177,4,0,1,0,0,4636,3741,543,5,0,1,0,0,4290,8926
37,Bologna,26,4548,295,4,0,1,0,0,4848,4006,809,10,2,3,0,0,4830,9678
37,Bologna,27,4533,394,7,0,0,0,0,4934,3785,950,17,4,1,0,0,4757,9691
37,Bologna,28,4640,550,4,0,3,0,0,5197,3808,1242,23,1,4,0,0,5078,10275
37,Bologna,29,4420,748,11,0,4,0,0,5183,3596,1469,32,1,6,0,0,5104,10287
37,Bologna,30,4351,958,8,1,3,0,0,5321,3544,1783,42,3,3,0,0,5375,10696
37,Bologna,31,4208,1241,26,1,3,0,0,5479,3244,2115,46,3,8,1,0,5417,10896
37,Bologna,32,3797,1503,22,1,8,0,0,5331,3190,2432,58,4,4,0,0,5688,11019
37,Bologna,33,3925,1786,33,0,6,0,0,5750,3083,2657,83,7,3,0,0,5833,11583
37,Bologna,34,3867,2050,47,0,4,0,0,5968,3025,2859,106,5,7,0,0,6002,11970
37,Bologna,35,3772,2311,54,2,6,0,0,6145,3031,3016,126,9,9,0,0,6191,12336
37,Bologna,36,3586,2496,62,2,7,0,0,6153,2880,3197,135,18,8,0,0,6238,12391
37,Bologna,37,3364,2815,88,2,13,0,0,6282,2726,3319,164,17,8,0,0,6234,12516
37,Bologna,38,3502,3013,89,6,10,0,0,6620,2679,3537,213,23,6,1,0,6459,13079
37,Bologna,39,3362,3101,105,2,7,0,0,6577,2753,3855,223,29,4,0,0,6864,13441
37,Bologna,40,3390,3539,147,10,9,0,0,7095,2782,3975,252,32,6,0,0,7047,14142
37,Bologna,41,3487,3554,143,9,5,0,0,7198,2857,4088,289,44,11,0,0,7289,14487
37,Bologna,42,3527,3949,182,5,9,0,1,7673,2852,4419,332,44,11,0,0,7658,15331
37,Bologna,43,3528,4052,218,19,15,0,1,7833,2943,4702,415,50,8,0,0,8118,15951
37,Bologna,44,3614,4224,246,15,14,0,0,8113,2897,4860,421,68,4,0,1,8251,16364
37,Bologna,45,3444,4580,286,15,15,0,0,8340,2877,4980,517,69,6,0,0,8449,16789
37,Bologna,46,3302,4574,359,19,17,0,0,8271,2804,4999,555,86,6,0,0,8450,16721
37,Bologna,47,3200,4971,380,27,14,0,0,8592,2691,5287,585,77,11,0,0,8651,17243
37,Bologna,48,2931,4926,409,30,21,0,0,8317,2505,5354,641,101,6,0,0,8607,16924
37,Bologna,49,2831,5074,438,27,19,0,0,8389,2428,5354,677,132,7,0,0,8598,16987
37,Bologna,50,2653,4977,480,42,5,0,0,8157,2256,5390,700,170,9,0,1,8526,16683
37,Bologna,51,2425,5045,503,57,14,0,0,8044,2211,5400,748,176,1,0,1,8537,16581
37,Bologna,52,2394,5131,538,51,17,0,0,8131,2074,5370,792,178,6,0,0,8420,16551
37,Bologna,53,2130,5232,611,63,8,0,0,8044,1881,5487,809,235,2,0,1,8415,16459
37,Bologna,54,2130,5460,585,73,13,0,1,8262,1871,5652,879,235,7,0,0,8644,16906
37,Bologna,55,1765,5128,571,60,15,0,0,7539,1665,5079,834,224,4,0,0,7806,15345
37,Bologna,56,1580,5028,596,73,8,0,1,7286,1480,5175,817,274,5,1,0,7752,15038
37,Bologna,57,1465,4915,506,81,11,0,0,6978,1386,5146,741,298,4,0,1,7576,14554
37,Bologna,58,1266,4744,551,92,13,0,0,6666,1329,4971,794,313,1,0,0,7408,14074
37,Bologna,59,1175,4859,588,103,10,0,0,6735,1261,4829,697,391,4,0,1,7183,13918
37,Bologna,60,1056,4658,533,112,11,0,0,6370,1081,4810,726,415,3,0,0,7035,13405
37,Bologna,61,956,4719,524,106,6,0,0,6311,1032,4647,688,420,4,0,0,6791,13102
37,Bologna,62,870,4542,484,126,6,0,0,6028,963,4589,645,522,3,0,0,6722,12750
37,Bologna,63,811,4328,457,151,7,0,0,5754,898,4457,635,526,3,0,0,6519,12273
37,Bologna,64,729,4344,391,144,7,0,0,5615,782,4387,612,603,4,0,0,6388,12003
37,Bologna,65,654,4211,361,175,2,0,0,5403,685,4161,576,643,1,0,0,6066,11469
37,Bologna,66,603,4054,382,192,9,0,0,5240,660,4170,523,698,1,0,0,6052,11292
37,Bologna,67,550,3989,375,183,3,0,0,5100,602,4021,491,779,1,0,0,5894,10994
37,Bologna,68,515,4204,330,211,4,0,0,5264,559,4226,478,858,2,0,0,6123,11387
37,Bologna,69,445,4364,319,262,3,0,0,5393,510,4176,479,978,1,0,0,6144,11537
37,Bologna,70,473,4612,316,319,5,0,0,5725,461,4551,501,1198,1,0,0,6712,12437
37,Bologna,71,451,4721,309,338,0,0,0,5819,432,4524,429,1312,0,0,0,6697,12516
37,Bologna,72,431,4844,297,399,2,0,0,5973,415,4417,459,1605,0,0,0,6896,12869
37,Bologna,73,288,3146,193,291,0,0,0,3918,264,2900,274,1159,1,0,0,4598,8516
37,Bologna,74,339,3615,178,339,0,0,0,4471,325,3228,287,1422,1,0,0,5263,9734
37,Bologna,75,303,3561,180,391,0,0,0,4435,301,3094,266,1587,0,0,0,5248,9683
37,Bologna,76,271,3412,144,394,1,0,0,4222,333,3005,258,1663,0,0,0,5259,9481
37,Bologna,77,325,3381,154,454,3,0,0,4317,331,2886,239,1934,0,0,0,5390,9707
37,Bologna,78,340,3598,137,545,1,0,0,4621,333,3055,245,2243,0,0,0,5876,10497
37,Bologna,79,329,3453,132,605,1,0,0,4520,318,2727,213,2465,0,0,0,5723,10243
37,Bologna,80,251,3174,98,566,1,0,0,4090,302,2482,189,2613,0,0,0,5586,9676
37,Bologna,81,228,2858,93,546,0,0,0,3725,250,2032,157,2474,1,0,0,4914,8639
37,Bologna,82,180,2456,66,598,1,0,0,3301,261,1677,120,2430,0,0,0,4488,7789
37,Bologna,83,184,2337,59,573,1,0,0,3154,239,1502,116,2737,0,0,0,4594,7748
37,Bologna,84,189,2016,61,606,0,0,0,2872,218,1284,99,2664,0,0,0,4265,7137
37,Bologna,85,132,1771,54,618,0,0,0,2575,237,1002,85,2639,0,0,0,3963,6538
37,Bologna,86,148,1517,39,577,0,0,0,2281,194,799,64,2548,0,0,0,3605,5886
37,Bologna,87,110,1355,28,566,0,0,0,2059,222,615,63,2444,0,0,0,3344,5403
37,Bologna,88,128,1123,20,531,0,0,0,1802,195,513,63,2561,0,0,0,3332,5134
37,Bologna,89,67,897,12,462,0,0,0,1438,172,387,28,2248,0,0,0,2835,4273
37,Bologna,90,60,673,17,427,0,0,0,1177,178,256,34,1994,0,0,0,2462,3639
37,Bologna,91,59,514,9,427,0,0,0,1009,131,190,19,1851,0,0,0,2191,3200
37,Bologna,92,41,380,4,319,0,0,0,744,114,123,21,1539,0,0,0,1797,2541
37,Bologna,93,31,275,4,255,0,0,0,565,124,67,25,1313,0,0,0,1529,2094
37,Bologna,94,17,182,5,202,0,0,0,406,99,60,17,1053,0,0,0,1229,1635
37,Bologna,95,22,122,2,171,0,0,0,317,68,43,9,876,0,0,0,996,1313
37,Bologna,96,11,70,3,115,0,0,0,199,61,20,8,695,0,0,0,784,983
37,Bologna,97,9,57,4,99,0,0,0,169,39,11,5,497,0,0,0,552,721
37,Bologna,98,5,21,1,65,0,0,0,92,33,7,2,358,0,0,0,400,492
37,Bologna,99,0,18,1,35,0,0,0,54,14,1,2,183,0,0,0,200,254
37,Bologna,100,1,10,0,33,0,0,0,44,34,1,2,262,0,0,0,299,343
38,Ferrara,0,1007,0,0,0,0,0,0,1007,982,0,0,0,0,0,0,982,1989
38,Ferrara,1,1055,0,0,0,0,0,0,1055,1014,0,0,0,0,0,0,1014,2069
38,Ferrara,2,1063,0,0,0,0,0,0,1063,1094,0,0,0,0,0,0,1094,2157
38,Ferrara,3,1079,0,0,0,0,0,0,1079,1081,0,0,0,0,0,0,1081,2160
38,Ferrara,4,1189,0,0,0,0,0,0,1189,1160,0,0,0,0,0,0,1160,2349
38,Ferrara,5,1224,0,0,0,0,0,0,1224,1212,0,0,0,0,0,0,1212,2436
38,Ferrara,6,1308,0,0,0,0,0,0,1308,1268,0,0,0,0,0,0,1268,2576
38,Ferrara,7,1374,0,0,0,0,0,0,1374,1319,0,0,0,0,0,0,1319,2693
38,Ferrara,8,1402,0,0,0,0,0,0,1402,1354,0,0,0,0,0,0,1354,2756
38,Ferrara,9,1466,0,0,0,0,0,0,1466,1387,0,0,0,0,0,0,1387,2853
38,Ferrara,10,1456,0,0,0,0,0,0,1456,1386,0,0,0,0,0,0,1386,2842
38,Ferrara,11,1430,0,0,0,0,0,0,1430,1327,0,0,0,0,0,0,1327,2757
38,Ferrara,12,1455,0,0,0,0,0,0,1455,1292,0,0,0,0,0,0,1292,2747
38,Ferrara,13,1442,0,0,0,0,0,0,1442,1307,0,0,0,0,0,0,1307,2749
38,Ferrara,14,1395,0,0,0,0,0,0,1395,1285,0,0,0,0,0,0,1285,2680
38,Ferrara,15,1319,0,0,0,0,0,0,1319,1320,0,0,0,0,0,0,1320,2639
38,Ferrara,16,1319,0,0,0,0,0,0,1319,1331,0,0,0,0,0,0,1331,2650
38,Ferrara,17,1314,0,0,0,0,0,0,1314,1285,0,0,0,0,0,0,1285,2599
38,Ferrara,18,1320,0,0,0,0,0,0,1320,1284,4,0,0,0,0,0,1288,2608
38,Ferrara,19,1413,0,0,0,0,0,0,1413,1225,4,0,0,0,0,0,1229,2642
38,Ferrara,20,1599,1,0,0,0,0,0,1600,1183,21,0,0,0,0,0,1204,2804
38,Ferrara,21,1460,3,0,0,0,0,0,1463,1250,27,0,0,0,0,0,1277,2740
38,Ferrara,22,1439,4,0,0,0,0,0,1443,1246,41,0,0,0,0,0,1287,2730
38,Ferrara,23,1385,14,0,0,0,0,0,1399,1247,72,1,0,0,0,0,1320,2719
38,Ferrara,24,1416,22,1,0,0,0,0,1439,1222,93,2,0,0,0,0,1317,2756
38,Ferrara,25,1389,37,1,0,0,0,0,1427,1226,132,1,1,0,0,0,1360,2787
38,Ferrara,26,1490,57,0,0,0,0,0,1547,1180,167,3,1,0,0,0,1351,2898
38,Ferrara,27,1462,87,1,0,3,0,0,1553,1234,221,7,1,0,0,0,1463,3016
38,Ferrara,28,1410,143,1,0,1,0,0,1555,1155,324,13,1,0,0,0,1493,3048
38,Ferrara,29,1354,167,2,1,0,0,0,1524,1077,394,15,1,0,0,0,1487,3011
38,Ferrara,30,1265,255,3,0,1,0,0,1524,1079,448,18,2,0,0,0,1547,3071
38,Ferrara,31,1220,288,1,0,2,0,0,1511,938,533,8,1,1,0,0,1481,2992
38,Ferrara,32,1245,359,10,0,0,0,0,1614,946,607,24,3,0,0,0,1580,3194
38,Ferrara,33,1253,439,12,0,0,0,0,1704,883,704,26,1,1,0,0,1615,3319
38,Ferrara,34,1179,518,13,0,2,1,0,1713,862,775,37,6,1,0,0,1681,3394
38,Ferrara,35,1187,582,12,1,2,0,0,1784,903,830,35,5,1,0,0,1774,3558
38,Ferrara,36,1050,698,20,0,0,0,0,1768,823,907,57,4,1,0,0,1792,3560
38,Ferrara,37,1069,716,32,0,2,0,0,1819,828,914,67,6,1,0,0,1816,3635
38,Ferrara,38,1103,755,33,0,1,0,0,1892,853,984,67,7,3,0,0,1914,3806
38,Ferrara,39,1167,835,51,0,1,0,0,2054,874,1091,96,9,2,0,0,2072,4126
38,Ferrara,40,1241,915,56,1,2,0,0,2215,910,1232,97,10,1,0,0,2250,4465
38,Ferrara,41,1238,1079,66,2,3,0,0,2388,959,1256,137,17,0,0,0,2369,4757
38,Ferrara,42,1265,1147,105,3,1,0,0,2521,923,1408,157,15,0,0,0,2503,5024
38,Ferrara,43,1242,1248,79,5,1,0,0,2575,952,1508,170,11,0,0,0,2641,5216
38,Ferrara,44,1291,1441,108,4,0,0,0,2844,973,1642,190,19,0,0,0,2824,5668
38,Ferrara,45,1240,1453,138,4,3,0,0,2838,896,1611,212,16,3,0,0,2738,5576
38,Ferrara,46,1249,1518,139,3,2,0,0,2911,861,1752,211,31,6,0,0,2861,5772
38,Ferrara,47,1125,1504,175,10,6,0,0,2820,862,1715,207,41,1,0,0,2826,5646
38,Ferrara,48,1027,1589,172,9,3,0,0,2800,775,1812,254,36,2,0,0,2879,5679
38,Ferrara,49,1056,1673,192,6,2,0,0,2929,744,1838,293,57,1,0,0,2933,5862
38,Ferrara,50,948,1713,202,10,1,0,0,2874,678,1946,279,49,1,0,0,2953,5827
38,Ferrara,51,854,1704,229,19,2,0,0,2808,583,1892,276,83,2,0,1,2837,5645
38,Ferrara,52,862,1870,232,17,4,0,0,2985,565,1929,313,67,0,0,0,2874,5859
38,Ferrara,53,754,1840,240,23,4,0,0,2861,493,2025,308,92,1,0,0,2919,5780
38,Ferrara,54,693,1867,260,22,3,0,0,2845,509,2054,312,116,2,0,0,2993,5838
38,Ferrara,55,617,1891,265,18,1,0,0,2792,493,2066,282,93,0,0,0,2934,5726
38,Ferrara,56,563,1863,242,31,3,0,0,2702,413,1957,312,130,1,0,0,2813,5515
38,Ferrara,57,465,1835,240,35,1,0,0,2576,347,2068,295,135,1,0,0,2846,5422
38,Ferrara,58,445,1906,223,37,0,0,0,2611,283,2025,296,169,1,0,0,2774,5385
38,Ferrara,59,401,1890,222,43,0,0,0,2556,335,2044,293,164,0,0,0,2836,5392
38,Ferrara,60,350,1849,211,45,4,0,0,2459,251,1868,241,216,0,0,0,2576,5035
38,Ferrara,61,353,1852,214,52,0,0,0,2471,266,1991,254,215,0,0,0,2726,5197
38,Ferrara,62,272,1854,195,63,0,0,0,2384,234,1982,262,247,0,0,0,2725,5109
38,Ferrara,63,275,1774,196,50,1,0,0,2296,201,1871,214,236,0,0,0,2522,4818
38,Ferrara,64,242,1720,172,71,2,0,0,2207,200,1849,203,286,2,0,0,2540,4747
38,Ferrara,65,201,1776,147,73,0,0,0,2197,179,1779,194,283,0,0,0,2435,4632
38,Ferrara,66,184,1739,128,74,1,0,0,2126,146,1796,174,359,1,0,0,2476,4602
38,Ferrara,67,203,1725,111,98,1,0,0,2138,140,1700,153,374,0,0,0,2367,4505
38,Ferrara,68,170,1819,140,101,0,0,0,2230,128,1804,149,421,0,0,0,2502,4732
38,Ferrara,69,147,1760,107,118,0,0,0,2132,113,1744,151,475,0,0,0,2483,4615
38,Ferrara,70,143,1870,119,129,0,0,0,2261,128,1893,153,535,0,0,0,2709,4970
38,Ferrara,71,169,2036,89,150,0,1,0,2445,116,1803,122,639,0,0,0,2680,5125
38,Ferrara,72,153,1981,90,170,1,0,0,2395,117,1791,118,747,0,0,0,2773,5168
38,Ferrara,73,78,1240,57,128,0,0,0,1503,78,1074,77,487,0,0,0,1716,3219
38,Ferrara,74,114,1514,64,160,0,0,0,1852,92,1252,72,659,0,0,0,2075,3927
38,Ferrara,75,106,1389,48,174,0,0,0,1717,105,1185,67,711,0,0,0,2068,3785
38,Ferrara,76,97,1323,50,184,0,0,0,1654,108,1123,49,720,0,0,0,2000,3654
38,Ferrara,77,103,1302,39,164,0,0,0,1608,99,1023,60,831,0,0,0,2013,3621
38,Ferrara,78,111,1375,35,205,0,0,0,1726,103,1129,69,1031,0,0,0,2332,4058
38,Ferrara,79,87,1292,33,242,1,0,0,1655,103,997,57,1020,0,0,0,2177,3832
38,Ferrara,80,78,1239,22,229,0,0,0,1568,101,921,60,1112,0,0,0,2194,3762
38,Ferrara,81,82,1088,18,238,0,0,0,1426,77,768,43,1102,0,0,0,1990,3416
38,Ferrara,82,86,887,24,227,0,0,0,1224,68,590,46,1075,0,0,0,1779,3003
38,Ferrara,83,71,894,25,269,0,0,0,1259,85,540,26,1140,0,0,0,1791,3050
38,Ferrara,84,61,859,14,259,0,0,0,1193,74,481,25,1160,0,0,0,1740,2933
38,Ferrara,85,40,694,7,249,0,0,0,990,70,361,19,1154,0,0,0,1604,2594
38,Ferrara,86,39,529,10,198,0,0,0,776,45,278,21,1126,0,0,0,1470,2246
38,Ferrara,87,37,487,5,237,0,0,0,766,55,212,23,1101,0,0,0,1391,2157
38,Ferrara,88,32,408,8,214,0,0,0,662,51,175,12,968,0,0,0,1206,1868
38,Ferrara,89,27,265,2,173,0,0,0,467,42,121,7,793,0,0,0,963,1430
38,Ferrara,90,17,232,4,141,0,0,0,394,52,70,8,758,0,0,0,888,1282
38,Ferrara,91,8,151,2,132,0,0,0,293,46,54,10,638,0,0,0,748,1041
38,Ferrara,92,6,97,0,94,0,0,0,197,32,34,8,558,0,0,0,632,829
38,Ferrara,93,4,85,2,117,0,0,0,208,26,21,3,469,0,0,0,519,727
38,Ferrara,94,6,58,1,74,0,0,0,139,25,11,4,366,0,0,0,406,545
38,Ferrara,95,2,42,0,59,0,0,0,103,23,10,4,290,0,0,0,327,430
38,Ferrara,96,1,25,0,35,0,0,0,61,11,3,1,226,0,0,0,241,302
38,Ferrara,97,1,13,0,28,0,0,0,42,13,3,0,177,0,0,0,193,235
38,Ferrara,98,1,4,1,23,0,0,0,29,9,0,0,120,0,0,0,129,158
38,Ferrara,99,0,2,0,13,0,0,0,15,5,2,0,51,0,0,0,58,73
38,Ferrara,100,2,3,0,12,0,0,0,17,6,0,0,67,0,0,0,73,90
39,Ravenna,0,1410,0,0,0,0,0,0,1410,1268,0,0,0,0,0,0,1268,2678
39,Ravenna,1,1455,0,0,0,0,0,0,1455,1338,0,0,0,0,0,0,1338,2793
39,Ravenna,2,1474,0,0,0,0,0,0,1474,1363,0,0,0,0,0,0,1363,2837
39,Ravenna,3,1554,0,0,0,0,0,0,1554,1435,0,0,0,0,0,0,1435,2989
39,Ravenna,4,1600,0,0,0,0,0,0,1600,1494,0,0,0,0,0,0,1494,3094
39,Ravenna,5,1593,0,0,0,0,0,0,1593,1535,0,0,0,0,0,0,1535,3128
39,Ravenna,6,1765,0,0,0,0,0,0,1765,1564,0,0,0,0,0,0,1564,3329
39,Ravenna,7,1781,0,0,0,0,0,0,1781,1600,0,0,0,0,0,0,1600,3381
39,Ravenna,8,1813,0,0,0,0,0,0,1813,1718,0,0,0,0,0,0,1718,3531
39,Ravenna,9,1883,0,0,0,0,0,0,1883,1750,0,0,0,0,0,0,1750,3633
39,Ravenna,10,1870,0,0,0,0,0,0,1870,1780,0,0,0,0,0,0,1780,3650
39,Ravenna,11,1836,0,0,0,0,0,0,1836,1728,0,0,0,0,0,0,1728,3564
39,Ravenna,12,1889,0,0,0,0,0,0,1889,1782,0,0,0,0,0,0,1782,3671
39,Ravenna,13,1776,0,0,0,0,0,0,1776,1663,0,0,0,0,0,0,1663,3439
39,Ravenna,14,1745,0,0,0,0,0,0,1745,1662,0,0,0,0,0,0,1662,3407
39,Ravenna,15,1797,0,0,0,0,0,0,1797,1611,0,0,0,0,0,0,1611,3408
39,Ravenna,16,1727,0,0,0,0,0,0,1727,1649,0,0,0,0,0,0,1649,3376
39,Ravenna,17,1740,0,0,0,0,0,0,1740,1627,0,0,0,0,0,0,1627,3367
39,Ravenna,18,1784,0,0,0,0,0,0,1784,1581,5,0,0,0,0,0,1586,3370
39,Ravenna,19,1786,1,0,0,0,0,0,1787,1517,10,0,0,0,0,0,1527,3314
39,Ravenna,20,1853,2,0,0,0,0,0,1855,1501,36,0,0,0,0,0,1537,3392
39,Ravenna,21,1839,7,1,0,0,0,0,1847,1525,73,0,0,0,0,0,1598,3445
39,Ravenna,22,1810,14,0,0,1,0,0,1825,1499,114,0,0,1,0,0,1614,3439
39,Ravenna,23,1761,22,0,0,1,0,0,1784,1432,138,2,0,1,0,0,1573,3357
39,Ravenna,24,1751,46,0,0,0,0,0,1797,1434,189,2,0,2,0,0,1627,3424
39,Ravenna,25,1619,67,0,0,0,0,0,1686,1400,240,4,0,0,0,0,1644,3330
39,Ravenna,26,1705,124,0,0,0,0,0,1829,1407,295,5,0,0,0,0,1707,3536
39,Ravenna,27,1652,178,1,0,0,0,0,1831,1304,375,7,0,0,0,0,1686,3517
39,Ravenna,28,1591,239,2,0,0,0,0,1832,1235,444,9,2,0,0,0,1690,3522
39,Ravenna,29,1494,302,3,0,0,0,0,1799,1193,528,17,2,1,0,0,1741,3540
39,Ravenna,30,1506,383,13,0,1,0,0,1903,1123,608,18,2,0,0,0,1751,3654
39,Ravenna,31,1363,456,15,0,0,0,0,1834,1089,719,24,2,0,0,0,1834,3668
39,Ravenna,32,1422,533,8,1,3,0,0,1967,1106,836,29,2,2,0,0,1975,3942
39,Ravenna,33,1283,599,18,0,0,0,0,1900,1025,890,47,4,1,0,0,1967,3867
39,Ravenna,34,1238,663,15,1,1,0,0,1918,919,962,64,5,0,0,0,1950,3868
39,Ravenna,35,1246,762,22,1,2,0,0,2033,1014,994,66,5,1,0,0,2080,4113
39,Ravenna,36,1238,850,35,1,2,0,0,2126,964,1161,79,7,3,0,0,2214,4340
39,Ravenna,37,1139,941,43,0,3,0,0,2126,928,1214,71,4,1,0,0,2218,4344
39,Ravenna,38,1252,999,53,2,1,0,0,2307,889,1291,95,11,1,0,0,2287,4594
39,Ravenna,39,1276,1076,61,2,1,0,0,2416,1013,1318,113,12,1,0,0,2457,4873
39,Ravenna,40,1273,1191,78,2,4,0,0,2548,1008,1452,144,18,2,0,0,2624,5172
39,Ravenna,41,1326,1328,88,1,1,0,0,2744,1073,1638,150,14,3,0,0,2878,5622
39,Ravenna,42,1331,1454,77,5,5,0,0,2872,1097,1561,165,20,4,0,0,2847,5719
39,Ravenna,43,1402,1605,129,3,2,0,0,3141,1072,1778,205,16,2,0,0,3073,6214
39,Ravenna,44,1404,1640,140,2,3,0,0,3189,1090,1841,243,24,2,0,0,3200,6389
39,Ravenna,45,1338,1629,144,2,3,0,0,3116,1064,1915,253,38,4,0,0,3274,6390
39,Ravenna,46,1318,1790,159,8,3,0,0,3278,1031,1931,269,49,3,0,0,3283,6561
39,Ravenna,47,1212,1815,192,10,5,0,0,3234,954,1950,288,41,2,0,0,3235,6469
39,Ravenna,48,1177,1798,202,17,2,0,0,3196,974,1997,317,54,2,0,0,3344,6540
39,Ravenna,49,1110,1869,221,9,3,0,0,3212,865,2100,320,65,3,0,0,3353,6565
39,Ravenna,50,1111,1973,250,12,9,0,0,3355,849,2027,307,52,2,0,0,3237,6592
39,Ravenna,51,1032,2009,265,13,4,0,0,3323,776,2017,343,70,1,0,0,3207,6530
39,Ravenna,52,921,2081,246,19,5,0,0,3272,802,2081,347,78,3,0,0,3311,6583
39,Ravenna,53,847,2013,269,14,1,0,0,3144,676,2091,382,113,0,0,0,3262,6406
39,Ravenna,54,873,2170,300,29,7,0,0,3379,688,2194,381,106,2,0,0,3371,6750
39,Ravenna,55,753,2037,294,30,3,0,0,3117,590,1964,372,122,0,0,0,3048,6165
39,Ravenna,56,591,2006,266,31,4,0,0,2898,530,2037,331,121,0,0,0,3019,5917
39,Ravenna,57,625,1957,284,35,4,0,0,2905,520,2051,332,126,2,0,0,3031,5936
39,Ravenna,58,513,1955,280,38,1,0,0,2787,466,1928,335,135,1,0,0,2865,5652
39,Ravenna,59,474,1900,254,38,2,0,0,2668,435,1879,306,160,1,0,0,2781,5449
39,Ravenna,60,425,1877,226,44,1,0,0,2573,411,1820,274,173,0,0,0,2678,5251
39,Ravenna,61,378,1779,228,53,1,0,0,2439,367,1854,299,206,0,0,0,2726,5165
39,Ravenna,62,376,1857,243,65,3,0,0,2544,343,1829,280,210,1,0,0,2663,5207
39,Ravenna,63,271,1835,203,49,2,0,0,2360,325,1769,246,206,0,0,0,2546,4906
39,Ravenna,64,271,1677,176,74,0,0,0,2198,266,1726,221,229,0,0,0,2442,4640
39,Ravenna,65,242,1656,183,72,0,0,1,2154,263,1591,218,247,1,0,0,2320,4474
39,Ravenna,66,238,1678,157,64,0,0,0,2137,232,1676,201,290,1,0,0,2400,4537
39,Ravenna,67,207,1655,160,74,2,0,0,2098,224,1579,194,318,0,0,0,2315,4413
39,Ravenna,68,214,1703,157,85,1,0,0,2160,213,1694,220,363,1,0,0,2491,4651
39,Ravenna,69,182,1732,156,97,1,0,0,2168,182,1742,179,414,1,0,0,2518,4686
39,Ravenna,70,177,1847,129,118,0,0,0,2271,198,1790,169,477,0,0,0,2634,4905
39,Ravenna,71,172,1839,134,141,0,0,0,2286,151,1625,129,542,0,0,0,2447,4733
39,Ravenna,72,180,1801,113,141,1,0,0,2236,157,1747,131,570,0,0,0,2605,4841
39,Ravenna,73,100,1243,89,123,0,0,0,1555,118,1164,112,472,0,0,0,1866,3421
39,Ravenna,74,130,1398,81,135,1,0,0,1745,103,1274,104,587,0,0,0,2068,3813
39,Ravenna,75,117,1326,65,138,0,0,0,1646,124,1165,87,638,0,0,0,2014,3660
39,Ravenna,76,127,1315,70,153,1,0,0,1666,118,1104,86,614,0,0,0,1922,3588
39,Ravenna,77,123,1311,60,154,1,0,0,1649,110,1090,88,672,0,0,0,1960,3609
39,Ravenna,78,137,1402,54,185,0,0,0,1778,136,1209,69,875,0,0,0,2289,4067
39,Ravenna,79,138,1407,47,206,0,0,0,1798,141,1149,67,942,0,0,0,2299,4097
39,Ravenna,80,135,1355,60,233,0,0,0,1783,134,986,60,1022,0,0,0,2202,3985
39,Ravenna,81,111,1165,39,223,0,0,0,1538,106,815,50,1004,0,0,0,1975,3513
39,Ravenna,82,85,969,23,216,0,0,0,1293,111,701,39,1019,0,0,0,1870,3163
39,Ravenna,83,102,1035,23,212,0,0,0,1372,76,642,49,1142,0,0,0,1909,3281
39,Ravenna,84,99,920,19,242,0,0,0,1280,107,549,39,1193,0,0,0,1888,3168
39,Ravenna,85,72,761,14,241,0,0,0,1088,99,427,38,1078,0,0,0,1642,2730
39,Ravenna,86,61,654,12,199,0,0,0,926,98,332,17,1021,0,0,0,1468,2394
39,Ravenna,87,51,588,8,212,0,0,0,859,88,261,16,971,0,0,0,1336,2195
39,Ravenna,88,60,489,6,219,0,0,0,774,103,194,23,1007,0,0,0,1327,2101
39,Ravenna,89,52,410,8,184,0,0,0,654,75,148,10,870,0,0,0,1103,1757
39,Ravenna,90,38,325,11,181,0,0,0,555,73,109,15,836,0,0,0,1033,1588
39,Ravenna,91,28,254,4,135,1,0,0,422,50,68,9,718,0,0,0,845,1267
39,Ravenna,92,15,169,1,122,0,0,0,307,56,51,7,650,0,0,0,764,1071
39,Ravenna,93,16,123,3,112,0,0,0,254,49,33,6,560,0,0,0,648,902
39,Ravenna,94,8,83,2,91,0,0,0,184,30,23,3,434,0,0,0,490,674
39,Ravenna,95,4,54,0,70,0,0,0,128,26,12,2,369,0,0,0,409,537
39,Ravenna,96,11,38,0,48,0,0,0,97,30,3,6,256,0,0,0,295,392
39,Ravenna,97,1,19,0,36,0,0,0,56,23,4,0,196,0,0,0,223,279
39,Ravenna,98,3,17,1,29,0,0,0,50,8,3,3,140,0,0,0,154,204
39,Ravenna,99,0,4,0,12,0,0,0,16,5,2,0,86,0,0,0,93,109
39,Ravenna,100,1,4,0,16,0,0,0,21,8,0,1,107,0,0,0,116,137
40,Forlì-Cesena,0,1487,0,0,0,0,0,0,1487,1368,0,0,0,0,0,0,1368,2855
40,Forlì-Cesena,1,1530,0,0,0,0,0,0,1530,1402,0,0,0,0,0,0,1402,2932
40,Forlì-Cesena,2,1559,0,0,0,0,0,0,1559,1517,0,0,0,0,0,0,1517,3076
40,Forlì-Cesena,3,1649,0,0,0,0,0,0,1649,1552,0,0,0,0,0,0,1552,3201
40,Forlì-Cesena,4,1722,0,0,0,0,0,0,1722,1611,0,0,0,0,0,0,1611,3333
40,Forlì-Cesena,5,1732,0,0,0,0,0,0,1732,1739,0,0,0,0,0,0,1739,3471
40,Forlì-Cesena,6,1788,0,0,0,0,0,0,1788,1732,0,0,0,0,0,0,1732,3520
40,Forlì-Cesena,7,1943,0,0,0,0,0,0,1943,1728,0,0,0,0,0,0,1728,3671
40,Forlì-Cesena,8,1973,0,0,0,0,0,0,1973,1732,0,0,0,0,0,0,1732,3705
40,Forlì-Cesena,9,1957,0,0,0,0,0,0,1957,1771,0,0,0,0,0,0,1771,3728
40,Forlì-Cesena,10,1932,0,0,0,0,0,0,1932,1808,0,0,0,0,0,0,1808,3740
40,Forlì-Cesena,11,1932,0,0,0,0,0,0,1932,1830,0,0,0,0,0,0,1830,3762
40,Forlì-Cesena,12,1897,0,0,0,0,0,0,1897,1875,0,0,0,0,0,0,1875,3772
40,Forlì-Cesena,13,1889,0,0,0,0,0,0,1889,1763,0,0,0,0,0,0,1763,3652
40,Forlì-Cesena,14,1903,0,0,0,0,0,0,1903,1780,0,0,0,0,0,0,1780,3683
40,Forlì-Cesena,15,1857,0,0,0,0,0,0,1857,1735,0,0,0,0,0,0,1735,3592
40,Forlì-Cesena,16,1836,0,0,0,0,0,0,1836,1710,0,0,0,0,0,0,1710,3546
40,Forlì-Cesena,17,1838,0,0,0,0,0,0,1838,1657,0,0,0,0,0,0,1657,3495
40,Forlì-Cesena,18,1925,0,0,0,0,0,0,1925,1675,1,0,0,0,0,0,1676,3601
40,Forlì-Cesena,19,1799,1,0,0,0,0,0,1800,1588,18,0,0,1,0,0,1607,3407
40,Forlì-Cesena,20,1904,2,0,0,0,0,0,1906,1645,27,0,0,0,0,0,1672,3578
40,Forlì-Cesena,21,1877,8,0,0,1,0,0,1886,1593,50,0,0,0,0,0,1643,3529
40,Forlì-Cesena,22,1811,8,0,0,0,0,0,1819,1610,94,0,0,0,0,0,1704,3523
40,Forlì-Cesena,23,1768,24,1,0,2,0,0,1795,1529,140,0,0,1,0,0,1670,3465
40,Forlì-Cesena,24,1819,45,1,0,0,0,0,1865,1529,160,1,1,0,0,0,1691,3556
40,Forlì-Cesena,25,1763,71,0,0,0,0,0,1834,1432,204,1,0,0,0,0,1637,3471
40,Forlì-Cesena,26,1808,103,0,0,0,0,0,1911,1528,273,7,1,0,0,0,1809,3720
40,Forlì-Cesena,27,1768,159,3,0,0,0,0,1930,1497,384,2,1,0,0,0,1884,3814
40,Forlì-Cesena,28,1700,262,1,0,0,0,0,1963,1455,470,8,1,0,0,0,1934,3897
40,Forlì-Cesena,29,1694,270,6,2,1,0,0,1973,1362,589,13,0,0,1,0,1965,3938
40,Forlì-Cesena,30,1587,363,6,0,1,0,0,1957,1178,678,15,0,0,0,0,1871,3828
40,Forlì-Cesena,31,1507,467,7,0,2,0,0,1983,1191,808,27,2,0,0,0,2028,4011
40,Forlì-Cesena,32,1436,567,14,0,0,0,0,2017,1029,917,23,3,0,0,0,1972,3989
40,Forlì-Cesena,33,1460,650,6,0,2,0,0,2118,1194,994,30,4,0,0,0,2222,4340
40,Forlì-Cesena,34,1305,762,17,0,2,0,0,2086,1039,1058,48,5,0,0,0,2150,4236
40,Forlì-Cesena,35,1288,779,16,1,4,0,0,2088,991,1108,49,7,0,0,0,2155,4243
40,Forlì-Cesena,36,1251,990,18,1,2,0,0,2262,1002,1251,60,5,1,0,0,2319,4581
40,Forlì-Cesena,37,1321,1060,37,1,1,0,0,2420,1004,1313,66,8,0,0,0,2391,4811
40,Forlì-Cesena,38,1204,1100,39,2,4,0,0,2349,1023,1396,68,6,0,0,0,2493,4842
40,Forlì-Cesena,39,1254,1262,48,2,1,0,0,2567,1052,1458,93,12,1,0,0,2616,5183
40,Forlì-Cesena,40,1315,1317,66,4,3,0,0,2705,1093,1586,105,12,1,0,0,2797,5502
40,Forlì-Cesena,41,1337,1476,73,3,2,0,0,2891,1019,1707,116,22,1,0,0,2865,5756
40,Forlì-Cesena,42,1300,1566,74,3,0,0,0,2943,1014,1808,146,19,0,1,0,2988,5931
40,Forlì-Cesena,43,1305,1695,85,6,1,0,0,3092,1044,1936,197,21,2,0,0,3200,6292
40,Forlì-Cesena,44,1412,1813,131,9,2,0,0,3367,1047,2111,195,24,1,0,0,3378,6745
40,Forlì-Cesena,45,1259,1842,128,6,1,0,0,3236,913,2110,190,30,0,0,0,3243,6479
40,Forlì-Cesena,46,1140,1939,146,6,2,0,0,3233,875,2114,238,41,1,0,0,3269,6502
40,Forlì-Cesena,47,1116,1932,157,14,1,0,0,3220,823,2154,258,49,0,0,0,3284,6504
40,Forlì-Cesena,48,1061,2067,182,9,3,0,0,3322,700,2193,251,42,1,0,0,3187,6509
40,Forlì-Cesena,49,976,2037,184,9,1,0,1,3208,713,2210,308,55,0,0,0,3286,6494
40,Forlì-Cesena,50,862,2118,167,15,2,0,0,3164,671,2264,296,69,1,0,0,3301,6465
40,Forlì-Cesena,51,826,2095,206,21,2,0,0,3150,633,2184,271,60,0,0,0,3148,6298
40,Forlì-Cesena,52,819,2165,236,18,1,0,0,3239,568,2238,296,86,0,0,0,3188,6427
40,Forlì-Cesena,53,711,2204,216,23,4,0,0,3158,539,2318,288,96,0,0,0,3241,6399
40,Forlì-Cesena,54,703,2228,224,21,2,0,0,3178,525,2308,274,100,1,0,0,3208,6386
40,Forlì-Cesena,55,556,2151,210,28,1,0,0,2946,478,2268,279,111,0,0,0,3136,6082
40,Forlì-Cesena,56,518,2123,200,29,1,0,0,2871,420,2164,257,111,0,0,0,2952,5823
40,Forlì-Cesena,57,476,2068,239,28,3,0,0,2814,372,2153,271,154,0,0,0,2950,5764
40,Forlì-Cesena,58,409,2032,191,39,2,0,0,2673,351,2161,281,140,0,0,0,2933,5606
40,Forlì-Cesena,59,407,1985,207,45,1,0,0,2645,325,2107,256,166,0,0,0,2854,5499
40,Forlì-Cesena,60,345,1898,171,40,1,0,0,2455,280,2011,252,200,0,0,0,2743,5198
40,Forlì-Cesena,61,322,1905,195,43,1,0,0,2466,291,1973,236,186,0,0,0,2686,5152
40,Forlì-Cesena,62,283,1976,176,42,1,0,0,2478,250,1973,210,228,0,0,0,2661,5139
40,Forlì-Cesena,63,263,1864,145,45,2,0,0,2319,245,1920,212,239,0,0,0,2616,4935
40,Forlì-Cesena,64,237,1766,134,47,2,0,0,2186,203,1750,161,259,0,0,0,2373,4559
40,Forlì-Cesena,65,216,1756,123,64,2,0,0,2161,197,1781,171,279,1,0,0,2429,4590
40,Forlì-Cesena,66,238,1713,111,75,1,0,0,2138,166,1829,152,317,1,0,0,2465,4603
40,Forlì-Cesena,67,174,1745,118,90,0,0,0,2127,174,1760,156,328,0,0,0,2418,4545
40,Forlì-Cesena,68,205,1781,120,78,0,0,0,2184,151,1738,129,400,0,0,0,2418,4602
40,Forlì-Cesena,69,194,1816,115,112,1,0,0,2238,144,1728,145,416,1,0,0,2434,4672
40,Forlì-Cesena,70,178,1856,93,112,0,0,0,2239,131,1804,125,472,0,0,0,2532,4771
40,Forlì-Cesena,71,172,1851,100,128,0,0,0,2251,158,1633,122,523,0,0,0,2436,4687
40,Forlì-Cesena,72,156,1834,104,145,1,0,0,2240,139,1680,96,565,2,0,0,2482,4722
40,Forlì-Cesena,73,137,1432,68,115,0,0,0,1752,101,1306,79,466,0,0,0,1952,3704
40,Forlì-Cesena,74,130,1494,54,134,0,0,0,1812,100,1359,80,562,0,0,0,2101,3913
40,Forlì-Cesena,75,150,1415,53,141,0,0,0,1759,108,1222,78,607,0,0,0,2015,3774
40,Forlì-Cesena,76,135,1361,46,143,0,0,0,1685,84,1142,68,683,0,0,0,1977,3662
40,Forlì-Cesena,77,157,1357,49,164,0,0,0,1727,114,1135,49,721,0,0,0,2019,3746
40,Forlì-Cesena,78,146,1348,44,196,0,0,0,1734,139,1165,56,851,0,0,0,2211,3945
40,Forlì-Cesena,79,136,1307,35,180,0,0,0,1658,109,1089,66,932,0,0,0,2196,3854
40,Forlì-Cesena,80,150,1318,21,231,0,0,0,1720,114,911,54,1080,0,0,0,2159,3879
40,Forlì-Cesena,81,118,1142,21,211,0,0,0,1492,106,785,37,973,0,0,0,1901,3393
40,Forlì-Cesena,82,106,951,21,201,0,0,0,1279,91,616,27,926,0,0,0,1660,2939
40,Forlì-Cesena,83,101,966,25,249,0,0,0,1341,82,515,26,1119,0,0,0,1742,3083
40,Forlì-Cesena,84,78,823,17,216,0,0,0,1134,75,438,25,1047,0,0,0,1585,2719
40,Forlì-Cesena,85,73,727,11,196,0,0,0,1007,84,351,20,1049,0,0,0,1504,2511
40,Forlì-Cesena,86,49,580,7,207,0,0,0,843,60,260,14,923,0,0,0,1257,2100
40,Forlì-Cesena,87,47,456,7,164,0,0,0,674,66,216,13,909,0,0,0,1204,1878
40,Forlì-Cesena,88,44,436,5,173,0,0,0,658,77,189,13,914,0,0,0,1193,1851
40,Forlì-Cesena,89,39,312,6,174,0,0,0,531,62,124,9,843,0,0,0,1038,1569
40,Forlì-Cesena,90,37,275,2,163,1,0,0,478,58,86,7,803,0,0,0,954,1432
40,Forlì-Cesena,91,17,194,2,151,0,0,0,364,51,64,5,683,0,0,0,803,1167
40,Forlì-Cesena,92,12,142,1,106,0,0,0,261,40,42,5,542,0,0,0,629,890
40,Forlì-Cesena,93,9,95,2,94,0,0,0,200,34,28,3,498,0,0,0,563,763
40,Forlì-Cesena,94,13,76,1,79,0,0,0,169,30,10,3,368,0,0,0,411,580
40,Forlì-Cesena,95,3,45,0,62,0,0,0,110,19,11,3,310,0,0,0,343,453
40,Forlì-Cesena,96,1,27,0,54,0,0,0,82,16,5,2,210,0,0,0,233,315
40,Forlì-Cesena,97,6,18,1,30,0,0,0,55,13,2,3,167,0,0,0,185,240
40,Forlì-Cesena,98,0,6,0,17,0,0,0,23,7,3,0,115,0,0,0,125,148
40,Forlì-Cesena,99,0,6,0,11,0,0,0,17,7,1,0,48,0,0,0,56,73
40,Forlì-Cesena,100,1,2,0,12,0,0,0,15,13,1,0,82,0,0,0,96,111
41,Pesaro e Urbino,0,1202,0,0,0,0,0,0,1202,1173,0,0,0,0,0,0,1173,2375
41,Pesaro e Urbino,1,1320,0,0,0,0,0,0,1320,1220,0,0,0,0,0,0,1220,2540
41,Pesaro e Urbino,2,1415,0,0,0,0,0,0,1415,1319,0,0,0,0,0,0,1319,2734
41,Pesaro e Urbino,3,1442,0,0,0,0,0,0,1442,1436,0,0,0,0,0,0,1436,2878
41,Pesaro e Urbino,4,1526,0,0,0,0,0,0,1526,1408,0,0,0,0,0,0,1408,2934
41,Pesaro e Urbino,5,1586,0,0,0,0,0,0,1586,1486,0,0,0,0,0,0,1486,3072
41,Pesaro e Urbino,6,1634,0,0,0,0,0,0,1634,1487,0,0,0,0,0,0,1487,3121
41,Pesaro e Urbino,7,1712,0,0,0,0,0,0,1712,1664,0,0,0,0,0,0,1664,3376
41,Pesaro e Urbino,8,1704,0,0,0,0,0,0,1704,1602,0,0,0,0,0,0,1602,3306
41,Pesaro e Urbino,9,1684,0,0,0,0,0,0,1684,1675,0,0,0,0,0,0,1675,3359
41,Pesaro e Urbino,10,1781,0,0,0,0,0,0,1781,1674,0,0,0,0,0,0,1674,3455
41,Pesaro e Urbino,11,1743,0,0,0,0,0,0,1743,1590,0,0,0,0,0,0,1590,3333
41,Pesaro e Urbino,12,1768,0,0,0,0,0,0,1768,1612,0,0,0,0,0,0,1612,3380
41,Pesaro e Urbino,13,1778,0,0,0,0,0,0,1778,1638,0,0,0,0,0,0,1638,3416
41,Pesaro e Urbino,14,1736,0,0,0,0,0,0,1736,1577,0,0,0,0,0,0,1577,3313
41,Pesaro e Urbino,15,1657,0,0,0,0,0,0,1657,1677,0,0,0,0,0,0,1677,3334
41,Pesaro e Urbino,16,1688,0,0,0,0,0,0,1688,1619,0,0,0,0,0,0,1619,3307
41,Pesaro e Urbino,17,1670,0,0,0,0,0,0,1670,1625,0,0,0,0,0,0,1625,3295
41,Pesaro e Urbino,18,1867,0,0,0,0,0,0,1867,1613,2,0,0,0,0,0,1615,3482
41,Pesaro e Urbino,19,1772,2,0,0,0,0,0,1774,1567,11,0,0,0,0,0,1578,3352
41,Pesaro e Urbino,20,1811,1,0,0,0,0,0,1812,1555,18,0,0,0,0,0,1573,3385
41,Pesaro e Urbino,21,1770,5,0,0,0,0,0,1775,1547,42,0,0,0,0,0,1589,3364
41,Pesaro e Urbino,22,1776,13,0,0,0,0,0,1789,1509,45,1,0,0,0,0,1555,3344
41,Pesaro e Urbino,23,1763,17,2,0,0,0,0,1782,1517,88,0,0,0,0,0,1605,3387
41,Pesaro e Urbino,24,1731,32,0,0,0,0,0,1763,1498,102,0,0,0,0,0,1600,3363
41,Pesaro e Urbino,25,1619,54,1,0,0,0,0,1674,1459,167,5,0,0,0,0,1631,3305
41,Pesaro e Urbino,26,1741,66,1,0,0,0,0,1808,1491,215,1,0,0,0,0,1707,3515
41,Pesaro e Urbino,27,1727,139,1,0,1,0,0,1868,1335,340,4,0,0,0,0,1679,3547
41,Pesaro e Urbino,28,1570,168,1,0,0,0,0,1739,1424,377,8,0,0,0,0,1809,3548
41,Pesaro e Urbino,29,1600,227,3,0,0,0,0,1830,1249,528,17,1,0,0,0,1795,3625
41,Pesaro e Urbino,30,1552,313,4,0,0,0,0,1869,1206,621,22,1,1,0,0,1851,3720
41,Pesaro e Urbino,31,1495,388,7,0,0,0,0,1890,1076,687,22,0,2,1,0,1788,3678
41,Pesaro e Urbino,32,1355,478,7,0,0,0,0,1840,1006,815,25,2,0,0,0,1848,3688
41,Pesaro e Urbino,33,1316,526,14,0,0,0,0,1856,1034,830,37,1,0,0,0,1902,3758
41,Pesaro e Urbino,34,1213,632,14,0,0,0,0,1859,893,954,33,5,1,0,0,1886,3745
41,Pesaro e Urbino,35,1325,744,30,0,2,0,0,2101,889,1067,46,10,1,0,0,2013,4114
41,Pesaro e Urbino,36,1174,884,27,0,2,0,0,2087,927,1165,51,4,0,0,0,2147,4234
41,Pesaro e Urbino,37,1172,949,26,0,2,0,0,2149,812,1242,65,6,0,0,0,2125,4274
41,Pesaro e Urbino,38,1120,1003,37,4,0,0,0,2164,773,1363,68,4,1,0,0,2209,4373
41,Pesaro e Urbino,39,1103,1061,52,3,0,0,0,2219,758,1421,99,11,0,0,0,2289,4508
41,Pesaro e Urbino,40,1189,1265,73,2,1,0,0,2530,824,1565,108,17,2,0,0,2516,5046
41,Pesaro e Urbino,41,1112,1337,61,1,1,1,0,2513,812,1712,133,20,0,0,0,2677,5190
41,Pesaro e Urbino,42,1111,1525,70,1,2,1,0,2710,737,1824,139,19,1,0,0,2720,5430
41,Pesaro e Urbino,43,1080,1564,79,6,2,0,0,2731,725,1905,128,19,0,1,0,2778,5509
41,Pesaro e Urbino,44,1021,1739,105,7,4,0,0,2876,725,1953,175,23,0,0,0,2876,5752
41,Pesaro e Urbino,45,971,1771,110,3,1,0,0,2856,699,1994,170,40,1,0,0,2904,5760
41,Pesaro e Urbino,46,909,1800,134,6,2,0,0,2851,571,2019,193,25,0,0,0,2808,5659
41,Pesaro e Urbino,47,871,1896,142,13,1,0,0,2923,597,2130,198,34,0,0,0,2959,5882
41,Pesaro e Urbino,48,768,1912,166,14,3,0,0,2863,491,2043,217,45,0,0,0,2796,5659
41,Pesaro e Urbino,49,767,1957,171,15,3,0,0,2913,556,2194,244,37,0,0,0,3031,5944
41,Pesaro e Urbino,50,658,2076,154,11,1,1,0,2901,506,2128,220,63,0,0,0,2917,5818
41,Pesaro e Urbino,51,669,2096,192,16,3,0,0,2976,458,2168,272,72,0,0,0,2970,5946
41,Pesaro e Urbino,52,639,2092,197,18,0,0,0,2946,379,2267,214,78,0,0,0,2938,5884
41,Pesaro e Urbino,53,548,2154,174,22,0,0,0,2898,386,2174,255,78,0,0,0,2893,5791
41,Pesaro e Urbino,54,531,2219,197,24,1,0,0,2972,350,2271,212,109,0,0,0,2942,5914
41,Pesaro e Urbino,55,476,2197,193,30,2,0,0,2898,319,2170,209,87,0,0,0,2785,5683
41,Pesaro e Urbino,56,350,2113,158,21,1,0,0,2643,299,2105,213,111,0,0,0,2728,5371
41,Pesaro e Urbino,57,381,2058,202,24,3,0,0,2668,293,2130,202,113,0,0,0,2738,5406
41,Pesaro e Urbino,58,386,1950,165,40,3,0,0,2544,241,2098,187,154,0,0,0,2680,5224
41,Pesaro e Urbino,59,327,1928,158,33,1,0,0,2447,256,1997,190,149,0,0,0,2592,5039
41,Pesaro e Urbino,60,287,1870,152,40,2,0,0,2351,210,1923,173,157,0,0,0,2463,4814
41,Pesaro e Urbino,61,294,1796,137,42,0,0,0,2269,185,1810,164,181,0,0,0,2340,4609
41,Pesaro e Urbino,62,237,1792,125,38,3,0,0,2195,193,1828,138,214,0,0,0,2373,4568
41,Pesaro e Urbino,63,229,1720,89,61,1,0,0,2100,163,1737,147,207,0,0,0,2254,4354
41,Pesaro e Urbino,64,216,1679,104,45,0,0,0,2044,142,1687,124,237,0,0,0,2190,4234
41,Pesaro e Urbino,65,189,1631,95,56,1,0,0,1972,150,1643,102,228,0,0,0,2123,4095
41,Pesaro e Urbino,66,176,1601,94,75,1,0,0,1947,137,1599,102,255,1,0,0,2094,4041
41,Pesaro e Urbino,67,156,1715,82,58,0,0,0,2011,126,1626,103,290,0,0,0,2145,4156
41,Pesaro e Urbino,68,172,1738,76,72,0,0,0,2058,126,1753,97,326,0,0,0,2302,4360
41,Pesaro e Urbino,69,181,1706,75,81,0,0,0,2043,103,1691,90,395,0,0,0,2279,4322
41,Pesaro e Urbino,70,148,1745,84,99,0,0,0,2076,114,1649,83,448,0,0,0,2294,4370
41,Pesaro e Urbino,71,164,1677,71,100,0,0,0,2012,88,1508,69,462,0,0,0,2127,4139
41,Pesaro e Urbino,72,164,1722,75,123,1,0,0,2085,99,1583,89,517,1,0,0,2289,4374
41,Pesaro e Urbino,73,116,1303,55,118,0,0,0,1592,88,1183,70,461,0,0,0,1802,3394
41,Pesaro e Urbino,74,129,1349,34,103,0,0,0,1615,67,1162,60,587,1,0,0,1877,3492
41,Pesaro e Urbino,75,103,1379,38,104,0,0,0,1624,85,1111,44,613,0,0,0,1853,3477
41,Pesaro e Urbino,76,115,1234,33,119,0,0,0,1501,84,956,44,594,1,0,0,1679,3180
41,Pesaro e Urbino,77,110,1172,31,124,0,0,0,1437,77,946,41,684,0,0,0,1748,3185
41,Pesaro e Urbino,78,103,1267,33,142,0,0,0,1545,103,970,40,825,0,0,0,1938,3483
41,Pesaro e Urbino,79,110,1309,21,148,0,0,0,1588,80,878,28,861,0,0,0,1847,3435
41,Pesaro e Urbino,80,128,1179,28,181,0,0,0,1516,84,859,31,977,0,0,0,1951,3467
41,Pesaro e Urbino,81,98,935,21,160,0,0,0,1214,75,652,19,891,0,0,0,1637,2851
41,Pesaro e Urbino,82,68,906,12,167,0,0,0,1153,74,549,21,881,0,0,0,1525,2678
41,Pesaro e Urbino,83,74,785,17,195,0,0,0,1071,83,510,20,998,0,0,0,1611,2682
41,Pesaro e Urbino,84,62,752,12,171,0,0,0,997,64,410,15,1018,0,0,0,1507,2504
41,Pesaro e Urbino,85,58,624,6,194,0,0,0,882,55,302,16,984,0,0,0,1357,2239
41,Pesaro e Urbino,86,45,540,7,164,0,0,0,756,69,237,11,896,0,0,0,1213,1969
41,Pesaro e Urbino,87,36,469,3,183,0,0,0,691,68,186,9,979,0,0,0,1242,1933
41,Pesaro e Urbino,88,30,393,3,182,0,0,0,608,50,158,5,889,0,0,0,1102,1710
41,Pesaro e Urbino,89,21,309,4,127,0,0,0,461,50,96,9,703,0,0,0,858,1319
41,Pesaro e Urbino,90,25,235,3,127,0,0,0,390,33,65,2,740,0,0,0,840,1230
41,Pesaro e Urbino,91,13,215,1,119,0,0,0,348,28,72,3,653,0,0,0,756,1104
41,Pesaro e Urbino,92,15,129,0,104,0,0,0,248,34,31,4,574,0,0,0,643,891
41,Pesaro e Urbino,93,13,97,0,93,0,0,0,203,35,21,3,460,0,0,0,519,722
41,Pesaro e Urbino,94,9,52,1,70,0,0,0,132,19,16,4,368,0,0,0,407,539
41,Pesaro e Urbino,95,6,42,1,53,0,0,0,102,18,4,2,267,0,0,0,291,393
41,Pesaro e Urbino,96,3,27,0,40,0,0,0,70,12,7,1,192,0,0,0,212,282
41,Pesaro e Urbino,97,6,13,0,26,0,0,0,45,12,2,1,183,0,0,0,198,243
41,Pesaro e Urbino,98,0,12,0,22,0,0,0,34,6,1,0,108,0,0,0,115,149
41,Pesaro e Urbino,99,1,1,0,4,0,0,0,6,3,1,0,51,0,0,0,55,61
41,Pesaro e Urbino,100,1,2,0,9,0,0,0,12,6,2,0,74,0,0,0,82,94
42,Ancona,0,1618,0,0,0,0,0,0,1618,1506,0,0,0,0,0,0,1506,3124
42,Ancona,1,1694,0,0,0,0,0,0,1694,1560,0,0,0,0,0,0,1560,3254
42,Ancona,2,1842,0,0,0,0,0,0,1842,1672,0,0,0,0,0,0,1672,3514
42,Ancona,3,1906,0,0,0,0,0,0,1906,1773,0,0,0,0,0,0,1773,3679
42,Ancona,4,1937,0,0,0,0,0,0,1937,1864,0,0,0,0,0,0,1864,3801
42,Ancona,5,2066,0,0,0,0,0,0,2066,1850,0,0,0,0,0,0,1850,3916
42,Ancona,6,2119,0,0,0,0,0,0,2119,1990,0,0,0,0,0,0,1990,4109
42,Ancona,7,2114,0,0,0,0,0,0,2114,2071,0,0,0,0,0,0,2071,4185
42,Ancona,8,2208,0,0,0,0,0,0,2208,2158,0,0,0,0,0,0,2158,4366
42,Ancona,9,2402,0,0,0,0,0,0,2402,2157,0,0,0,0,0,0,2157,4559
42,Ancona,10,2343,0,0,0,0,0,0,2343,2236,0,0,0,0,0,0,2236,4579
42,Ancona,11,2269,0,0,0,0,0,0,2269,2166,0,0,0,0,0,0,2166,4435
42,Ancona,12,2194,0,0,0,0,0,0,2194,2078,0,0,0,0,0,0,2078,4272
42,Ancona,13,2188,0,0,0,0,0,0,2188,2079,0,0,0,0,0,0,2079,4267
42,Ancona,14,2221,0,0,0,0,0,0,2221,2068,0,0,0,0,0,0,2068,4289
42,Ancona,15,2138,0,0,0,0,0,0,2138,2059,0,0,0,0,0,0,2059,4197
42,Ancona,16,2273,0,0,0,0,0,0,2273,2065,0,0,0,0,0,0,2065,4338
42,Ancona,17,2189,0,0,0,0,0,0,2189,2014,0,0,0,0,0,0,2014,4203
42,Ancona,18,2234,2,0,0,0,0,0,2236,2027,4,0,0,0,0,0,2031,4267
42,Ancona,19,2244,2,0,0,0,0,0,2246,2075,13,0,0,0,0,0,2088,4334
42,Ancona,20,2392,1,0,0,0,0,0,2393,2028,29,0,0,0,0,0,2057,4450
42,Ancona,21,2318,0,0,0,0,0,0,2318,2063,46,0,0,0,0,0,2109,4427
42,Ancona,22,2272,13,1,0,0,0,0,2286,1985,82,1,0,0,0,0,2068,4354
42,Ancona,23,2273,21,0,0,0,0,0,2294,1949,113,2,0,0,0,0,2064,4358
42,Ancona,24,2206,35,0,0,0,0,0,2241,1927,146,4,0,0,0,0,2077,4318
42,Ancona,25,2217,54,0,0,0,0,0,2271,1945,213,6,0,0,0,0,2164,4435
42,Ancona,26,2286,92,1,0,0,0,0,2379,1947,292,7,0,1,0,0,2247,4626
42,Ancona,27,2265,138,1,0,1,0,0,2405,1881,301,4,1,0,0,0,2187,4592
42,Ancona,28,2280,207,2,0,0,0,0,2489,1821,475,8,2,1,0,0,2307,4796
42,Ancona,29,1983,281,2,0,0,0,0,2266,1673,615,14,2,0,0,0,2304,4570
42,Ancona,30,1885,392,4,0,1,0,0,2282,1515,741,14,1,1,0,0,2272,4554
42,Ancona,31,1809,472,3,0,2,0,0,2286,1354,903,15,1,3,0,0,2276,4562
42,Ancona,32,1836,623,4,0,1,0,0,2464,1331,1066,25,2,1,0,0,2425,4889
42,Ancona,33,1703,691,14,0,1,0,0,2409,1281,1176,38,6,0,1,0,2502,4911
42,Ancona,34,1674,928,12,1,1,0,0,2616,1183,1328,38,7,0,0,0,2556,5172
42,Ancona,35,1522,1020,15,0,1,0,0,2558,1192,1415,52,4,1,0,0,2664,5222
42,Ancona,36,1627,1097,31,1,1,0,1,2758,1093,1535,86,5,0,0,0,2719,5477
42,Ancona,37,1512,1209,33,1,3,0,0,2758,1066,1590,85,8,1,0,0,2750,5508
42,Ancona,38,1537,1406,38,1,1,0,0,2983,1134,1767,77,11,0,0,0,2989,5972
42,Ancona,39,1480,1593,54,3,1,0,0,3131,1014,1905,111,15,1,1,0,3047,6178
42,Ancona,40,1509,1692,80,5,5,0,0,3291,1042,2041,125,19,0,1,0,3228,6519
42,Ancona,41,1552,1827,80,7,0,0,0,3466,1043,2153,129,16,0,0,0,3341,6807
42,Ancona,42,1411,1853,116,5,2,1,0,3388,1004,2269,157,25,2,0,0,3457,6845
42,Ancona,43,1462,2150,96,3,4,0,0,3715,1027,2528,175,26,2,0,0,3758,7473
42,Ancona,44,1467,2222,124,7,2,0,0,3822,961,2536,192,19,0,0,0,3708,7530
42,Ancona,45,1259,2253,128,6,1,0,0,3647,881,2587,206,39,1,0,0,3714,7361
42,Ancona,46,1226,2316,137,11,3,0,0,3693,834,2626,220,37,3,0,0,3720,7413
42,Ancona,47,1196,2466,183,8,3,0,0,3856,811,2718,251,34,2,0,0,3816,7672
42,Ancona,48,1007,2478,175,8,3,0,0,3671,695,2761,255,64,1,0,0,3776,7447
42,Ancona,49,955,2524,169,9,4,0,0,3661,734,2838,273,71,3,0,0,3919,7580
42,Ancona,50,893,2548,167,17,2,0,0,3627,663,2836,312,81,1,0,0,3893,7520
42,Ancona,51,845,2496,201,24,5,0,0,3571,616,2819,268,87,0,0,0,3790,7361
42,Ancona,52,766,2756,224,23,4,0,0,3773,611,2896,283,87,0,0,0,3877,7650
42,Ancona,53,712,2688,203,36,6,0,0,3645,546,2763,275,92,1,0,0,3677,7322
42,Ancona,54,696,2770,246,20,2,0,0,3734,512,2998,300,123,0,0,0,3933,7667
42,Ancona,55,605,2632,215,32,1,0,0,3485,475,2824,314,134,1,0,0,3748,7233
42,Ancona,56,565,2606,231,45,2,0,0,3449,395,2616,259,128,1,0,0,3399,6848
42,Ancona,57,466,2660,206,32,4,0,0,3368,396,2689,274,157,1,0,0,3517,6885
42,Ancona,58,451,2452,204,42,1,0,0,3150,414,2547,225,180,0,0,0,3366,6516
42,Ancona,59,418,2395,174,39,3,0,0,3029,328,2608,213,215,0,0,0,3364,6393
42,Ancona,60,392,2370,201,60,2,0,0,3025,333,2515,197,205,0,0,0,3250,6275
42,Ancona,61,352,2377,159,63,2,0,0,2953,274,2499,209,233,0,0,0,3215,6168
42,Ancona,62,334,2394,167,74,1,0,0,2970,285,2549,213,303,0,0,0,3350,6320
42,Ancona,63,298,2325,159,73,2,0,0,2857,253,2441,187,289,0,0,0,3170,6027
42,Ancona,64,271,2329,108,66,1,0,0,2775,249,2269,170,301,0,0,0,2989,5764
42,Ancona,65,240,2151,122,78,3,0,0,2594,206,2342,151,349,0,0,0,3048,5642
42,Ancona,66,242,2233,133,94,1,0,0,2703,181,2197,156,394,0,0,0,2928,5631
42,Ancona,67,235,2296,109,88,3,0,0,2731,201,2222,123,417,0,0,0,2963,5694
42,Ancona,68,230,2318,107,113,3,0,0,2771,184,2222,140,465,1,0,0,3012,5783
42,Ancona,69,189,2201,78,110,0,0,0,2578,168,2085,118,525,0,0,0,2896,5474
42,Ancona,70,211,2330,54,137,1,0,0,2733,160,2143,99,536,0,0,0,2938,5671
42,Ancona,71,198,2224,69,137,0,0,0,2628,157,1954,100,685,0,0,0,2896,5524
42,Ancona,72,196,2212,80,167,0,0,0,2655,160,2033,88,731,0,0,0,3012,5667
42,Ancona,73,150,1841,61,168,1,0,0,2221,109,1559,66,657,0,0,0,2391,4612
42,Ancona,74,144,1672,45,152,0,0,0,2013,128,1482,66,711,0,0,0,2387,4400
42,Ancona,75,143,1782,44,157,0,0,0,2126,125,1575,38,812,0,0,0,2550,4676
42,Ancona,76,152,1563,39,195,1,0,0,1950,141,1355,51,883,0,0,0,2430,4380
42,Ancona,77,138,1593,30,171,0,0,0,1932,133,1272,41,944,0,0,0,2390,4322
42,Ancona,78,125,1715,21,194,0,0,0,2055,136,1389,45,1174,0,0,0,2744,4799
42,Ancona,79,129,1686,30,204,1,0,0,2050,138,1241,41,1291,0,0,0,2711,4761
42,Ancona,80,149,1524,33,233,0,0,0,1939,170,1067,38,1389,0,0,0,2664,4603
42,Ancona,81,100,1455,24,219,0,0,0,1798,120,890,27,1338,0,0,0,2375,4173
42,Ancona,82,76,1184,12,207,0,0,0,1479,131,753,19,1368,0,0,0,2271,3750
42,Ancona,83,93,1163,13,235,0,0,0,1504,128,679,27,1416,0,0,0,2250,3754
42,Ancona,84,90,1042,7,209,0,0,0,1348,119,532,17,1402,0,0,0,2070,3418
42,Ancona,85,46,895,11,202,0,0,0,1154,107,404,12,1394,0,0,0,1917,3071
42,Ancona,86,55,746,11,207,0,0,0,1019,104,301,16,1242,0,0,0,1663,2682
42,Ancona,87,42,669,4,214,0,0,0,929,103,269,15,1390,0,0,0,1777,2706
42,Ancona,88,30,628,6,202,0,0,0,866,96,173,7,1259,0,0,0,1535,2401
42,Ancona,89,25,424,3,183,0,0,0,635,98,129,7,1066,0,0,0,1300,1935
42,Ancona,90,22,339,2,163,0,0,0,526,98,92,4,1009,0,0,0,1203,1729
42,Ancona,91,17,293,1,145,0,0,0,456,88,82,6,873,0,0,0,1049,1505
42,Ancona,92,12,168,2,149,0,0,0,331,65,65,4,751,0,0,0,885,1216
42,Ancona,93,5,137,2,118,0,0,0,262,68,39,2,646,0,0,0,755,1017
42,Ancona,94,7,79,1,96,0,0,0,183,49,21,3,510,0,0,0,583,766
42,Ancona,95,4,66,0,74,0,0,0,144,34,9,2,416,0,0,0,461,605
42,Ancona,96,2,41,0,62,0,0,0,105,20,8,4,293,0,0,0,325,430
42,Ancona,97,4,24,0,30,0,0,0,58,18,4,0,222,0,0,0,244,302
42,Ancona,98,2,21,0,21,0,0,0,44,19,5,2,167,0,0,0,193,237
42,Ancona,99,0,4,0,14,0,0,0,18,10,2,0,61,0,0,0,73,91
42,Ancona,100,1,4,0,16,0,0,0,21,8,1,1,115,0,0,0,125,146
43,Macerata,0,1136,0,0,0,0,0,0,1136,1047,0,0,0,0,0,0,1047,2183
43,Macerata,1,1194,0,0,0,0,0,0,1194,1142,0,0,0,0,0,0,1142,2336
43,Macerata,2,1218,0,0,0,0,0,0,1218,1214,0,0,0,0,0,0,1214,2432
43,Macerata,3,1250,0,0,0,0,0,0,1250,1247,0,0,0,0,0,0,1247,2497
43,Macerata,4,1284,0,0,0,0,0,0,1284,1311,0,0,0,0,0,0,1311,2595
43,Macerata,5,1360,0,0,0,0,0,0,1360,1197,0,0,0,0,0,0,1197,2557
43,Macerata,6,1370,0,0,0,0,0,0,1370,1303,0,0,0,0,0,0,1303,2673
43,Macerata,7,1396,0,0,0,0,0,0,1396,1390,0,0,0,0,0,0,1390,2786
43,Macerata,8,1527,0,0,0,0,0,0,1527,1333,0,0,0,0,0,0,1333,2860
43,Macerata,9,1496,0,0,0,0,0,0,1496,1424,0,0,0,0,0,0,1424,2920
43,Macerata,10,1456,0,0,0,0,0,0,1456,1340,0,0,0,0,0,0,1340,2796
43,Macerata,11,1456,0,0,0,0,0,0,1456,1425,0,0,0,0,0,0,1425,2881
43,Macerata,12,1411,0,0,0,0,0,0,1411,1390,0,0,0,0,0,0,1390,2801
43,Macerata,13,1403,0,0,0,0,0,0,1403,1370,0,0,0,0,0,0,1370,2773
43,Macerata,14,1468,0,0,0,0,0,0,1468,1296,0,0,0,0,0,0,1296,2764
43,Macerata,15,1472,0,0,0,0,0,0,1472,1336,0,0,0,0,0,0,1336,2808
43,Macerata,16,1437,0,0,0,0,0,0,1437,1346,0,0,0,0,0,0,1346,2783
43,Macerata,17,1398,0,0,0,0,0,0,1398,1354,1,0,0,0,0,0,1355,2753
43,Macerata,18,1517,0,0,0,0,0,0,1517,1367,3,0,0,0,0,0,1370,2887
43,Macerata,19,1513,0,0,0,0,0,0,1513,1376,13,0,0,0,0,0,1389,2902
43,Macerata,20,1541,5,0,0,0,0,0,1546,1342,25,0,0,0,0,0,1367,2913
43,Macerata,21,1585,4,0,0,0,0,0,1589,1360,37,0,0,0,0,0,1397,2986
43,Macerata,22,1465,14,0,0,0,0,0,1479,1368,48,0,0,0,0,0,1416,2895
43,Macerata,23,1487,16,0,0,0,0,0,1503,1317,92,0,0,0,0,0,1409,2912
43,Macerata,24,1524,26,0,1,0,0,0,1551,1343,116,0,0,0,0,0,1459,3010
43,Macerata,25,1622,55,0,0,0,0,0,1677,1326,186,0,0,0,0,0,1512,3189
43,Macerata,26,1567,93,1,0,0,0,0,1661,1319,247,3,0,0,0,0,1569,3230
43,Macerata,27,1518,131,0,0,1,0,0,1650,1277,341,7,0,0,0,0,1625,3275
43,Macerata,28,1570,182,1,0,1,0,0,1754,1233,398,2,1,0,0,0,1634,3388
43,Macerata,29,1449,253,3,0,0,0,0,1705,1123,493,8,1,0,0,0,1625,3330
43,Macerata,30,1394,326,2,0,0,0,0,1722,1076,643,12,0,0,0,0,1731,3453
43,Macerata,31,1275,416,3,0,0,0,0,1694,887,717,9,1,0,0,0,1614,3308
43,Macerata,32,1257,521,5,0,0,0,0,1783,932,729,23,2,0,0,0,1686,3469
43,Macerata,33,1200,579,7,1,1,0,0,1788,855,906,25,2,0,0,0,1788,3576
43,Macerata,34,1084,633,12,0,1,1,0,1731,776,960,35,2,0,0,0,1773,3504
43,Macerata,35,1005,713,23,0,0,0,0,1741,710,1036,43,4,0,0,0,1793,3534
43,Macerata,36,988,899,15,0,0,0,0,1902,770,1086,37,6,0,0,0,1899,3801
43,Macerata,37,990,911,27,1,0,0,0,1929,666,1182,43,3,0,0,0,1894,3823
43,Macerata,38,958,968,28,2,0,0,0,1956,593,1295,59,4,1,0,0,1952,3908
43,Macerata,39,934,999,28,2,0,0,0,1963,582,1391,67,14,1,0,0,2055,4018
43,Macerata,40,945,1181,47,1,0,0,0,2174,602,1382,83,10,0,0,0,2077,4251
43,Macerata,41,865,1257,51,2,1,0,0,2176,570,1524,79,11,0,0,0,2184,4360
43,Macerata,42,879,1308,63,3,1,0,0,2254,520,1587,96,13,0,0,0,2216,4470
43,Macerata,43,877,1374,58,3,0,0,0,2312,558,1682,115,11,0,0,0,2366,4678
43,Macerata,44,782,1511,63,4,1,0,0,2361,526,1709,132,20,0,0,0,2387,4748
43,Macerata,45,734,1467,66,5,1,0,0,2273,503,1677,119,22,0,0,0,2321,4594
43,Macerata,46,712,1576,104,5,0,0,0,2397,425,1703,146,34,0,0,0,2308,4705
43,Macerata,47,722,1550,91,4,0,0,0,2367,447,1882,157,25,0,0,0,2511,4878
43,Macerata,48,620,1616,90,7,0,0,0,2333,393,1748,142,37,0,0,0,2320,4653
43,Macerata,49,619,1667,140,15,0,0,0,2441,397,1884,132,46,0,0,0,2459,4900
43,Macerata,50,551,1782,104,10,0,0,0,2447,323,1849,159,51,0,0,0,2382,4829
43,Macerata,51,512,1675,115,10,0,0,0,2312,342,1924,156,67,0,0,0,2489,4801
43,Macerata,52,491,1747,137,8,0,0,0,2383,326,1877,184,67,0,0,0,2454,4837
43,Macerata,53,446,1810,142,7,0,0,0,2405,293,1936,178,78,0,0,0,2485,4890
43,Macerata,54,479,1816,176,13,0,0,0,2484,265,1980,165,84,1,1,0,2496,4980
43,Macerata,55,369,1783,130,15,0,0,0,2297,260,1916,176,97,1,0,0,2450,4747
43,Macerata,56,350,1785,141,25,0,0,0,2301,214,1781,155,94,0,0,0,2244,4545
43,Macerata,57,357,1786,132,20,1,0,0,2296,253,1844,169,106,0,0,0,2372,4668
43,Macerata,58,301,1720,130,31,0,0,0,2182,204,1834,149,126,0,0,0,2313,4495
43,Macerata,59,287,1696,112,23,0,0,0,2118,170,1820,128,161,0,0,0,2279,4397
43,Macerata,60,260,1653,113,36,2,0,0,2064,159,1688,155,137,0,0,0,2139,4203
43,Macerata,61,218,1635,98,38,1,0,0,1990,153,1734,153,172,0,0,0,2212,4202
43,Macerata,62,211,1634,91,44,0,0,0,1980,166,1640,119,171,0,0,0,2096,4076
43,Macerata,63,199,1589,86,51,1,0,0,1926,141,1637,110,236,0,0,0,2124,4050
43,Macerata,64,209,1580,83,50,0,0,0,1922,121,1592,94,209,1,0,0,2017,3939
43,Macerata,65,193,1571,77,43,0,0,0,1884,108,1464,92,254,0,0,0,1918,3802
43,Macerata,66,192,1585,77,69,1,0,0,1924,126,1492,75,289,0,0,1,1983,3907
43,Macerata,67,188,1537,71,64,0,0,0,1860,113,1557,99,314,0,0,0,2083,3943
43,Macerata,68,160,1568,69,69,0,0,0,1866,99,1465,89,354,0,0,0,2007,3873
43,Macerata,69,168,1468,64,72,0,0,0,1772,94,1322,63,366,0,0,0,1845,3617
43,Macerata,70,137,1471,51,91,0,0,0,1750,111,1449,46,429,0,0,0,2035,3785
43,Macerata,71,169,1468,49,62,0,0,0,1748,66,1275,62,462,0,0,0,1865,3613
43,Macerata,72,124,1348,39,94,0,0,0,1605,66,1286,48,444,0,0,0,1844,3449
43,Macerata,73,90,1149,30,83,0,0,0,1352,71,1051,42,440,0,0,0,1604,2956
43,Macerata,74,117,1086,43,85,0,0,0,1331,79,917,34,528,0,0,0,1558,2889
43,Macerata,75,107,1113,39,95,1,0,0,1355,68,924,35,551,0,0,0,1578,2933
43,Macerata,76,99,1061,21,106,1,0,0,1288,53,872,25,628,0,0,0,1578,2866
43,Macerata,77,101,991,17,100,0,0,0,1209,73,837,25,653,0,0,0,1588,2797
43,Macerata,78,121,1160,22,137,0,0,0,1440,67,860,35,779,0,0,0,1741,3181
43,Macerata,79,114,1163,17,143,0,0,0,1437,86,881,28,866,0,0,1,1862,3299
43,Macerata,80,94,1165,19,161,0,0,0,1439,79,730,23,1048,0,0,0,1880,3319
43,Macerata,81,97,989,19,167,0,0,0,1272,78,612,10,963,0,0,0,1663,2935
43,Macerata,82,66,805,14,142,0,0,0,1027,77,474,19,959,0,0,0,1529,2556
43,Macerata,83,68,825,7,155,0,0,0,1055,63,425,9,1016,0,0,0,1513,2568
43,Macerata,84,57,758,7,168,0,0,0,990,71,314,10,994,0,0,0,1389,2379
43,Macerata,85,62,585,5,139,0,0,0,791,56,292,7,904,0,0,0,1259,2050
43,Macerata,86,57,519,5,138,0,0,0,719,68,217,7,870,0,0,0,1162,1881
43,Macerata,87,40,476,6,166,0,0,0,688,56,150,6,865,0,0,0,1077,1765
43,Macerata,88,32,393,4,136,0,0,0,565,75,126,7,880,0,0,0,1088,1653
43,Macerata,89,31,314,1,119,0,0,0,465,42,74,8,747,0,0,0,871,1336
43,Macerata,90,19,262,1,112,0,0,0,394,58,57,5,680,0,0,0,800,1194
43,Macerata,91,11,192,2,114,0,0,0,319,48,49,5,648,0,0,0,750,1069
43,Macerata,92,15,138,0,89,0,0,0,242,43,38,2,552,0,0,0,635,877
43,Macerata,93,10,95,0,71,0,0,0,176,36,13,3,428,0,0,0,480,656
43,Macerata,94,11,56,0,65,0,0,0,132,29,10,2,293,0,0,0,334,466
43,Macerata,95,7,45,1,39,0,0,0,92,26,6,1,269,0,0,0,302,394
43,Macerata,96,4,21,0,29,0,0,0,54,21,5,2,191,0,0,0,219,273
43,Macerata,97,1,13,0,32,0,0,0,46,6,2,2,135,0,0,0,145,191
43,Macerata,98,2,11,0,20,0,0,0,33,7,0,2,106,0,0,0,115,148
43,Macerata,99,0,3,0,13,0,0,0,16,7,0,0,32,0,0,0,39,55
43,Macerata,100,1,5,0,9,0,0,0,15,6,0,0,77,0,0,0,83,98
44,Ascoli Piceno,0,663,0,0,0,0,0,0,663,646,0,0,0,0,0,0,646,1309
44,Ascoli Piceno,1,678,0,0,0,0,0,0,678,693,0,0,0,0,0,0,693,1371
44,Ascoli Piceno,2,792,0,0,0,0,0,0,792,702,0,0,0,0,0,0,702,1494
44,Ascoli Piceno,3,745,0,0,0,0,0,0,745,759,0,0,0,0,0,0,759,1504
44,Ascoli Piceno,4,856,0,0,0,0,0,0,856,792,0,0,0,0,0,0,792,1648
44,Ascoli Piceno,5,825,0,0,0,0,0,0,825,802,0,0,0,0,0,0,802,1627
44,Ascoli Piceno,6,818,0,0,0,0,0,0,818,808,0,0,0,0,0,0,808,1626
44,Ascoli Piceno,7,857,0,0,0,0,0,0,857,819,0,0,0,0,0,0,819,1676
44,Ascoli Piceno,8,877,0,0,0,0,0,0,877,846,0,0,0,0,0,0,846,1723
44,Ascoli Piceno,9,887,0,0,0,0,0,0,887,850,0,0,0,0,0,0,850,1737
44,Ascoli Piceno,10,957,0,0,0,0,0,0,957,883,0,0,0,0,0,0,883,1840
44,Ascoli Piceno,11,926,0,0,0,0,0,0,926,824,0,0,0,0,0,0,824,1750
44,Ascoli Piceno,12,930,0,0,0,0,0,0,930,845,0,0,0,0,0,0,845,1775
44,Ascoli Piceno,13,877,0,0,0,0,0,0,877,876,0,0,0,0,0,0,876,1753
44,Ascoli Piceno,14,953,0,0,0,0,0,0,953,920,0,0,0,0,0,0,920,1873
44,Ascoli Piceno,15,942,0,0,0,0,0,0,942,829,0,0,0,0,0,0,829,1771
44,Ascoli Piceno,16,935,0,0,0,0,0,0,935,807,0,0,0,0,0,0,807,1742
44,Ascoli Piceno,17,951,0,0,0,0,0,0,951,840,0,0,0,0,0,0,840,1791
44,Ascoli Piceno,18,1050,0,0,0,0,0,0,1050,925,0,0,0,0,0,0,925,1975
44,Ascoli Piceno,19,1024,1,0,0,0,0,0,1025,939,5,0,0,0,0,0,944,1969
44,Ascoli Piceno,20,1119,0,0,0,0,0,0,1119,977,14,0,0,0,0,0,991,2110
44,Ascoli Piceno,21,994,0,0,0,0,0,0,994,931,16,0,0,0,0,0,947,1941
44,Ascoli Piceno,22,1066,2,0,0,0,0,0,1068,886,35,0,0,0,0,0,921,1989
44,Ascoli Piceno,23,1074,7,0,0,0,0,0,1081,906,34,0,0,0,0,0,940,2021
44,Ascoli Piceno,24,1051,14,0,0,0,0,0,1065,944,43,1,0,0,0,0,988,2053
44,Ascoli Piceno,25,1092,16,0,0,0,0,0,1108,958,68,2,0,0,0,0,1028,2136
44,Ascoli Piceno,26,1083,38,0,0,0,0,0,1121,909,116,3,0,0,0,0,1028,2149
44,Ascoli Piceno,27,1082,56,1,0,1,0,0,1140,868,172,1,0,0,0,0,1041,2181
44,Ascoli Piceno,28,1084,81,2,0,0,0,0,1167,822,198,0,0,0,0,0,1020,2187
44,Ascoli Piceno,29,997,144,2,0,0,0,0,1143,799,279,8,0,1,0,0,1087,2230
44,Ascoli Piceno,30,954,196,1,0,0,0,0,1151,778,363,4,1,1,0,0,1147,2298
44,Ascoli Piceno,31,894,208,0,0,0,0,0,1102,637,420,8,1,0,0,0,1066,2168
44,Ascoli Piceno,32,853,276,4,0,0,0,0,1133,611,444,7,1,1,0,0,1064,2197
44,Ascoli Piceno,33,814,303,5,0,1,0,0,1123,566,540,19,1,1,0,0,1127,2250
44,Ascoli Piceno,34,761,396,5,0,0,0,0,1162,498,596,20,2,0,0,0,1116,2278
44,Ascoli Piceno,35,706,438,16,0,1,0,0,1161,485,683,24,2,0,0,0,1194,2355
44,Ascoli Piceno,36,655,499,16,0,0,0,0,1170,485,663,24,1,1,0,0,1174,2344
44,Ascoli Piceno,37,651,537,10,2,0,0,0,1200,438,705,30,3,0,0,0,1176,2376
44,Ascoli Piceno,38,627,634,14,0,0,0,0,1275,408,751,33,5,0,0,0,1197,2472
44,Ascoli Piceno,39,584,664,25,1,0,0,0,1274,414,834,47,5,1,0,0,1301,2575
44,Ascoli Piceno,40,605,663,32,1,1,0,0,1302,404,943,59,7,0,0,0,1413,2715
44,Ascoli Piceno,41,532,703,26,2,1,0,0,1264,385,1000,55,9,0,0,0,1449,2713
44,Ascoli Piceno,42,549,806,41,2,2,0,0,1400,342,976,64,11,1,0,0,1394,2794
44,Ascoli Piceno,43,526,896,33,2,0,0,0,1457,370,1022,73,9,1,0,0,1475,2932
44,Ascoli Piceno,44,559,954,39,1,0,0,0,1553,359,1091,82,12,0,0,0,1544,3097
44,Ascoli Piceno,45,500,972,49,2,2,0,0,1525,305,1118,74,16,0,0,0,1513,3038
44,Ascoli Piceno,46,534,991,65,5,0,0,0,1595,347,1204,88,19,0,0,0,1658,3253
44,Ascoli Piceno,47,466,1036,56,6,1,0,0,1565,297,1205,92,24,0,0,0,1618,3183
44,Ascoli Piceno,48,451,1005,63,5,0,0,0,1524,277,1261,105,29,0,0,0,1672,3196
44,Ascoli Piceno,49,434,1065,86,8,1,0,0,1594,286,1269,127,23,0,0,0,1705,3299
44,Ascoli Piceno,50,404,1182,81,11,2,0,0,1680,258,1290,122,40,0,0,0,1710,3390
44,Ascoli Piceno,51,359,1156,90,7,2,0,0,1614,207,1326,109,41,0,0,0,1683,3297
44,Ascoli Piceno,52,309,1142,74,14,2,0,0,1541,215,1309,118,55,0,0,0,1697,3238
44,Ascoli Piceno,53,300,1301,87,13,1,0,0,1702,211,1366,108,52,0,0,0,1737,3439
44,Ascoli Piceno,54,278,1350,74,14,0,0,0,1716,220,1439,127,63,0,1,0,1850,3566
44,Ascoli Piceno,55,251,1217,100,11,2,0,0,1581,176,1385,116,63,0,0,0,1740,3321
44,Ascoli Piceno,56,223,1204,82,13,0,0,0,1522,157,1227,108,87,0,0,0,1579,3101
44,Ascoli Piceno,57,205,1196,104,16,0,0,0,1521,174,1206,108,79,1,0,0,1568,3089
44,Ascoli Piceno,58,176,1212,74,24,3,0,0,1489,160,1232,105,91,0,0,0,1588,3077
44,Ascoli Piceno,59,179,1152,59,15,2,0,0,1407,158,1201,85,107,1,0,0,1552,2959
44,Ascoli Piceno,60,170,1099,55,24,0,0,0,1348,146,1229,102,120,0,0,0,1597,2945
44,Ascoli Piceno,61,142,1107,65,27,0,0,0,1341,131,1185,86,109,0,0,0,1511,2852
44,Ascoli Piceno,62,158,1102,67,23,0,0,0,1350,117,1149,76,162,0,0,0,1504,2854
44,Ascoli Piceno,63,127,1080,49,23,0,0,0,1279,124,1113,66,165,0,0,0,1468,2747
44,Ascoli Piceno,64,129,996,57,39,1,0,0,1222,103,1090,56,140,0,0,0,1389,2611
44,Ascoli Piceno,65,100,1043,52,30,0,0,0,1225,107,1021,59,181,0,0,0,1368,2593
44,Ascoli Piceno,66,116,1019,37,32,0,0,0,1204,90,1031,47,185,0,0,0,1353,2557
44,Ascoli Piceno,67,93,1002,50,41,0,0,0,1186,67,983,43,214,0,0,0,1307,2493
44,Ascoli Piceno,68,78,1074,46,49,0,0,0,1247,72,982,38,237,0,0,0,1329,2576
44,Ascoli Piceno,69,84,1026,33,44,0,0,0,1187,68,987,38,219,0,0,0,1312,2499
44,Ascoli Piceno,70,75,1041,23,48,0,0,0,1187,83,966,27,326,0,0,0,1402,2589
44,Ascoli Piceno,71,69,988,39,58,0,0,0,1154,79,891,40,333,0,0,0,1343,2497
44,Ascoli Piceno,72,65,953,23,58,0,0,0,1099,79,826,43,326,0,0,0,1274,2373
44,Ascoli Piceno,73,65,792,23,53,1,0,0,934,42,695,25,339,0,0,0,1101,2035
44,Ascoli Piceno,74,58,757,18,52,0,0,0,885,50,541,19,334,0,0,0,944,1829
44,Ascoli Piceno,75,64,828,22,72,0,0,0,986,48,598,21,409,0,0,0,1076,2062
44,Ascoli Piceno,76,49,772,22,62,0,0,0,905,49,576,17,429,0,0,0,1071,1976
44,Ascoli Piceno,77,59,721,22,67,0,0,0,869,77,541,13,438,0,0,0,1069,1938
44,Ascoli Piceno,78,63,819,17,99,0,0,0,998,72,566,23,561,0,0,0,1222,2220
44,Ascoli Piceno,79,57,794,12,104,0,0,0,967,52,532,15,585,0,0,0,1184,2151
44,Ascoli Piceno,80,43,761,9,108,0,0,0,921,68,490,20,620,0,0,0,1198,2119
44,Ascoli Piceno,81,47,664,9,103,0,0,0,823,53,386,8,596,0,0,0,1043,1866
44,Ascoli Piceno,82,39,580,3,89,0,0,0,711,60,325,10,583,0,0,0,978,1689
44,Ascoli Piceno,83,36,541,2,111,0,0,0,690,41,257,10,652,0,0,0,960,1650
44,Ascoli Piceno,84,32,488,5,96,0,0,0,621,50,227,5,587,0,0,0,869,1490
44,Ascoli Piceno,85,25,472,8,97,0,0,0,602,48,193,8,634,0,0,0,883,1485
44,Ascoli Piceno,86,23,333,3,95,0,0,0,454,47,141,2,503,0,0,0,693,1147
44,Ascoli Piceno,87,21,296,3,106,0,0,0,426,49,97,7,564,0,0,0,717,1143
44,Ascoli Piceno,88,14,248,4,102,0,0,0,368,35,82,2,570,0,0,0,689,1057
44,Ascoli Piceno,89,20,206,2,98,0,0,0,326,30,53,3,447,0,0,0,533,859
44,Ascoli Piceno,90,11,158,0,68,0,0,0,237,34,40,5,408,0,0,0,487,724
44,Ascoli Piceno,91,8,110,1,66,0,0,0,185,36,30,2,373,0,0,0,441,626
44,Ascoli Piceno,92,4,94,1,59,0,0,0,158,35,28,0,308,0,0,0,371,529
44,Ascoli Piceno,93,2,76,0,51,0,0,0,129,24,17,1,274,0,0,0,316,445
44,Ascoli Piceno,94,5,33,0,33,0,0,0,71,24,12,1,185,0,0,0,222,293
44,Ascoli Piceno,95,5,23,0,30,0,0,0,58,17,6,1,152,0,0,0,176,234
44,Ascoli Piceno,96,3,16,0,21,0,0,0,40,8,4,0,109,0,0,0,121,161
44,Ascoli Piceno,97,1,15,0,9,0,0,0,25,9,5,0,85,0,0,0,99,124
44,Ascoli Piceno,98,2,7,0,12,0,0,0,21,4,0,0,58,0,0,0,62,83
44,Ascoli Piceno,99,2,2,0,9,0,0,0,13,4,0,0,25,0,0,0,29,42
44,Ascoli Piceno,100,1,2,0,4,0,0,0,7,4,0,1,43,0,0,0,48,55
45,Massa-Carrara,0,571,0,0,0,0,0,0,571,535,0,0,0,0,0,0,535,1106
45,Massa-Carrara,1,636,0,0,0,0,0,0,636,603,0,0,0,0,0,0,603,1239
45,Massa-Carrara,2,616,0,0,0,0,0,0,616,602,0,0,0,0,0,0,602,1218
45,Massa-Carrara,3,643,0,0,0,0,0,0,643,563,0,0,0,0,0,0,563,1206
45,Massa-Carrara,4,665,0,0,0,0,0,0,665,659,0,0,0,0,0,0,659,1324
45,Massa-Carrara,5,736,0,0,0,0,0,0,736,691,0,0,0,0,0,0,691,1427
45,Massa-Carrara,6,784,0,0,0,0,0,0,784,746,0,0,0,0,0,0,746,1530
45,Massa-Carrara,7,758,0,0,0,0,0,0,758,785,0,0,0,0,0,0,785,1543
45,Massa-Carrara,8,775,0,0,0,0,0,0,775,780,0,0,0,0,0,0,780,1555
45,Massa-Carrara,9,755,0,0,0,0,0,0,755,722,0,0,0,0,0,0,722,1477
45,Massa-Carrara,10,887,0,0,0,0,0,0,887,811,0,0,0,0,0,0,811,1698
45,Massa-Carrara,11,828,0,0,0,0,0,0,828,788,0,0,0,0,0,0,788,1616
45,Massa-Carrara,12,874,0,0,0,0,0,0,874,765,0,0,0,0,0,0,765,1639
45,Massa-Carrara,13,860,0,0,0,0,0,0,860,755,0,0,0,0,0,0,755,1615
45,Massa-Carrara,14,782,0,0,0,0,0,0,782,773,0,0,0,0,0,0,773,1555
45,Massa-Carrara,15,799,0,0,0,0,0,0,799,762,0,0,0,0,0,0,762,1561
45,Massa-Carrara,16,876,0,0,0,0,0,0,876,774,0,0,0,0,0,0,774,1650
45,Massa-Carrara,17,826,0,0,0,0,0,0,826,758,0,0,0,0,0,0,758,1584
45,Massa-Carrara,18,846,0,0,0,0,0,0,846,729,0,0,0,0,0,0,729,1575
45,Massa-Carrara,19,828,0,0,0,0,0,0,828,768,3,0,0,0,0,0,771,1599
45,Massa-Carrara,20,881,1,0,0,0,0,0,882,789,7,0,0,0,0,0,796,1678
45,Massa-Carrara,21,841,1,0,0,0,0,0,842,719,15,0,0,0,0,0,734,1576
45,Massa-Carrara,22,874,6,0,0,0,0,0,880,771,19,0,0,0,0,0,790,1670
45,Massa-Carrara,23,907,2,0,0,0,0,0,909,780,26,1,0,0,0,0,807,1716
45,Massa-Carrara,24,824,10,0,0,0,0,0,834,762,50,0,0,0,0,0,812,1646
45,Massa-Carrara,25,893,13,0,0,0,0,0,906,739,82,3,0,0,0,0,824,1730
45,Massa-Carrara,26,873,30,0,0,0,0,0,903,738,108,1,0,0,0,0,847,1750
45,Massa-Carrara,27,890,55,0,1,1,0,0,947,722,153,3,0,0,0,0,878,1825
45,Massa-Carrara,28,851,74,0,0,0,0,0,925,719,185,4,2,0,0,0,910,1835
45,Massa-Carrara,29,832,104,5,0,0,0,0,941,659,207,9,0,0,0,0,875,1816
45,Massa-Carrara,30,821,170,2,0,1,0,0,994,614,280,5,1,0,0,0,900,1894
45,Massa-Carrara,31,753,175,2,0,1,0,0,931,590,337,7,1,0,0,0,935,1866
45,Massa-Carrara,32,748,222,10,0,2,0,0,982,506,377,15,1,1,0,0,900,1882
45,Massa-Carrara,33,708,262,7,0,1,0,0,978,522,432,20,3,2,0,0,979,1957
45,Massa-Carrara,34,762,310,12,1,0,0,0,1085,507,491,15,3,0,0,0,1016,2101
45,Massa-Carrara,35,700,352,15,1,1,0,0,1069,488,537,20,1,1,0,0,1047,2116
45,Massa-Carrara,36,647,402,18,1,1,0,0,1069,439,578,29,4,0,0,0,1050,2119
45,Massa-Carrara,37,587,473,21,1,4,0,0,1086,423,611,47,5,0,0,0,1086,2172
45,Massa-Carrara,38,665,517,25,1,1,0,0,1209,421,608,50,3,0,0,0,1082,2291
45,Massa-Carrara,39,606,534,27,0,3,0,0,1170,441,662,64,8,1,0,0,1176,2346
45,Massa-Carrara,40,605,585,31,0,0,0,0,1221,408,690,70,9,1,0,0,1178,2399
45,Massa-Carrara,41,646,670,42,1,0,0,0,1359,441,824,80,8,1,0,0,1354,2713
45,Massa-Carrara,42,629,727,56,0,0,0,0,1412,414,850,83,8,2,0,0,1357,2769
45,Massa-Carrara,43,596,796,56,3,0,0,0,1451,438,937,103,12,1,0,0,1491,2942
45,Massa-Carrara,44,590,786,57,4,1,0,0,1438,395,992,119,20,2,0,0,1528,2966
45,Massa-Carrara,45,558,855,72,1,1,0,0,1487,343,1038,110,19,1,0,0,1511,2998
45,Massa-Carrara,46,547,915,75,5,1,0,0,1543,338,1064,110,18,0,0,0,1530,3073
45,Massa-Carrara,47,505,933,80,5,1,0,0,1524,365,985,124,25,1,0,0,1500,3024
45,Massa-Carrara,48,455,964,94,2,1,0,0,1516,294,1110,148,27,1,0,0,1580,3096
45,Massa-Carrara,49,479,1008,116,6,2,0,0,1611,332,1157,156,27,1,0,0,1673,3284
45,Massa-Carrara,50,391,992,108,7,2,0,0,1500,281,1114,138,43,1,0,0,1577,3077
45,Massa-Carrara,51,389,1008,105,7,1,0,0,1510,266,1144,140,31,3,0,0,1584,3094
45,Massa-Carrara,52,387,1080,117,18,2,0,0,1604,222,1183,162,54,0,0,0,1621,3225
45,Massa-Carrara,53,376,1169,124,11,3,0,0,1683,236,1184,165,46,0,0,0,1631,3314
45,Massa-Carrara,54,313,1227,143,15,4,0,0,1702,211,1278,169,72,1,0,0,1731,3433
45,Massa-Carrara,55,250,1216,140,10,2,0,0,1618,191,1276,177,58,1,0,0,1703,3321
45,Massa-Carrara,56,271,1154,133,19,0,0,0,1577,187,1170,152,61,2,0,0,1572,3149
45,Massa-Carrara,57,259,1073,116,23,0,0,0,1471,157,1222,134,95,0,0,0,1608,3079
45,Massa-Carrara,58,200,1061,102,11,0,0,0,1374,150,1096,140,84,0,0,0,1470,2844
45,Massa-Carrara,59,192,1113,122,18,0,0,0,1445,138,1122,125,94,2,0,0,1481,2926
45,Massa-Carrara,60,188,1052,86,35,3,0,0,1364,140,1203,117,130,1,0,0,1591,2955
45,Massa-Carrara,61,186,1075,90,20,1,0,0,1372,126,1114,112,154,0,0,0,1506,2878
45,Massa-Carrara,62,171,1115,85,19,0,0,0,1390,103,1073,95,181,0,0,0,1452,2842
45,Massa-Carrara,63,144,1038,91,35,1,0,0,1309,121,1106,85,148,0,0,0,1460,2769
45,Massa-Carrara,64,155,1044,72,31,1,0,0,1303,98,990,81,178,0,0,0,1347,2650
45,Massa-Carrara,65,107,999,49,38,0,0,0,1193,91,971,65,213,0,0,0,1340,2533
45,Massa-Carrara,66,91,1008,47,37,0,0,0,1183,85,883,68,204,0,0,0,1240,2423
45,Massa-Carrara,67,105,939,61,49,0,0,0,1154,73,871,61,183,0,0,0,1188,2342
45,Massa-Carrara,68,103,1020,67,49,0,0,0,1239,89,876,71,255,0,0,0,1291,2530
45,Massa-Carrara,69,107,1002,51,71,1,0,0,1232,65,891,79,278,0,0,0,1313,2545
45,Massa-Carrara,70,114,1020,61,70,0,0,0,1265,74,932,64,328,0,0,0,1398,2663
45,Massa-Carrara,71,85,1075,52,65,1,0,0,1278,61,972,56,387,0,0,0,1476,2754
45,Massa-Carrara,72,95,1077,47,78,0,0,0,1297,56,889,62,411,0,0,0,1418,2715
45,Massa-Carrara,73,49,626,33,56,0,0,0,764,45,589,32,285,0,0,0,951,1715
45,Massa-Carrara,74,61,797,21,81,0,0,0,960,52,715,53,411,0,0,0,1231,2191
45,Massa-Carrara,75,59,753,30,84,0,0,0,926,44,613,26,365,0,0,0,1048,1974
45,Massa-Carrara,76,63,778,27,72,0,0,0,940,40,584,25,406,0,0,0,1055,1995
45,Massa-Carrara,77,76,786,22,86,0,0,0,970,51,659,31,484,0,0,0,1225,2195
45,Massa-Carrara,78,70,802,27,108,0,0,0,1007,56,642,35,631,0,0,0,1364,2371
45,Massa-Carrara,79,58,723,18,114,0,0,0,913,52,527,22,552,0,0,0,1153,2066
45,Massa-Carrara,80,61,709,18,119,0,0,0,907,51,413,11,651,0,0,0,1126,2033
45,Massa-Carrara,81,64,574,15,124,0,0,0,777,42,422,17,612,0,0,0,1093,1870
45,Massa-Carrara,82,41,484,9,116,0,0,0,650,57,333,15,582,0,0,0,987,1637
45,Massa-Carrara,83,31,437,8,104,0,0,0,580,52,275,11,638,0,0,0,976,1556
45,Massa-Carrara,84,33,377,5,106,0,0,0,521,42,218,13,608,0,0,0,881,1402
45,Massa-Carrara,85,32,352,6,101,0,0,0,491,40,171,13,595,0,0,0,819,1310
45,Massa-Carrara,86,28,296,1,120,0,0,0,445,41,150,9,596,0,0,0,796,1241
45,Massa-Carrara,87,20,236,4,90,0,0,0,350,33,101,12,561,0,0,0,707,1057
45,Massa-Carrara,88,22,226,8,101,0,0,0,357,44,86,12,570,0,0,0,712,1069
45,Massa-Carrara,89,17,168,3,91,0,0,0,279,42,55,6,513,0,0,0,616,895
45,Massa-Carrara,90,12,110,1,68,0,0,0,191,29,49,6,495,0,0,0,579,770
45,Massa-Carrara,91,13,88,1,66,0,0,0,168,21,22,3,383,0,0,0,429,597
45,Massa-Carrara,92,3,56,0,61,0,0,0,120,26,17,2,329,0,0,0,374,494
45,Massa-Carrara,93,5,44,1,39,0,0,0,89,17,10,2,286,0,0,0,315,404
45,Massa-Carrara,94,4,25,0,39,0,0,0,68,16,6,1,205,0,0,0,228,296
45,Massa-Carrara,95,6,11,0,22,0,0,0,39,15,8,0,153,0,0,0,176,215
45,Massa-Carrara,96,2,12,0,13,0,0,0,27,7,2,2,142,0,0,0,153,180
45,Massa-Carrara,97,2,7,0,17,0,0,0,26,12,4,0,68,0,0,0,84,110
45,Massa-Carrara,98,0,3,0,6,0,0,0,9,5,3,0,74,0,0,0,82,91
45,Massa-Carrara,99,1,1,0,6,0,0,0,8,2,0,0,29,0,0,0,31,39
45,Massa-Carrara,100,0,4,0,10,0,0,0,14,2,1,0,60,0,0,0,63,77
46,Lucca,0,1222,0,0,0,0,0,0,1222,1198,0,0,0,0,0,0,1198,2420
46,Lucca,1,1343,0,0,0,0,0,0,1343,1220,0,0,0,0,0,0,1220,2563
46,Lucca,2,1387,0,0,0,0,0,0,1387,1326,0,0,0,0,0,0,1326,2713
46,Lucca,3,1419,0,0,0,0,0,0,1419,1311,0,0,0,0,0,0,1311,2730
46,Lucca,4,1451,0,0,0,0,0,0,1451,1406,0,0,0,0,0,0,1406,2857
46,Lucca,5,1544,0,0,0,0,0,0,1544,1461,0,0,0,0,0,0,1461,3005
46,Lucca,6,1651,0,0,0,0,0,0,1651,1599,0,0,0,0,0,0,1599,3250
46,Lucca,7,1608,0,0,0,0,0,0,1608,1592,0,0,0,0,0,0,1592,3200
46,Lucca,8,1696,0,0,0,0,0,0,1696,1607,0,0,0,0,0,0,1607,3303
46,Lucca,9,1734,0,0,0,0,0,0,1734,1558,0,0,0,0,0,0,1558,3292
46,Lucca,10,1817,0,0,0,0,0,0,1817,1761,0,0,0,0,0,0,1761,3578
46,Lucca,11,1799,0,0,0,0,0,0,1799,1663,0,0,0,0,0,0,1663,3462
46,Lucca,12,1764,0,0,0,0,0,0,1764,1694,0,0,0,0,0,0,1694,3458
46,Lucca,13,1798,0,0,0,0,0,0,1798,1679,0,0,0,0,0,0,1679,3477
46,Lucca,14,1687,0,0,0,0,0,0,1687,1662,0,0,0,0,0,0,1662,3349
46,Lucca,15,1721,0,0,0,0,0,0,1721,1613,0,0,0,0,0,0,1613,3334
46,Lucca,16,1718,0,0,0,0,0,0,1718,1617,0,0,0,0,0,0,1617,3335
46,Lucca,17,1767,0,0,0,0,0,0,1767,1646,0,0,0,0,0,0,1646,3413
46,Lucca,18,1705,0,0,0,0,0,0,1705,1595,1,0,0,0,0,0,1596,3301
46,Lucca,19,1795,0,0,0,0,0,0,1795,1562,4,0,0,0,0,0,1566,3361
46,Lucca,20,1881,1,0,0,0,0,0,1882,1604,18,0,0,0,0,0,1622,3504
46,Lucca,21,1818,3,0,0,0,0,0,1821,1547,33,0,0,0,0,0,1580,3401
46,Lucca,22,1794,10,0,0,2,0,0,1806,1637,48,1,1,0,0,0,1687,3493
46,Lucca,23,1818,11,1,0,0,0,0,1830,1498,88,0,0,0,0,0,1586,3416
46,Lucca,24,1751,23,1,0,0,0,0,1775,1557,91,2,0,0,0,0,1650,3425
46,Lucca,25,1792,38,0,0,0,0,0,1830,1534,154,4,0,1,0,0,1693,3523
46,Lucca,26,1800,74,2,0,2,0,0,1878,1513,218,3,0,0,0,0,1734,3612
46,Lucca,27,1744,96,1,0,3,0,0,1844,1475,282,5,0,0,0,0,1762,3606
46,Lucca,28,1756,145,0,0,2,0,0,1903,1445,387,9,0,1,0,0,1842,3745
46,Lucca,29,1570,208,4,1,1,0,0,1784,1217,461,6,1,1,0,0,1686,3470
46,Lucca,30,1573,333,7,0,1,0,0,1914,1291,605,16,1,5,0,0,1918,3832
46,Lucca,31,1448,368,6,0,1,0,0,1823,1072,701,21,1,5,0,0,1800,3623
46,Lucca,32,1381,493,9,0,1,0,0,1884,998,730,28,2,2,0,0,1760,3644
46,Lucca,33,1323,572,18,0,1,0,0,1914,1040,883,40,7,1,0,0,1971,3885
46,Lucca,34,1275,699,19,0,2,0,0,1995,921,986,31,5,4,0,0,1947,3942
46,Lucca,35,1217,764,30,1,3,0,0,2015,908,1048,66,5,2,0,0,2029,4044
46,Lucca,36,1237,832,28,0,4,0,0,2101,927,1160,57,4,3,0,0,2151,4252
46,Lucca,37,1199,951,40,0,2,0,0,2192,856,1213,104,1,2,0,0,2176,4368
46,Lucca,38,1149,1059,67,2,0,0,0,2277,859,1347,100,14,3,0,0,2323,4600
46,Lucca,39,1154,1144,61,1,2,0,0,2362,818,1463,91,10,0,0,0,2382,4744
46,Lucca,40,1103,1279,60,2,4,0,0,2448,872,1588,128,11,5,0,1,2605,5053
46,Lucca,41,1217,1363,82,3,2,0,0,2667,808,1684,144,14,5,1,1,2657,5324
46,Lucca,42,1134,1529,98,5,5,0,0,2771,827,1808,152,15,4,0,0,2806,5577
46,Lucca,43,1192,1617,114,4,5,0,0,2932,877,1954,205,21,4,0,0,3061,5993
46,Lucca,44,1152,1707,133,6,3,0,0,3001,810,2062,209,32,4,0,0,3117,6118
46,Lucca,45,1088,1806,147,14,3,0,0,3058,776,2109,249,31,2,0,0,3167,6225
46,Lucca,46,997,1885,172,6,4,0,0,3064,692,2214,274,36,8,0,0,3224,6288
46,Lucca,47,992,1927,207,4,6,0,0,3136,706,2233,305,49,1,0,0,3294,6430
46,Lucca,48,969,1974,196,7,4,0,0,3150,617,2240,279,50,4,0,0,3190,6340
46,Lucca,49,844,2092,250,6,5,0,0,3197,629,2360,320,69,0,0,0,3378,6575
46,Lucca,50,765,2212,232,17,4,0,0,3230,569,2377,318,62,4,0,0,3330,6560
46,Lucca,51,761,2172,242,21,0,0,0,3196,520,2357,357,89,3,0,0,3326,6522
46,Lucca,52,710,2235,271,21,4,0,0,3241,517,2394,341,83,2,0,0,3337,6578
46,Lucca,53,679,2317,271,24,4,0,0,3295,530,2530,359,118,3,0,0,3540,6835
46,Lucca,54,618,2342,295,32,4,0,0,3291,448,2531,383,134,1,0,0,3497,6788
46,Lucca,55,545,2308,288,28,5,0,0,3174,351,2362,354,144,0,0,0,3211,6385
46,Lucca,56,536,2134,226,30,6,0,0,2932,355,2253,333,167,2,0,0,3110,6042
46,Lucca,57,438,2178,231,36,2,0,0,2885,340,2277,346,168,0,0,0,3131,6016
46,Lucca,58,439,2189,284,42,4,0,0,2958,312,2168,303,167,3,0,0,2953,5911
46,Lucca,59,385,2059,211,45,4,0,0,2704,266,2165,290,204,1,0,0,2926,5630
46,Lucca,60,324,1997,207,49,3,0,0,2580,259,2094,235,179,0,0,0,2767,5347
46,Lucca,61,307,1898,198,40,1,0,0,2444,236,2048,244,215,1,0,0,2744,5188
46,Lucca,62,298,1936,206,65,4,0,0,2509,187,1922,222,240,1,1,0,2573,5082
46,Lucca,63,271,1814,178,65,6,0,0,2334,175,1941,190,272,1,0,0,2579,4913
46,Lucca,64,249,1945,180,54,2,0,0,2430,194,1873,229,292,1,0,0,2589,5019
46,Lucca,65,222,1863,169,71,0,0,0,2325,173,1774,182,324,0,0,1,2454,4779
46,Lucca,66,218,1811,133,82,1,0,0,2245,173,1868,156,368,0,0,0,2565,4810
46,Lucca,67,185,1814,135,78,3,0,0,2215,118,1823,170,370,0,0,0,2481,4696
46,Lucca,68,209,1899,125,93,3,0,0,2329,141,1730,156,425,0,0,0,2452,4781
46,Lucca,69,190,1901,114,103,2,0,0,2310,140,1723,126,493,0,0,0,2482,4792
46,Lucca,70,219,2045,127,109,1,0,0,2501,165,1876,135,559,0,0,0,2735,5236
46,Lucca,71,205,1970,107,148,1,0,0,2431,137,1850,122,629,0,0,0,2738,5169
46,Lucca,72,191,2020,87,183,0,0,0,2481,124,1796,111,753,1,0,0,2785,5266
46,Lucca,73,136,1456,77,137,3,0,0,1809,100,1312,90,567,0,0,0,2069,3878
46,Lucca,74,151,1545,62,148,1,0,0,1907,119,1299,84,740,1,0,0,2243,4150
46,Lucca,75,127,1486,52,175,1,0,0,1841,101,1188,73,748,1,0,0,2111,3952
46,Lucca,76,142,1419,52,166,4,0,0,1783,111,1196,71,801,0,0,0,2179,3962
46,Lucca,77,129,1481,46,174,2,0,0,1832,102,1135,64,887,0,0,0,2188,4020
46,Lucca,78,147,1398,37,216,2,0,0,1800,119,1163,70,1053,0,0,0,2405,4205
46,Lucca,79,128,1332,39,182,0,0,0,1681,125,1039,38,1036,0,0,0,2238,3919
46,Lucca,80,103,1340,35,243,0,0,0,1721,107,916,50,1112,0,0,0,2185,3906
46,Lucca,81,122,1094,27,227,0,0,0,1470,107,726,37,1047,0,0,0,1917,3387
46,Lucca,82,86,934,33,238,1,0,0,1292,95,606,46,1048,1,0,1,1797,3089
46,Lucca,83,77,930,22,242,0,0,0,1271,112,512,43,1102,0,0,0,1769,3040
46,Lucca,84,71,713,26,228,0,0,0,1038,98,438,21,1055,0,0,0,1612,2650
46,Lucca,85,64,644,13,197,0,0,0,918,102,326,22,1067,0,0,0,1517,2435
46,Lucca,86,56,524,11,214,0,0,0,805,97,278,20,982,0,0,0,1377,2182
46,Lucca,87,48,427,6,171,0,0,0,652,113,210,19,993,0,0,0,1335,1987
46,Lucca,88,53,387,10,191,0,0,0,641,77,176,12,1018,0,0,0,1283,1924
46,Lucca,89,28,279,7,149,0,0,0,463,69,121,11,844,0,0,0,1045,1508
46,Lucca,90,29,222,3,138,0,0,0,392,74,95,4,739,0,0,0,912,1304
46,Lucca,91,22,146,2,116,0,0,0,286,70,62,11,660,0,0,0,803,1089
46,Lucca,92,15,115,3,96,0,0,0,229,62,40,8,558,0,0,0,668,897
46,Lucca,93,13,74,1,73,0,0,0,161,49,24,4,483,0,0,0,560,721
46,Lucca,94,6,61,1,62,0,0,0,130,56,23,3,376,0,0,0,458,588
46,Lucca,95,5,46,0,64,0,0,0,115,36,19,0,277,0,0,0,332,447
46,Lucca,96,4,15,2,35,0,0,0,56,17,6,2,222,0,0,0,247,303
46,Lucca,97,1,13,2,26,0,0,0,42,16,9,0,148,0,0,0,173,215
46,Lucca,98,1,7,0,15,0,0,0,23,10,5,1,112,0,0,0,128,151
46,Lucca,99,1,3,0,6,0,0,0,10,3,1,0,58,0,0,0,62,72
46,Lucca,100,0,0,0,11,0,0,0,11,7,4,1,74,0,0,0,86,97
47,Pistoia,0,1051,0,0,0,0,0,0,1051,974,0,0,0,0,0,0,974,2025
47,Pistoia,1,1073,0,0,0,0,0,0,1073,1012,0,0,0,0,0,0,1012,2085
47,Pistoia,2,1099,0,0,0,0,0,0,1099,1006,0,0,0,0,0,0,1006,2105
47,Pistoia,3,1191,0,0,0,0,0,0,1191,1065,0,0,0,0,0,0,1065,2256
47,Pistoia,4,1194,0,0,0,0,0,0,1194,1163,0,0,0,0,0,0,1163,2357
47,Pistoia,5,1176,0,0,0,0,0,0,1176,1150,0,0,0,0,0,0,1150,2326
47,Pistoia,6,1282,0,0,0,0,0,0,1282,1186,0,0,0,0,0,0,1186,2468
47,Pistoia,7,1357,0,0,0,0,0,0,1357,1237,0,0,0,0,0,0,1237,2594
47,Pistoia,8,1326,0,0,0,0,0,0,1326,1254,0,0,0,0,0,0,1254,2580
47,Pistoia,9,1356,0,0,0,0,0,0,1356,1268,0,0,0,0,0,0,1268,2624
47,Pistoia,10,1422,0,0,0,0,0,0,1422,1322,0,0,0,0,0,0,1322,2744
47,Pistoia,11,1392,0,0,0,0,0,0,1392,1262,0,0,0,0,0,0,1262,2654
47,Pistoia,12,1319,0,0,0,0,0,0,1319,1291,0,0,0,0,0,0,1291,2610
47,Pistoia,13,1336,0,0,0,0,0,0,1336,1259,0,0,0,0,0,0,1259,2595
47,Pistoia,14,1317,0,0,0,0,0,0,1317,1287,0,0,0,0,0,0,1287,2604
47,Pistoia,15,1292,0,0,0,0,0,0,1292,1225,0,0,0,0,0,0,1225,2517
47,Pistoia,16,1390,0,0,0,0,0,0,1390,1186,0,0,0,0,0,0,1186,2576
47,Pistoia,17,1267,0,0,0,0,0,0,1267,1266,0,0,0,0,0,0,1266,2533
47,Pistoia,18,1360,0,0,0,0,0,0,1360,1285,3,0,0,0,0,0,1288,2648
47,Pistoia,19,1339,1,0,0,0,0,0,1340,1184,13,0,0,1,0,0,1198,2538
47,Pistoia,20,1400,2,0,0,0,0,0,1402,1209,31,0,0,0,0,0,1240,2642
47,Pistoia,21,1341,1,0,0,0,0,0,1342,1220,48,0,0,0,0,0,1268,2610
47,Pistoia,22,1332,5,0,0,0,0,0,1337,1143,75,0,0,0,0,0,1218,2555
47,Pistoia,23,1284,10,0,0,0,0,0,1294,1096,107,2,0,0,0,0,1205,2499
47,Pistoia,24,1304,30,0,0,0,0,0,1334,1090,104,1,1,0,0,0,1196,2530
47,Pistoia,25,1277,36,0,0,0,0,0,1313,1113,165,1,0,0,0,0,1279,2592
47,Pistoia,26,1273,80,3,0,0,0,0,1356,1145,237,1,0,1,0,1,1385,2741
47,Pistoia,27,1321,91,0,0,0,0,0,1412,1040,285,3,0,0,0,0,1328,2740
47,Pistoia,28,1285,155,2,0,0,0,0,1442,1029,356,5,1,0,0,0,1391,2833
47,Pistoia,29,1250,215,2,0,0,0,0,1467,998,410,4,2,1,0,0,1415,2882
47,Pistoia,30,1213,271,3,0,0,0,0,1487,931,525,19,1,1,0,0,1477,2964
47,Pistoia,31,1041,370,1,1,1,0,0,1414,914,584,17,1,1,0,0,1517,2931
47,Pistoia,32,1034,409,3,1,1,0,0,1448,849,750,18,2,1,0,0,1620,3068
47,Pistoia,33,1002,501,10,0,3,0,0,1516,817,757,25,2,2,0,0,1603,3119
47,Pistoia,34,1017,573,21,0,2,0,0,1613,712,763,30,4,1,0,0,1510,3123
47,Pistoia,35,960,704,20,2,0,0,0,1686,708,879,48,3,1,0,0,1639,3325
47,Pistoia,36,873,739,17,1,0,0,0,1630,680,992,44,7,1,0,0,1724,3354
47,Pistoia,37,806,808,25,0,1,0,0,1640,632,1083,43,5,2,0,0,1765,3405
47,Pistoia,38,791,870,36,0,2,0,0,1699,648,1156,60,7,1,0,0,1872,3571
47,Pistoia,39,856,973,39,3,1,0,0,1872,638,1204,64,9,1,0,0,1916,3788
47,Pistoia,40,872,1077,42,1,1,0,0,1993,606,1289,86,14,2,0,0,1997,3990
47,Pistoia,41,813,1135,65,6,2,0,0,2021,696,1370,90,22,0,0,0,2178,4199
47,Pistoia,42,832,1175,55,2,1,0,0,2065,669,1440,108,11,1,0,0,2229,4294
47,Pistoia,43,823,1329,70,5,1,0,0,2228,640,1567,127,12,1,0,0,2347,4575
47,Pistoia,44,807,1402,79,5,7,0,0,2300,567,1646,142,30,2,0,0,2387,4687
47,Pistoia,45,760,1473,90,5,1,0,0,2329,530,1697,152,22,2,0,0,2403,4732
47,Pistoia,46,757,1475,102,10,0,0,0,2344,487,1608,183,33,3,0,0,2314,4658
47,Pistoia,47,669,1592,113,11,2,0,0,2387,458,1816,206,25,2,0,0,2507,4894
47,Pistoia,48,614,1605,119,13,0,0,0,2351,452,1713,212,33,1,0,0,2411,4762
47,Pistoia,49,591,1670,143,13,0,0,0,2417,393,1803,186,36,1,0,0,2419,4836
47,Pistoia,50,549,1584,138,8,2,0,0,2281,411,1821,195,43,2,0,0,2472,4753
47,Pistoia,51,497,1641,138,11,2,0,0,2289,392,1832,207,42,2,0,0,2475,4764
47,Pistoia,52,456,1686,155,13,1,0,0,2311,335,1830,220,55,3,0,0,2443,4754
47,Pistoia,53,423,1752,150,17,2,0,0,2344,319,1779,213,46,2,0,0,2359,4703
47,Pistoia,54,422,1796,198,20,0,0,0,2436,273,1907,210,67,2,0,0,2459,4895
47,Pistoia,55,318,1701,153,15,2,0,0,2189,272,1782,205,84,1,0,0,2344,4533
47,Pistoia,56,298,1731,167,28,3,0,0,2227,220,1710,211,95,0,0,0,2236,4463
47,Pistoia,57,276,1720,125,26,2,0,0,2149,173,1759,216,126,0,0,0,2274,4423
47,Pistoia,58,222,1628,179,27,0,0,0,2056,171,1752,166,125,0,0,0,2214,4270
47,Pistoia,59,243,1614,129,23,0,0,0,2009,173,1607,192,128,0,0,0,2100,4109
47,Pistoia,60,214,1517,131,36,1,0,0,1899,160,1555,171,154,1,0,0,2041,3940
47,Pistoia,61,168,1491,125,22,1,0,0,1807,145,1564,154,171,0,0,0,2034,3841
47,Pistoia,62,142,1468,115,40,0,0,0,1765,116,1474,149,182,0,0,0,1921,3686
47,Pistoia,63,164,1476,117,57,0,0,0,1814,129,1456,139,198,1,0,0,1923,3737
47,Pistoia,64,136,1438,94,45,1,0,0,1714,115,1412,117,195,0,0,0,1839,3553
47,Pistoia,65,139,1344,94,57,0,0,0,1634,118,1332,116,223,0,0,0,1789,3423
47,Pistoia,66,118,1345,81,54,1,0,0,1599,104,1393,145,209,0,0,0,1851,3450
47,Pistoia,67,125,1432,90,61,0,0,0,1708,101,1327,106,246,1,0,0,1781,3489
47,Pistoia,68,102,1371,101,74,0,0,0,1648,89,1282,104,304,1,0,0,1780,3428
47,Pistoia,69,110,1398,74,79,0,0,0,1661,98,1371,85,324,1,0,0,1879,3540
47,Pistoia,70,125,1502,78,84,0,0,0,1789,99,1443,102,362,0,0,0,2006,3795
47,Pistoia,71,104,1549,68,101,1,0,0,1823,95,1407,111,429,0,0,0,2042,3865
47,Pistoia,72,107,1481,43,113,0,0,0,1744,97,1391,76,488,0,0,0,2052,3796
47,Pistoia,73,66,1162,50,100,0,0,0,1378,73,1038,60,444,0,0,0,1615,2993
47,Pistoia,74,80,1096,53,94,0,0,0,1323,58,992,66,501,0,0,0,1617,2940
47,Pistoia,75,81,1160,34,107,0,0,0,1382,66,966,56,491,0,0,0,1579,2961
47,Pistoia,76,86,996,38,113,1,0,0,1234,65,865,45,548,0,0,0,1523,2757
47,Pistoia,77,70,991,37,116,0,0,0,1214,61,892,48,578,0,0,0,1579,2793
47,Pistoia,78,66,1072,30,148,1,0,0,1317,69,869,50,697,0,0,0,1685,3002
47,Pistoia,79,88,1063,30,161,0,0,0,1342,64,759,39,743,0,0,0,1605,2947
47,Pistoia,80,60,969,26,156,0,0,0,1211,65,725,31,748,0,0,0,1569,2780
47,Pistoia,81,57,894,22,172,0,0,0,1145,73,609,32,802,0,0,0,1516,2661
47,Pistoia,82,54,748,11,178,0,0,0,991,83,491,23,837,0,0,0,1434,2425
47,Pistoia,83,57,741,11,159,0,0,0,968,60,450,19,819,0,0,0,1348,2316
47,Pistoia,84,43,664,14,171,1,0,0,893,62,313,14,819,0,0,0,1208,2101
47,Pistoia,85,33,495,8,152,0,0,0,688,46,263,16,805,0,0,0,1130,1818
47,Pistoia,86,44,444,4,139,0,0,0,631,52,207,14,825,0,0,0,1098,1729
47,Pistoia,87,34,380,4,141,0,0,0,559,64,167,8,690,0,0,0,929,1488
47,Pistoia,88,27,319,8,145,0,0,0,499,58,134,12,760,0,0,0,964,1463
47,Pistoia,89,20,249,3,131,0,0,0,403,34,119,11,616,0,0,0,780,1183
47,Pistoia,90,19,189,3,103,0,0,0,314,50,72,7,606,0,0,0,735,1049
47,Pistoia,91,8,142,2,96,0,0,0,248,26,37,6,504,0,0,0,573,821
47,Pistoia,92,10,92,0,82,0,0,0,184,36,34,4,383,0,0,0,457,641
47,Pistoia,93,6,63,0,69,0,0,0,138,23,16,6,392,0,0,0,437,575
47,Pistoia,94,7,41,1,57,0,0,0,106,24,16,2,287,0,0,0,329,435
47,Pistoia,95,3,37,1,43,0,0,0,84,16,5,1,230,0,0,0,252,336
47,Pistoia,96,2,20,1,24,0,0,0,47,6,2,1,190,0,0,0,199,246
47,Pistoia,97,2,10,0,25,0,0,0,37,8,2,0,149,0,0,0,159,196
47,Pistoia,98,0,2,1,11,0,0,0,14,4,0,1,113,0,0,0,118,132
47,Pistoia,99,0,2,0,8,0,0,0,10,6,1,1,43,0,0,0,51,61
47,Pistoia,100,1,2,0,10,0,0,0,13,7,1,0,55,0,0,0,63,76
48,Firenze,0,3503,0,0,0,0,0,0,3503,3445,0,0,0,0,0,0,3445,6948
48,Firenze,1,3759,0,0,0,0,0,0,3759,3560,0,0,0,0,0,0,3560,7319
48,Firenze,2,3862,0,0,0,0,0,0,3862,3667,0,0,0,0,0,0,3667,7529
48,Firenze,3,3946,0,0,0,0,0,0,3946,3670,0,0,0,0,0,0,3670,7616
48,Firenze,4,4223,0,0,0,0,0,0,4223,3999,0,0,0,0,0,0,3999,8222
48,Firenze,5,4248,0,0,0,0,0,0,4248,3967,0,0,0,0,0,0,3967,8215
48,Firenze,6,4452,0,0,0,0,0,0,4452,4196,0,0,0,0,0,0,4196,8648
48,Firenze,7,4460,0,0,0,0,0,0,4460,4148,0,0,0,0,0,0,4148,8608
48,Firenze,8,4663,0,0,0,0,0,0,4663,4316,0,0,0,0,0,0,4316,8979
48,Firenze,9,4608,0,0,0,0,0,0,4608,4496,0,0,0,0,0,0,4496,9104
48,Firenze,10,4951,0,0,0,0,0,0,4951,4360,0,0,0,0,0,0,4360,9311
48,Firenze,11,4815,0,0,0,0,0,0,4815,4350,0,0,0,0,0,0,4350,9165
48,Firenze,12,4700,0,0,0,0,0,0,4700,4437,0,0,0,0,0,0,4437,9137
48,Firenze,13,4705,0,0,0,0,0,0,4705,4566,0,0,0,0,0,0,4566,9271
48,Firenze,14,4899,0,0,0,0,0,0,4899,4398,0,0,0,0,0,0,4398,9297
48,Firenze,15,4765,0,0,0,0,0,0,4765,4364,0,0,0,0,0,0,4364,9129
48,Firenze,16,4698,0,0,0,0,0,0,4698,4491,0,0,0,0,0,0,4491,9189
48,Firenze,17,4713,0,0,0,0,0,0,4713,4413,0,0,0,0,0,0,4413,9126
48,Firenze,18,4970,0,0,0,0,0,0,4970,4420,4,0,0,0,0,0,4424,9394
48,Firenze,19,4811,1,0,0,0,0,0,4812,4183,18,0,0,0,0,0,4201,9013
48,Firenze,20,4963,4,0,0,0,0,0,4967,4259,53,0,0,0,0,0,4312,9279
48,Firenze,21,4869,11,0,0,0,1,0,4881,4239,65,0,0,0,0,0,4304,9185
48,Firenze,22,4712,22,0,1,0,0,0,4735,4170,133,0,0,1,0,0,4304,9039
48,Firenze,23,4645,31,0,0,0,0,0,4676,4160,190,1,0,1,0,0,4352,9028
48,Firenze,24,4503,65,0,0,1,0,0,4569,4175,256,2,0,0,0,0,4433,9002
48,Firenze,25,4634,76,0,0,1,0,0,4711,3987,327,5,1,2,0,0,4322,9033
48,Firenze,26,4673,179,0,0,1,0,0,4853,4209,529,10,0,1,0,0,4749,9602
48,Firenze,27,4544,260,3,0,3,0,0,4810,4153,678,6,0,0,0,0,4837,9647
48,Firenze,28,4771,413,2,0,1,0,0,5187,4029,863,17,3,1,0,0,4913,10100
48,Firenze,29,4526,504,4,1,4,0,0,5039,4012,1125,17,2,0,0,0,5156,10195
48,Firenze,30,4511,766,8,0,3,0,0,5288,3831,1467,31,0,4,0,0,5333,10621
48,Firenze,31,4219,1036,13,0,2,0,0,5270,3491,1619,44,2,2,0,0,5158,10428
48,Firenze,32,3877,1163,15,0,2,0,0,5057,3332,1959,59,5,5,0,0,5360,10417
48,Firenze,33,3961,1402,34,0,5,0,0,5402,3288,2219,68,5,4,0,0,5584,10986
48,Firenze,34,3675,1685,35,2,2,0,0,5399,3170,2475,91,3,1,0,0,5740,11139
48,Firenze,35,3602,1916,49,1,7,0,0,5575,3103,2731,113,6,3,0,0,5956,11531
48,Firenze,36,3516,2194,58,3,4,0,0,5775,2923,2806,123,8,7,0,0,5867,11642
48,Firenze,37,3407,2387,66,2,5,0,0,5867,2719,3118,144,16,6,0,0,6003,11870
48,Firenze,38,3217,2525,102,3,5,0,0,5852,2705,3161,171,18,4,0,0,6059,11911
48,Firenze,39,3205,2884,131,8,7,0,0,6235,2736,3356,207,24,5,0,0,6328,12563
48,Firenze,40,3306,3074,115,6,4,0,0,6505,2817,3660,269,39,10,0,0,6795,13300
48,Firenze,41,3211,3408,130,7,4,0,0,6760,2696,3918,279,32,4,0,0,6929,13689
48,Firenze,42,3368,3536,196,5,5,0,0,7110,2696,4323,314,39,8,0,0,7380,14490
48,Firenze,43,3391,3791,228,10,9,0,0,7429,2747,4642,362,43,6,0,0,7800,15229
48,Firenze,44,3371,4307,262,12,14,0,0,7966,2769,5103,417,53,6,0,0,8348,16314
48,Firenze,45,3214,4430,250,14,9,0,0,7917,2783,5139,490,52,5,0,0,8469,16386
48,Firenze,46,2914,4749,307,22,10,0,0,8002,2501,5293,517,77,5,0,0,8393,16395
48,Firenze,47,2774,4936,355,24,6,0,0,8095,2409,5548,583,91,4,0,0,8635,16730
48,Firenze,48,2679,5034,383,24,6,0,0,8126,2220,5399,612,103,3,0,0,8337,16463
48,Firenze,49,2471,5222,448,27,11,0,1,8180,2228,5555,641,103,3,0,0,8530,16710
48,Firenze,50,2309,5258,445,26,16,0,0,8054,2080,5575,694,134,6,0,0,8489,16543
48,Firenze,51,2209,5405,495,40,5,0,0,8154,1938,5869,721,172,6,0,1,8707,16861
48,Firenze,52,2181,5634,534,44,12,0,0,8405,1804,5908,723,163,2,0,0,8600,17005
48,Firenze,53,1917,5695,491,55,11,0,0,8169,1723,6031,737,192,1,0,0,8684,16853
48,Firenze,54,1825,5736,523,72,13,0,0,8169,1644,5918,792,213,3,0,1,8571,16740
48,Firenze,55,1527,5414,479,74,12,0,0,7506,1432,5551,720,232,3,0,0,7938,15444
48,Firenze,56,1369,5286,569,60,13,0,0,7297,1279,5445,684,285,3,0,0,7696,14993
48,Firenze,57,1270,5087,518,83,12,0,0,6970,1218,5150,641,293,5,0,0,7307,14277
48,Firenze,58,1088,5161,524,82,12,0,0,6867,1113,5205,682,333,3,0,0,7336,14203
48,Firenze,59,1020,5070,490,83,8,0,1,6672,1102,5123,665,365,2,0,0,7257,13929
48,Firenze,60,875,4862,410,104,12,0,1,6264,1008,4916,596,396,3,0,1,6920,13184
48,Firenze,61,784,4754,445,118,11,0,0,6112,910,4807,571,415,3,0,0,6706,12818
48,Firenze,62,780,4499,388,142,10,0,0,5819,843,4780,556,497,1,0,1,6678,12497
48,Firenze,63,729,4527,367,137,6,1,0,5767,800,4641,536,539,6,0,1,6523,12290
48,Firenze,64,624,4519,361,146,7,0,0,5657,738,4703,494,579,1,0,0,6515,12172
48,Firenze,65,628,4406,298,165,5,0,0,5502,665,4275,468,622,2,0,0,6032,11534
48,Firenze,66,540,4300,302,153,5,0,0,5300,577,4468,428,670,2,0,0,6145,11445
48,Firenze,67,504,4392,264,200,10,0,0,5370,501,4402,425,765,2,0,0,6095,11465
48,Firenze,68,469,4470,285,205,2,0,0,5431,496,4457,408,904,5,0,0,6270,11701
48,Firenze,69,471,4701,259,229,4,0,0,5664,489,4606,382,1082,1,0,0,6560,12224
48,Firenze,70,444,4976,271,286,3,0,0,5980,467,4822,393,1300,1,0,0,6983,12963
48,Firenze,71,432,4981,244,304,4,0,0,5965,442,4791,385,1402,0,0,0,7020,12985
48,Firenze,72,394,4997,216,371,5,0,0,5983,437,4614,378,1544,0,0,0,6973,12956
48,Firenze,73,305,3850,163,331,1,0,0,4650,315,3593,271,1332,1,0,0,5512,10162
48,Firenze,74,275,3813,148,375,6,0,0,4617,349,3389,223,1442,2,0,0,5405,10022
48,Firenze,75,260,3778,118,392,1,0,0,4549,330,3425,232,1628,1,0,0,5616,10165
48,Firenze,76,275,3408,131,353,5,0,0,4172,358,2989,193,1701,0,0,0,5241,9413
48,Firenze,77,310,3435,124,401,4,0,0,4274,319,3169,206,1846,1,0,0,5541,9815
48,Firenze,78,294,3876,123,503,3,0,0,4799,353,3174,199,2354,2,0,0,6082,10881
48,Firenze,79,310,3598,102,573,0,0,1,4584,318,2941,195,2516,0,0,0,5970,10554
48,Firenze,80,259,3492,90,591,0,0,0,4432,345,2744,147,2632,0,0,0,5868,10300
48,Firenze,81,232,2900,89,572,0,0,0,3793,299,2148,131,2583,0,0,0,5161,8954
48,Firenze,82,184,2491,43,520,0,0,0,3238,303,1729,109,2544,0,0,0,4685,7923
48,Firenze,83,206,2497,50,533,0,0,0,3286,286,1663,96,2635,1,0,0,4681,7967
48,Firenze,84,143,2069,52,506,1,0,0,2771,278,1292,87,2658,0,0,0,4315,7086
48,Firenze,85,152,1840,27,550,4,0,0,2573,231,1052,50,2691,0,0,0,4024,6597
48,Firenze,86,134,1520,19,535,0,0,0,2208,261,816,63,2585,0,0,0,3725,5933
48,Firenze,87,121,1396,25,486,1,0,0,2029,223,677,53,2613,0,0,0,3566,5595
48,Firenze,88,115,1211,17,528,1,0,0,1872,207,534,59,2551,0,0,0,3351,5223
48,Firenze,89,63,978,14,460,0,0,0,1515,192,372,39,2265,0,0,0,2868,4383
48,Firenze,90,54,768,6,386,0,0,0,1214,172,277,28,2052,0,0,0,2529,3743
48,Firenze,91,48,563,8,338,0,0,0,957,161,186,18,1813,0,0,0,2178,3135
48,Firenze,92,44,404,9,292,0,0,0,749,140,132,17,1544,0,0,0,1833,2582
48,Firenze,93,30,252,3,254,0,0,0,539,105,84,22,1303,0,0,0,1514,2053
48,Firenze,94,27,197,4,204,0,0,0,432,100,61,8,1076,0,0,0,1245,1677
48,Firenze,95,14,119,2,176,0,0,0,311,70,34,8,884,0,0,0,996,1307
48,Firenze,96,8,88,0,126,0,0,0,222,47,25,4,641,0,0,0,717,939
48,Firenze,97,8,45,2,97,0,0,0,152,49,10,1,478,0,0,0,538,690
48,Firenze,98,5,25,0,58,0,0,0,88,36,11,3,381,0,0,0,431,519
48,Firenze,99,0,14,0,21,0,0,0,35,18,3,0,165,0,0,0,186,221
48,Firenze,100,1,6,0,32,0,0,0,39,38,2,2,203,0,0,0,245,284
49,Livorno,0,1065,0,0,0,0,0,0,1065,1041,0,0,0,0,0,0,1041,2106
49,Livorno,1,1114,0,0,0,0,0,0,1114,1095,0,0,0,0,0,0,1095,2209
49,Livorno,2,1159,0,0,0,0,0,0,1159,1099,0,0,0,0,0,0,1099,2258
49,Livorno,3,1208,0,0,0,0,0,0,1208,1171,0,0,0,0,0,0,1171,2379
49,Livorno,4,1262,0,0,0,0,0,0,1262,1207,0,0,0,0,0,0,1207,2469
49,Livorno,5,1287,0,0,0,0,0,0,1287,1203,0,0,0,0,0,0,1203,2490
49,Livorno,6,1334,0,0,0,0,0,0,1334,1360,0,0,0,0,0,0,1360,2694
49,Livorno,7,1381,0,0,0,0,0,0,1381,1337,0,0,0,0,0,0,1337,2718
49,Livorno,8,1477,0,0,0,0,0,0,1477,1366,0,0,0,0,0,0,1366,2843
49,Livorno,9,1508,0,0,0,0,0,0,1508,1409,0,0,0,0,0,0,1409,2917
49,Livorno,10,1469,0,0,0,0,0,0,1469,1401,0,0,0,0,0,0,1401,2870
49,Livorno,11,1545,0,0,0,0,0,0,1545,1424,0,0,0,0,0,0,1424,2969
49,Livorno,12,1502,0,0,0,0,0,0,1502,1435,0,0,0,0,0,0,1435,2937
49,Livorno,13,1427,0,0,0,0,0,0,1427,1346,0,0,0,0,0,0,1346,2773
49,Livorno,14,1546,0,0,0,0,0,0,1546,1397,0,0,0,0,0,0,1397,2943
49,Livorno,15,1409,0,0,0,0,0,0,1409,1369,0,0,0,0,0,0,1369,2778
49,Livorno,16,1417,0,0,0,0,0,0,1417,1340,0,0,0,0,0,0,1340,2757
49,Livorno,17,1442,0,0,0,0,0,0,1442,1402,0,0,0,0,0,0,1402,2844
49,Livorno,18,1443,0,0,0,0,0,0,1443,1335,1,0,0,0,0,0,1336,2779
49,Livorno,19,1495,0,0,0,0,0,0,1495,1267,9,0,0,0,0,0,1276,2771
49,Livorno,20,1479,2,0,0,0,0,0,1481,1318,25,0,0,0,0,0,1343,2824
49,Livorno,21,1567,3,0,0,0,0,0,1570,1341,31,0,0,0,0,0,1372,2942
49,Livorno,22,1484,10,0,0,0,0,0,1494,1260,45,0,0,0,0,0,1305,2799
49,Livorno,23,1459,17,0,0,0,0,0,1476,1328,63,1,0,0,0,0,1392,2868
49,Livorno,24,1452,19,0,0,0,0,0,1471,1270,88,0,0,0,0,0,1358,2829
49,Livorno,25,1433,36,1,0,0,0,0,1470,1161,133,2,0,0,0,0,1296,2766
49,Livorno,26,1510,71,1,0,1,0,0,1583,1197,197,3,0,1,0,0,1398,2981
49,Livorno,27,1457,95,2,0,0,0,0,1554,1157,251,4,0,0,0,0,1412,2966
49,Livorno,28,1496,178,2,0,0,0,0,1676,1165,321,8,1,0,0,0,1495,3171
49,Livorno,29,1373,219,1,0,3,0,0,1596,1098,401,6,1,0,0,0,1506,3102
49,Livorno,30,1332,273,1,0,1,0,0,1607,1052,506,13,1,0,0,0,1572,3179
49,Livorno,31,1199,341,2,2,1,0,0,1545,1026,574,12,6,2,0,0,1620,3165
49,Livorno,32,1130,397,8,0,1,0,0,1536,897,622,18,1,0,0,0,1538,3074
49,Livorno,33,1186,476,19,0,0,0,0,1681,893,683,28,5,0,0,0,1609,3290
49,Livorno,34,1059,530,16,1,4,0,0,1610,830,771,27,3,1,0,0,1632,3242
49,Livorno,35,1034,679,15,2,1,0,0,1731,781,859,43,8,3,0,0,1694,3425
49,Livorno,36,1135,741,27,0,1,0,0,1904,810,896,56,4,1,0,0,1767,3671
49,Livorno,37,963,738,29,0,0,0,0,1730,792,976,65,9,1,0,0,1843,3573
49,Livorno,38,1059,852,41,0,3,0,0,1955,796,1085,53,9,2,0,0,1945,3900
49,Livorno,39,1028,958,32,1,2,0,0,2021,802,1212,96,9,0,0,0,2119,4140
49,Livorno,40,1128,1040,44,1,2,0,0,2215,809,1264,113,7,1,1,0,2195,4410
49,Livorno,41,1011,1155,64,0,1,0,0,2231,811,1358,111,11,4,1,0,2296,4527
49,Livorno,42,1019,1226,97,5,1,0,0,2348,794,1433,138,16,0,0,0,2381,4729
49,Livorno,43,1015,1361,98,5,1,0,0,2480,797,1586,177,19,2,0,0,2581,5061
49,Livorno,44,1055,1515,121,4,5,0,0,2700,723,1765,186,28,2,0,0,2704,5404
49,Livorno,45,995,1564,156,6,1,0,0,2722,734,1837,216,27,2,0,0,2816,5538
49,Livorno,46,922,1594,156,13,0,0,0,2685,680,1936,236,32,2,0,0,2886,5571
49,Livorno,47,867,1715,170,13,0,0,0,2765,599,1837,260,33,2,0,0,2731,5496
49,Livorno,48,822,1737,202,9,1,0,0,2771,579,1856,260,38,1,0,0,2734,5505
49,Livorno,49,706,1815,225,7,1,0,0,2754,452,2000,283,56,1,0,0,2792,5546
49,Livorno,50,712,1753,177,13,0,0,0,2655,486,2004,286,58,3,0,0,2837,5492
49,Livorno,51,636,1870,215,15,1,0,0,2737,430,2005,322,73,1,0,0,2831,5568
49,Livorno,52,562,1896,254,13,1,0,0,2726,449,2085,325,77,0,0,0,2936,5662
49,Livorno,53,537,1930,222,24,3,0,0,2716,422,2029,339,73,2,0,0,2865,5581
49,Livorno,54,494,2044,282,34,3,0,0,2857,397,2105,353,90,3,0,0,2948,5805
49,Livorno,55,424,1939,271,30,2,0,0,2666,352,2024,358,100,4,0,0,2838,5504
49,Livorno,56,406,1893,247,21,2,0,0,2569,300,1950,298,116,2,0,0,2666,5235
49,Livorno,57,311,1868,253,28,2,0,0,2462,311,1952,288,133,2,0,0,2686,5148
49,Livorno,58,286,1776,212,32,1,0,0,2307,263,1817,261,149,2,0,0,2492,4799
49,Livorno,59,263,1735,177,34,0,0,0,2209,232,1735,265,161,0,0,0,2393,4602
49,Livorno,60,266,1604,167,39,1,0,0,2077,195,1741,276,167,0,0,0,2379,4456
49,Livorno,61,207,1758,193,37,0,0,0,2195,190,1715,222,206,0,0,0,2333,4528
49,Livorno,62,199,1725,153,55,2,0,0,2134,192,1761,197,254,1,0,0,2405,4539
49,Livorno,63,197,1710,162,48,0,0,0,2117,152,1716,218,243,1,0,0,2330,4447
49,Livorno,64,171,1560,129,56,0,0,0,1916,141,1749,188,247,1,0,0,2326,4242
49,Livorno,65,143,1568,133,56,0,0,0,1900,124,1570,185,237,0,0,0,2116,4016
49,Livorno,66,145,1607,113,71,0,0,0,1936,114,1590,131,278,1,0,0,2114,4050
49,Livorno,67,138,1578,94,64,1,0,0,1875,120,1542,115,306,0,0,0,2083,3958
49,Livorno,68,119,1616,103,79,1,0,0,1918,119,1554,144,330,0,0,0,2147,4065
49,Livorno,69,122,1765,100,101,0,0,0,2088,131,1631,135,408,0,0,0,2305,4393
49,Livorno,70,97,1875,85,127,0,0,0,2184,94,1763,155,448,0,0,0,2460,4644
49,Livorno,71,121,1851,114,119,2,0,0,2207,92,1766,143,555,0,0,0,2556,4763
49,Livorno,72,93,1988,97,148,0,0,0,2326,122,1871,146,659,1,0,0,2799,5125
49,Livorno,73,99,1583,64,113,1,0,0,1860,72,1388,102,556,0,0,0,2118,3978
49,Livorno,74,75,1491,73,137,0,0,0,1776,77,1325,72,596,0,0,0,2070,3846
49,Livorno,75,59,1360,57,160,2,0,0,1638,78,1208,80,597,0,0,0,1963,3601
49,Livorno,76,68,1383,50,139,0,0,0,1640,73,1154,78,668,0,0,0,1973,3613
49,Livorno,77,67,1264,48,166,2,0,0,1547,93,1090,61,758,0,0,0,2002,3549
49,Livorno,78,89,1383,36,186,0,0,0,1694,88,1041,65,921,0,0,0,2115,3809
49,Livorno,79,71,1343,25,184,0,0,0,1623,86,954,65,966,0,0,0,2071,3694
49,Livorno,80,66,1279,38,229,0,0,0,1612,64,915,50,981,0,0,0,2010,3622
49,Livorno,81,45,1108,28,163,0,0,0,1344,57,725,42,972,0,0,0,1796,3140
49,Livorno,82,50,859,17,183,0,0,0,1109,66,585,33,942,0,0,0,1626,2735
49,Livorno,83,55,815,21,185,0,0,0,1076,61,495,29,983,0,0,0,1568,2644
49,Livorno,84,40,682,17,191,0,0,0,930,75,388,18,918,0,0,0,1399,2329
49,Livorno,85,39,611,12,172,1,0,0,835,56,278,29,918,0,0,0,1281,2116
49,Livorno,86,28,560,11,173,0,0,0,772,55,261,14,937,0,0,0,1267,2039
49,Livorno,87,28,455,7,178,0,0,0,668,53,182,21,904,0,0,0,1160,1828
49,Livorno,88,20,361,5,181,0,0,0,567,62,128,9,922,0,0,0,1121,1688
49,Livorno,89,20,313,4,133,0,0,0,470,59,120,6,782,0,0,0,967,1437
49,Livorno,90,7,222,2,162,0,0,0,393,52,69,7,699,0,0,0,827,1220
49,Livorno,91,9,170,1,118,0,0,0,298,55,42,3,583,0,0,0,683,981
49,Livorno,92,13,124,1,114,0,0,0,252,33,43,7,500,0,0,0,583,835
49,Livorno,93,7,80,0,95,0,0,0,182,32,23,3,386,0,0,0,444,626
49,Livorno,94,5,48,2,75,0,0,0,130,22,16,10,338,0,0,0,386,516
49,Livorno,95,6,33,1,56,0,0,0,96,13,13,2,269,0,0,0,297,393
49,Livorno,96,2,23,0,41,0,0,0,66,15,4,2,195,0,0,0,216,282
49,Livorno,97,0,15,1,27,0,0,0,43,12,6,3,142,0,0,0,163,206
49,Livorno,98,2,10,0,20,0,0,0,32,6,2,2,93,0,0,0,103,135
49,Livorno,99,0,4,0,10,0,0,0,14,3,1,0,46,0,0,0,50,64
49,Livorno,100,1,0,0,12,0,0,0,13,9,1,0,63,0,0,0,73,86
50,Pisa,0,1492,0,0,0,0,0,0,1492,1436,0,0,0,0,0,0,1436,2928
50,Pisa,1,1597,0,0,0,0,0,0,1597,1524,0,0,0,0,0,0,1524,3121
50,Pisa,2,1682,0,0,0,0,0,0,1682,1580,0,0,0,0,0,0,1580,3262
50,Pisa,3,1771,0,0,0,0,0,0,1771,1629,0,0,0,0,0,0,1629,3400
50,Pisa,4,1781,0,0,0,0,0,0,1781,1776,0,0,0,0,0,0,1776,3557
50,Pisa,5,1817,0,0,0,0,0,0,1817,1785,0,0,0,0,0,0,1785,3602
50,Pisa,6,1868,0,0,0,0,0,0,1868,1787,0,0,0,0,0,0,1787,3655
50,Pisa,7,1895,0,0,0,0,0,0,1895,1870,0,0,0,0,0,0,1870,3765
50,Pisa,8,1974,0,0,0,0,0,0,1974,1935,0,0,0,0,0,0,1935,3909
50,Pisa,9,2006,0,0,0,0,0,0,2006,1884,0,0,0,0,0,0,1884,3890
50,Pisa,10,2043,0,0,0,0,0,0,2043,1910,0,0,0,0,0,0,1910,3953
50,Pisa,11,2014,0,0,0,0,0,0,2014,1900,0,0,0,0,0,0,1900,3914
50,Pisa,12,1935,0,0,0,0,0,0,1935,1826,0,0,0,0,0,0,1826,3761
50,Pisa,13,1982,0,0,0,0,0,0,1982,1791,0,0,0,0,0,0,1791,3773
50,Pisa,14,1940,0,0,0,0,0,0,1940,1786,0,0,0,0,0,0,1786,3726
50,Pisa,15,1849,0,0,0,0,0,0,1849,1748,0,0,0,0,0,0,1748,3597
50,Pisa,16,1893,0,0,0,0,0,0,1893,1725,0,0,0,0,0,0,1725,3618
50,Pisa,17,1863,0,0,0,0,0,0,1863,1672,0,0,0,0,0,0,1672,3535
50,Pisa,18,1902,0,0,0,0,0,0,1902,1769,7,0,0,0,0,0,1776,3678
50,Pisa,19,1945,2,0,0,0,0,0,1947,1701,11,0,0,0,0,0,1712,3659
50,Pisa,20,1953,1,0,0,0,0,0,1954,1594,32,0,0,0,0,0,1626,3580
50,Pisa,21,1986,3,0,0,0,0,0,1989,1689,48,0,0,0,0,0,1737,3726
50,Pisa,22,1844,6,0,0,0,0,0,1850,1634,66,0,0,2,0,0,1702,3552
50,Pisa,23,1893,16,0,0,0,0,0,1909,1643,89,2,0,0,0,0,1734,3643
50,Pisa,24,1881,22,0,1,0,0,0,1904,1606,130,1,0,0,0,0,1737,3641
50,Pisa,25,1930,54,1,0,0,0,0,1985,1696,202,1,0,2,0,0,1901,3886
50,Pisa,26,2051,81,2,0,0,0,0,2134,1690,259,4,0,0,0,0,1953,4087
50,Pisa,27,2017,123,0,0,2,0,0,2142,1610,356,1,1,0,0,0,1968,4110
50,Pisa,28,1994,192,1,0,5,0,0,2192,1702,445,6,1,0,0,0,2154,4346
50,Pisa,29,1910,297,0,0,1,0,0,2208,1599,558,12,0,2,0,0,2171,4379
50,Pisa,30,1863,366,3,0,1,0,0,2233,1431,725,13,4,0,0,0,2173,4406
50,Pisa,31,1776,480,5,0,1,0,0,2262,1327,775,18,2,0,0,0,2122,4384
50,Pisa,32,1534,586,6,0,5,0,0,2131,1272,963,19,1,1,0,0,2256,4387
50,Pisa,33,1636,698,15,0,3,0,0,2352,1249,1093,37,1,6,0,0,2386,4738
50,Pisa,34,1561,891,20,1,2,0,0,2475,1186,1160,34,1,0,0,0,2381,4856
50,Pisa,35,1448,955,17,0,2,0,0,2422,1129,1348,31,3,0,0,0,2511,4933
50,Pisa,36,1449,1200,29,0,2,0,0,2680,1028,1348,47,7,2,0,0,2432,5112
50,Pisa,37,1427,1235,42,1,3,0,0,2708,1002,1478,64,10,0,0,0,2554,5262
50,Pisa,38,1358,1331,34,0,5,0,0,2728,1009,1555,78,6,6,1,0,2655,5383
50,Pisa,39,1348,1419,61,2,4,0,0,2834,973,1704,90,14,3,0,0,2784,5618
50,Pisa,40,1340,1574,65,2,1,0,0,2982,967,1924,119,11,2,0,0,3023,6005
50,Pisa,41,1323,1722,69,0,4,0,0,3118,981,1821,134,11,2,0,0,2949,6067
50,Pisa,42,1284,1767,116,6,5,0,0,3178,937,2178,124,24,3,0,0,3266,6444
50,Pisa,43,1204,1941,97,4,3,0,0,3249,906,2208,154,24,1,0,0,3293,6542
50,Pisa,44,1319,2092,117,7,4,0,0,3539,936,2501,195,34,2,0,0,3668,7207
50,Pisa,45,1105,2189,142,9,4,0,0,3449,846,2375,198,28,4,0,0,3451,6900
50,Pisa,46,1092,2374,153,11,2,0,0,3632,751,2372,244,38,1,0,0,3406,7038
50,Pisa,47,1000,2333,139,9,3,0,0,3484,739,2547,228,37,3,0,0,3554,7038
50,Pisa,48,941,2196,172,8,3,0,0,3320,673,2340,237,38,1,0,0,3289,6609
50,Pisa,49,839,2359,191,12,2,0,0,3403,580,2483,288,55,2,1,0,3409,6812
50,Pisa,50,779,2332,190,11,1,0,0,3313,548,2426,273,65,3,0,0,3315,6628
50,Pisa,51,690,2385,210,15,4,0,0,3304,523,2511,286,87,2,0,0,3409,6713
50,Pisa,52,648,2404,245,19,0,0,0,3316,460,2543,288,81,1,0,0,3373,6689
50,Pisa,53,686,2404,227,18,2,0,1,3338,460,2517,293,83,1,0,0,3354,6692
50,Pisa,54,532,2467,254,32,3,0,0,3288,408,2674,279,104,3,0,0,3468,6756
50,Pisa,55,482,2353,193,37,3,0,0,3068,384,2478,282,102,1,0,0,3247,6315
50,Pisa,56,417,2293,189,31,0,0,0,2930,317,2488,269,141,1,0,0,3216,6146
50,Pisa,57,383,2313,209,26,3,0,0,2934,303,2450,282,160,1,0,0,3196,6130
50,Pisa,58,364,2294,175,48,1,0,0,2882,282,2291,270,162,0,0,0,3005,5887
50,Pisa,59,316,2308,185,57,3,0,0,2869,249,2283,188,167,2,0,0,2889,5758
50,Pisa,60,286,2160,185,33,9,0,0,2673,227,2193,202,190,2,0,0,2814,5487
50,Pisa,61,265,2098,127,58,1,0,0,2549,241,2071,196,231,1,0,0,2740,5289
50,Pisa,62,227,2083,147,66,3,0,0,2526,199,2143,172,272,1,0,0,2787,5313
50,Pisa,63,237,1982,132,68,2,0,0,2421,181,2074,172,238,1,0,0,2666,5087
50,Pisa,64,196,1996,118,65,0,0,0,2375,157,2129,169,274,1,0,0,2730,5105
50,Pisa,65,188,1929,121,87,2,0,0,2327,169,1922,138,290,2,0,0,2521,4848
50,Pisa,66,169,1876,100,81,1,0,0,2227,143,1916,143,322,0,0,1,2525,4752
50,Pisa,67,138,1896,89,100,2,0,0,2225,114,1852,127,304,1,0,0,2398,4623
50,Pisa,68,156,1966,100,102,1,0,0,2325,137,1978,133,417,2,0,0,2667,4992
50,Pisa,69,139,2048,100,130,1,0,0,2418,146,1964,146,484,1,0,0,2741,5159
50,Pisa,70,156,2129,78,155,2,0,0,2520,117,2054,129,533,0,0,0,2833,5353
50,Pisa,71,122,2151,77,145,0,0,0,2495,131,2075,121,574,0,1,0,2902,5397
50,Pisa,72,129,2147,72,155,0,0,0,2503,135,2024,119,708,0,0,0,2986,5489
50,Pisa,73,109,1712,49,153,0,0,0,2023,107,1516,76,589,0,0,0,2288,4311
50,Pisa,74,93,1602,41,127,0,0,0,1863,95,1394,70,673,1,0,0,2233,4096
50,Pisa,75,82,1566,45,147,0,0,0,1840,90,1352,71,788,0,0,0,2301,4141
50,Pisa,76,90,1470,36,158,0,0,0,1754,83,1304,48,725,0,0,0,2160,3914
50,Pisa,77,93,1357,37,169,1,0,0,1657,77,1161,43,816,0,0,0,2097,3754
50,Pisa,78,94,1512,24,199,0,0,0,1829,103,1193,59,1042,0,0,0,2397,4226
50,Pisa,79,101,1481,23,198,1,0,0,1804,90,1154,41,1014,0,0,0,2299,4103
50,Pisa,80,76,1413,20,243,0,0,0,1752,81,1061,33,1164,0,0,0,2339,4091
50,Pisa,81,74,1210,27,243,0,0,0,1554,93,814,31,1137,0,0,0,2075,3629
50,Pisa,82,72,1040,22,208,0,0,0,1342,75,664,18,1052,0,0,0,1809,3151
50,Pisa,83,61,1015,14,229,0,0,0,1319,69,560,14,1102,0,0,0,1745,3064
50,Pisa,84,65,827,12,228,1,0,0,1133,68,425,25,1087,0,0,0,1605,2738
50,Pisa,85,42,733,10,206,0,0,0,991,63,322,20,1113,0,0,0,1518,2509
50,Pisa,86,50,597,8,202,0,0,0,857,59,285,13,1017,0,0,0,1374,2231
50,Pisa,87,34,540,9,198,1,0,0,782,65,214,12,1030,0,0,0,1321,2103
50,Pisa,88,44,414,6,212,0,0,0,676,64,203,13,960,0,0,0,1240,1916
50,Pisa,89,29,282,2,173,0,0,0,486,56,131,9,929,0,0,0,1125,1611
50,Pisa,90,21,235,5,155,0,0,0,416,50,96,7,774,0,0,0,927,1343
50,Pisa,91,13,200,1,146,0,0,0,360,48,45,8,665,0,0,0,766,1126
50,Pisa,92,11,148,1,108,0,0,0,268,31,44,9,494,0,0,0,578,846
50,Pisa,93,4,87,0,88,0,0,0,179,36,34,4,470,0,0,0,544,723
50,Pisa,94,9,50,1,73,0,0,0,133,28,13,0,376,0,0,0,417,550
50,Pisa,95,2,46,1,54,0,0,0,103,26,9,2,281,0,0,0,318,421
50,Pisa,96,3,25,0,37,0,0,0,65,13,7,0,199,0,0,0,219,284
50,Pisa,97,2,14,0,31,0,0,0,47,14,4,3,171,0,0,0,192,239
50,Pisa,98,2,9,0,24,0,0,0,35,10,4,1,118,0,0,0,133,168
50,Pisa,99,1,7,0,7,0,0,0,15,2,1,1,39,0,0,0,43,58
50,Pisa,100,1,4,0,14,0,0,0,19,5,2,0,63,0,0,0,70,89
51,Arezzo,0,1150,0,0,0,0,0,0,1150,1106,0,0,0,0,0,0,1106,2256
51,Arezzo,1,1291,0,0,0,0,0,0,1291,1144,0,0,0,0,0,0,1144,2435
51,Arezzo,2,1288,0,0,0,0,0,0,1288,1260,0,0,0,0,0,0,1260,2548
51,Arezzo,3,1298,0,0,0,0,0,0,1298,1193,0,0,0,0,0,0,1193,2491
51,Arezzo,4,1389,0,0,0,0,0,0,1389,1290,0,0,0,0,0,0,1290,2679
51,Arezzo,5,1456,0,0,0,0,0,0,1456,1204,0,0,0,0,0,0,1204,2660
51,Arezzo,6,1461,0,0,0,0,0,0,1461,1431,0,0,0,0,0,0,1431,2892
51,Arezzo,7,1491,0,0,0,0,0,0,1491,1476,0,0,0,0,0,0,1476,2967
51,Arezzo,8,1539,0,0,0,0,0,0,1539,1457,0,0,0,0,0,0,1457,2996
51,Arezzo,9,1581,0,0,0,0,0,0,1581,1442,0,0,0,0,0,0,1442,3023
51,Arezzo,10,1566,0,0,0,0,0,0,1566,1494,0,0,0,0,0,0,1494,3060
51,Arezzo,11,1605,0,0,0,0,0,0,1605,1502,0,0,0,0,0,0,1502,3107
51,Arezzo,12,1530,0,0,0,0,0,0,1530,1484,0,0,0,0,0,0,1484,3014
51,Arezzo,13,1528,0,0,0,0,0,0,1528,1495,0,0,0,0,0,0,1495,3023
51,Arezzo,14,1605,0,0,0,0,0,0,1605,1555,0,0,0,0,0,0,1555,3160
51,Arezzo,15,1500,0,0,0,0,0,0,1500,1424,0,0,0,0,0,0,1424,2924
51,Arezzo,16,1545,0,0,0,0,0,0,1545,1480,0,0,0,0,0,0,1480,3025
51,Arezzo,17,1562,0,0,0,0,0,0,1562,1462,0,0,0,0,0,0,1462,3024
51,Arezzo,18,1548,1,0,0,0,0,0,1549,1459,2,0,0,0,0,0,1461,3010
51,Arezzo,19,1585,1,0,0,0,0,0,1586,1387,6,0,0,0,0,0,1393,2979
51,Arezzo,20,1685,1,0,0,0,0,0,1686,1388,12,2,0,0,0,0,1402,3088
51,Arezzo,21,1636,6,0,0,0,0,0,1642,1418,25,0,0,0,0,0,1443,3085
51,Arezzo,22,1706,11,0,0,0,0,0,1717,1446,41,0,0,0,0,0,1487,3204
51,Arezzo,23,1536,17,0,0,0,0,0,1553,1385,81,1,0,0,0,0,1467,3020
51,Arezzo,24,1635,30,1,0,1,0,0,1667,1419,120,0,0,0,0,0,1539,3206
51,Arezzo,25,1664,47,0,0,1,0,0,1712,1370,155,2,0,0,0,0,1527,3239
51,Arezzo,26,1691,55,0,0,0,0,0,1746,1431,218,1,0,0,0,0,1650,3396
51,Arezzo,27,1630,124,1,0,0,0,0,1755,1293,307,3,0,1,0,0,1604,3359
51,Arezzo,28,1601,184,1,0,0,0,0,1786,1323,426,12,3,1,0,1,1766,3552
51,Arezzo,29,1522,250,7,0,1,0,0,1780,1236,453,12,0,1,0,0,1702,3482
51,Arezzo,30,1570,309,2,1,0,0,0,1882,1227,564,11,1,0,0,0,1803,3685
51,Arezzo,31,1473,431,6,0,0,0,0,1910,1092,760,20,1,0,0,0,1873,3783
51,Arezzo,32,1324,485,8,0,0,0,0,1817,1005,782,21,4,0,0,0,1812,3629
51,Arezzo,33,1304,583,14,1,1,0,0,1903,1026,890,25,3,0,0,0,1944,3847
51,Arezzo,34,1213,628,13,0,2,0,0,1856,943,954,46,4,1,0,0,1948,3804
51,Arezzo,35,1179,790,16,1,1,0,0,1987,820,990,50,3,0,0,0,1863,3850
51,Arezzo,36,1098,835,25,0,1,0,0,1959,814,1124,38,6,2,0,0,1984,3943
51,Arezzo,37,1069,913,31,2,2,0,0,2017,766,1184,67,8,0,0,0,2025,4042
51,Arezzo,38,941,1116,47,1,1,0,0,2106,709,1320,63,10,0,0,0,2102,4208
51,Arezzo,39,962,1154,47,2,1,0,0,2166,671,1415,84,14,1,0,0,2185,4351
51,Arezzo,40,1033,1207,51,4,0,0,0,2295,702,1449,118,10,1,0,0,2280,4575
51,Arezzo,41,916,1306,76,2,0,0,0,2300,684,1565,139,17,3,0,0,2408,4708
51,Arezzo,42,959,1441,92,1,2,0,0,2495,626,1670,165,16,1,0,0,2478,4973
51,Arezzo,43,893,1477,108,5,2,0,0,2485,646,1821,201,19,1,0,0,2688,5173
51,Arezzo,44,877,1625,125,7,0,0,0,2634,610,1847,183,29,0,0,0,2669,5303
51,Arezzo,45,783,1749,129,5,0,0,0,2666,557,1940,224,30,2,0,0,2753,5419
51,Arezzo,46,762,1818,137,9,1,0,0,2727,546,1923,208,38,1,0,0,2716,5443
51,Arezzo,47,740,1791,145,8,2,0,0,2686,507,2017,208,37,0,0,0,2769,5455
51,Arezzo,48,677,1846,180,12,0,0,0,2715,447,2008,200,34,0,0,0,2689,5404
51,Arezzo,49,604,1942,157,6,2,0,0,2711,436,2158,214,51,1,0,0,2860,5571
51,Arezzo,50,563,1917,150,10,1,0,0,2641,435,2136,239,55,0,0,0,2865,5506
51,Arezzo,51,556,1993,167,10,2,0,0,2728,396,2124,262,67,0,0,0,2849,5577
51,Arezzo,52,570,2012,180,21,2,0,0,2785,382,2120,238,86,0,0,0,2826,5611
51,Arezzo,53,505,2069,183,19,3,0,0,2779,358,2192,246,85,0,0,0,2881,5660
51,Arezzo,54,457,2092,197,26,0,0,0,2772,320,2114,239,96,1,0,0,2770,5542
51,Arezzo,55,399,1900,185,16,1,0,0,2501,246,2055,222,106,1,0,0,2630,5131
51,Arezzo,56,347,1930,162,28,1,0,0,2468,220,2083,224,113,0,0,0,2640,5108
51,Arezzo,57,311,1951,161,33,0,0,0,2456,206,2021,223,133,1,0,0,2584,5040
51,Arezzo,58,268,1902,138,32,3,0,0,2343,188,2052,203,131,0,0,0,2574,4917
51,Arezzo,59,267,1901,149,42,3,0,0,2362,181,1878,188,153,0,0,0,2400,4762
51,Arezzo,60,238,1794,152,30,0,0,0,2214,180,1897,149,157,0,0,0,2383,4597
51,Arezzo,61,217,1828,138,41,3,0,0,2227,134,1840,136,169,0,0,0,2279,4506
51,Arezzo,62,216,1743,124,48,0,0,0,2131,148,1811,142,229,0,0,0,2330,4461
51,Arezzo,63,189,1707,108,52,1,0,0,2057,126,1742,135,210,0,0,0,2213,4270
51,Arezzo,64,176,1739,109,61,2,0,0,2087,116,1792,145,235,0,0,0,2288,4375
51,Arezzo,65,157,1648,100,56,1,0,0,1962,113,1653,107,265,0,0,0,2138,4100
51,Arezzo,66,176,1637,93,64,2,0,0,1972,109,1563,101,240,0,0,0,2013,3985
51,Arezzo,67,182,1696,84,75,1,0,0,2038,111,1697,92,313,0,0,0,2213,4251
51,Arezzo,68,166,1675,78,97,0,0,0,2016,104,1623,109,345,0,0,0,2181,4197
51,Arezzo,69,146,1782,71,94,1,0,0,2094,92,1765,98,386,0,0,0,2341,4435
51,Arezzo,70,171,1935,71,112,0,0,0,2289,117,1845,86,492,0,0,0,2540,4829
51,Arezzo,71,143,1820,66,108,0,0,0,2137,96,1675,88,482,0,0,0,2341,4478
51,Arezzo,72,131,1756,49,121,1,0,0,2058,112,1527,84,498,0,0,0,2221,4279
51,Arezzo,73,99,1416,54,115,0,0,0,1684,62,1201,50,470,0,0,0,1783,3467
51,Arezzo,74,83,1265,31,115,0,0,0,1494,75,1033,47,495,0,0,0,1650,3144
51,Arezzo,75,114,1309,37,143,0,0,0,1603,81,1131,42,566,0,0,0,1820,3423
51,Arezzo,76,95,1185,35,103,0,0,0,1418,87,976,36,566,0,0,0,1665,3083
51,Arezzo,77,112,1217,26,135,0,0,0,1490,66,945,33,626,0,0,0,1670,3160
51,Arezzo,78,115,1282,29,173,0,0,0,1599,88,1002,37,861,0,0,0,1988,3587
51,Arezzo,79,105,1163,28,186,0,0,0,1482,83,908,33,838,0,0,0,1862,3344
51,Arezzo,80,99,1190,22,179,0,0,0,1490,69,877,28,904,0,0,0,1878,3368
51,Arezzo,81,101,970,17,160,0,0,0,1248,86,723,17,904,0,0,0,1730,2978
51,Arezzo,82,113,891,10,171,0,0,0,1185,65,561,15,843,0,0,0,1484,2669
51,Arezzo,83,71,870,11,221,0,0,0,1173,50,539,19,940,0,0,0,1548,2721
51,Arezzo,84,69,716,11,196,0,0,0,992,56,403,17,920,0,0,0,1396,2388
51,Arezzo,85,77,642,4,198,0,0,0,921,55,351,11,867,0,0,0,1284,2205
51,Arezzo,86,53,497,6,154,0,0,0,710,46,258,8,844,0,0,0,1156,1866
51,Arezzo,87,61,484,6,190,0,0,0,741,52,221,9,897,0,0,0,1179,1920
51,Arezzo,88,46,406,2,155,0,0,0,609,54,174,10,888,0,0,0,1126,1735
51,Arezzo,89,31,306,2,149,0,0,0,488,36,98,3,736,0,0,0,873,1361
51,Arezzo,90,25,234,3,145,0,0,0,407,46,63,5,696,0,0,0,810,1217
51,Arezzo,91,16,195,4,142,0,0,0,357,42,63,3,654,0,0,0,762,1119
51,Arezzo,92,17,126,1,117,0,0,0,261,26,39,4,484,0,0,0,553,814
51,Arezzo,93,14,89,1,91,0,0,0,195,22,19,2,436,0,0,0,479,674
51,Arezzo,94,4,61,2,69,0,0,0,136,21,15,1,348,0,0,0,385,521
51,Arezzo,95,8,29,0,50,0,0,0,87,12,10,2,279,0,0,0,303,390
51,Arezzo,96,6,22,0,44,0,0,0,72,14,10,2,202,0,0,0,228,300
51,Arezzo,97,7,14,2,26,0,0,0,49,12,5,0,156,0,0,0,173,222
51,Arezzo,98,1,9,0,24,0,0,0,34,6,3,2,98,0,0,0,109,143
51,Arezzo,99,0,1,0,8,0,0,0,9,5,0,1,47,0,0,0,53,62
51,Arezzo,100,1,4,0,16,0,0,0,21,4,1,0,60,0,0,0,65,86
52,Siena,0,878,0,0,0,0,0,0,878,910,0,0,0,0,0,0,910,1788
52,Siena,1,934,0,0,0,0,0,0,934,934,0,0,0,0,0,0,934,1868
52,Siena,2,1004,0,0,0,0,0,0,1004,969,0,0,0,0,0,0,969,1973
52,Siena,3,1063,0,0,0,0,0,0,1063,990,0,0,0,0,0,0,990,2053
52,Siena,4,1148,0,0,0,0,0,0,1148,1011,0,0,0,0,0,0,1011,2159
52,Siena,5,1100,0,0,0,0,0,0,1100,1075,0,0,0,0,0,0,1075,2175
52,Siena,6,1136,0,0,0,0,0,0,1136,1138,0,0,0,0,0,0,1138,2274
52,Siena,7,1209,0,0,0,0,0,0,1209,1100,0,0,0,0,0,0,1100,2309
52,Siena,8,1204,0,0,0,0,0,0,1204,1190,0,0,0,0,0,0,1190,2394
52,Siena,9,1204,0,0,0,0,0,0,1204,1206,0,0,0,0,0,0,1206,2410
52,Siena,10,1206,0,0,0,0,0,0,1206,1138,0,0,0,0,0,0,1138,2344
52,Siena,11,1204,0,0,0,0,0,0,1204,1203,0,0,0,0,0,0,1203,2407
52,Siena,12,1211,0,0,0,0,0,0,1211,1101,0,0,0,0,0,0,1101,2312
52,Siena,13,1257,0,0,0,0,0,0,1257,1063,0,0,0,0,0,0,1063,2320
52,Siena,14,1206,0,0,0,0,0,0,1206,1095,0,0,0,0,0,0,1095,2301
52,Siena,15,1194,0,0,0,0,0,0,1194,1096,0,0,0,0,0,0,1096,2290
52,Siena,16,1137,0,0,0,0,0,0,1137,1060,0,0,0,0,0,0,1060,2197
52,Siena,17,1162,0,0,0,0,0,0,1162,1104,1,0,0,0,0,0,1105,2267
52,Siena,18,1222,0,0,0,0,0,0,1222,1130,5,0,0,0,0,0,1135,2357
52,Siena,19,1205,0,0,0,0,0,0,1205,1078,9,0,0,0,0,0,1087,2292
52,Siena,20,1238,2,0,0,0,0,0,1240,1045,26,0,0,0,0,0,1071,2311
52,Siena,21,1227,6,0,0,0,0,0,1233,1060,41,1,0,0,0,0,1102,2335
52,Siena,22,1318,14,0,0,0,0,0,1332,1102,44,1,0,0,0,0,1147,2479
52,Siena,23,1220,24,0,0,0,0,0,1244,1013,91,2,0,0,0,0,1106,2350
52,Siena,24,1231,33,0,0,0,0,0,1264,1048,94,0,0,0,0,0,1142,2406
52,Siena,25,1218,47,0,0,0,0,0,1265,1074,121,0,0,0,0,0,1195,2460
52,Siena,26,1287,72,1,0,0,0,0,1360,1103,219,2,0,0,0,0,1324,2684
52,Siena,27,1215,118,1,0,0,0,0,1334,1008,231,4,1,0,0,0,1244,2578
52,Siena,28,1297,162,2,0,0,0,0,1461,986,338,3,0,0,0,0,1327,2788
52,Siena,29,1180,214,4,0,0,0,0,1398,933,353,4,2,2,0,0,1294,2692
52,Siena,30,1149,257,2,0,1,0,0,1409,943,464,6,1,0,0,0,1414,2823
52,Siena,31,1045,316,3,0,2,0,0,1366,869,494,9,1,0,0,0,1373,2739
52,Siena,32,1033,340,6,0,1,0,0,1380,769,585,11,1,0,0,0,1366,2746
52,Siena,33,970,439,4,0,1,0,0,1414,801,637,14,3,0,0,0,1455,2869
52,Siena,34,965,519,8,0,1,0,0,1493,725,764,14,1,0,0,0,1504,2997
52,Siena,35,876,577,6,1,1,0,0,1461,749,781,26,3,3,0,0,1562,3023
52,Siena,36,891,629,12,0,1,0,0,1533,705,892,32,4,2,0,0,1635,3168
52,Siena,37,807,656,17,2,0,0,0,1482,677,855,33,2,0,0,0,1567,3049
52,Siena,38,828,744,17,2,1,0,0,1592,595,920,34,3,0,0,0,1552,3144
52,Siena,39,767,788,30,0,0,0,0,1585,626,1017,45,5,2,0,0,1695,3280
52,Siena,40,800,919,24,3,2,0,0,1748,669,1118,53,7,2,0,0,1849,3597
52,Siena,41,830,1025,34,1,3,0,0,1893,610,1239,76,10,2,0,0,1937,3830
52,Siena,42,738,1064,34,2,0,0,0,1838,602,1278,78,13,1,0,0,1972,3810
52,Siena,43,805,1083,48,2,2,0,0,1940,601,1283,98,19,0,0,0,2001,3941
52,Siena,44,763,1163,55,3,1,0,0,1985,576,1392,104,13,1,0,0,2086,4071
52,Siena,45,699,1216,44,4,1,0,0,1964,514,1435,98,15,3,0,0,2065,4029
52,Siena,46,742,1269,62,4,0,0,0,2077,546,1486,109,22,0,0,0,2163,4240
52,Siena,47,652,1335,75,5,0,0,0,2067,498,1435,95,26,1,0,0,2055,4122
52,Siena,48,607,1327,70,6,0,0,0,2010,448,1504,139,27,0,0,0,2118,4128
52,Siena,49,566,1447,88,7,1,0,0,2109,421,1609,150,29,1,0,0,2210,4319
52,Siena,50,511,1484,101,13,0,0,0,2109,418,1566,156,35,0,0,0,2175,4284
52,Siena,51,489,1509,116,10,1,0,0,2125,402,1645,152,38,3,0,0,2240,4365
52,Siena,52,482,1626,102,14,0,0,0,2224,355,1709,163,48,2,0,0,2277,4501
52,Siena,53,430,1530,117,11,0,0,0,2088,331,1615,132,54,0,0,0,2132,4220
52,Siena,54,352,1597,124,15,2,0,0,2090,316,1663,199,90,1,0,0,2269,4359
52,Siena,55,346,1515,127,14,0,0,0,2002,261,1520,175,63,1,0,0,2020,4022
52,Siena,56,301,1421,104,18,0,0,0,1844,268,1563,139,97,0,0,0,2067,3911
52,Siena,57,263,1453,126,16,0,0,0,1858,228,1601,152,91,0,0,0,2072,3930
52,Siena,58,273,1381,113,24,1,0,0,1792,175,1456,156,110,1,0,0,1898,3690
52,Siena,59,231,1490,102,31,4,0,0,1858,184,1500,123,138,1,0,0,1946,3804
52,Siena,60,208,1354,78,30,3,0,0,1673,160,1511,133,138,1,0,0,1943,3616
52,Siena,61,178,1282,103,31,1,0,0,1595,142,1400,137,120,0,0,0,1799,3394
52,Siena,62,164,1360,83,34,1,0,0,1642,155,1340,110,145,1,0,0,1751,3393
52,Siena,63,172,1254,92,29,1,0,0,1548,146,1375,108,190,0,0,0,1819,3367
52,Siena,64,138,1328,78,40,0,0,0,1584,112,1350,119,201,0,0,0,1782,3366
52,Siena,65,124,1283,71,41,0,0,0,1519,101,1290,112,204,0,0,0,1707,3226
52,Siena,66,121,1213,62,56,1,0,0,1453,101,1270,96,217,0,0,0,1684,3137
52,Siena,67,148,1242,46,56,0,0,0,1492,81,1208,81,229,0,0,0,1599,3091
52,Siena,68,123,1292,64,52,0,0,0,1531,72,1249,78,219,0,0,0,1618,3149
52,Siena,69,134,1332,52,56,1,0,0,1575,89,1329,70,302,0,0,0,1790,3365
52,Siena,70,110,1432,50,99,0,0,0,1691,89,1393,77,360,0,0,0,1919,3610
52,Siena,71,132,1428,54,86,1,0,0,1701,91,1335,56,372,0,0,0,1854,3555
52,Siena,72,106,1318,54,85,1,0,0,1564,82,1204,50,409,0,0,0,1745,3309
52,Siena,73,76,966,26,81,1,0,0,1150,61,954,40,384,0,0,0,1439,2589
52,Siena,74,92,1004,36,80,0,0,0,1212,55,868,33,389,0,0,0,1345,2557
52,Siena,75,75,1022,26,91,1,0,0,1215,60,849,47,453,0,0,0,1409,2624
52,Siena,76,85,899,26,119,1,0,0,1130,63,738,27,457,0,0,0,1285,2415
52,Siena,77,90,918,19,90,0,0,0,1117,52,778,38,548,0,0,0,1416,2533
52,Siena,78,93,1077,25,143,2,0,0,1340,55,890,33,695,0,0,0,1673,3013
52,Siena,79,100,942,15,137,0,0,0,1194,50,746,18,741,0,0,0,1555,2749
52,Siena,80,76,940,15,127,0,0,0,1158,56,654,23,798,0,0,0,1531,2689
52,Siena,81,79,818,13,134,0,0,0,1044,52,554,25,787,0,0,0,1418,2462
52,Siena,82,62,705,7,148,0,0,0,922,47,408,19,712,0,0,0,1186,2108
52,Siena,83,69,700,10,114,0,0,0,893,54,442,17,831,0,0,0,1344,2237
52,Siena,84,76,634,8,154,0,0,0,872,40,369,15,774,0,0,0,1198,2070
52,Siena,85,61,564,11,148,0,0,0,784,51,259,6,817,0,0,0,1133,1917
52,Siena,86,38,415,4,150,0,0,0,607,46,208,4,743,0,0,0,1001,1608
52,Siena,87,50,471,2,153,0,0,0,676,53,169,9,826,0,0,0,1057,1733
52,Siena,88,41,330,6,139,0,0,0,516,36,147,9,796,0,0,0,988,1504
52,Siena,89,29,272,4,123,0,0,0,428,41,99,7,667,0,0,0,814,1242
52,Siena,90,23,221,0,111,0,0,0,355,35,46,5,585,0,0,0,671,1026
52,Siena,91,18,148,1,107,0,0,0,274,36,50,6,566,0,0,0,658,932
52,Siena,92,17,134,0,98,0,0,0,249,21,37,2,487,0,0,0,547,796
52,Siena,93,5,72,0,75,0,0,0,152,15,36,1,386,0,0,0,438,590
52,Siena,94,9,52,0,73,0,0,0,134,25,10,3,317,0,0,0,355,489
52,Siena,95,3,45,0,52,0,0,0,100,17,9,2,255,0,0,0,283,383
52,Siena,96,6,21,1,40,0,0,0,68,12,7,1,208,0,0,0,228,296
52,Siena,97,2,11,0,29,0,0,0,42,10,4,1,144,0,0,0,159,201
52,Siena,98,0,8,0,19,0,0,0,27,9,1,0,95,0,0,0,105,132
52,Siena,99,1,4,0,7,0,0,0,12,0,0,0,51,0,0,0,51,63
52,Siena,100,0,5,0,8,0,0,0,13,3,0,0,61,0,0,0,64,77
53,Grosseto,0,714,0,0,0,0,0,0,714,644,0,0,0,0,0,0,644,1358
53,Grosseto,1,695,0,0,0,0,0,0,695,647,0,0,0,0,0,0,647,1342
53,Grosseto,2,765,0,0,0,0,0,0,765,702,0,0,0,0,0,0,702,1467
53,Grosseto,3,750,0,0,0,0,0,0,750,729,0,0,0,0,0,0,729,1479
53,Grosseto,4,744,0,0,0,0,0,0,744,717,0,0,0,0,0,0,717,1461
53,Grosseto,5,795,0,0,0,0,0,0,795,765,0,0,0,0,0,0,765,1560
53,Grosseto,6,862,0,0,0,0,0,0,862,780,0,0,0,0,0,0,780,1642
53,Grosseto,7,962,0,0,0,0,0,0,962,829,0,0,0,0,0,0,829,1791
53,Grosseto,8,890,0,0,0,0,0,0,890,882,0,0,0,0,0,0,882,1772
53,Grosseto,9,963,0,0,0,0,0,0,963,880,0,0,0,0,0,0,880,1843
53,Grosseto,10,997,0,0,0,0,0,0,997,909,0,0,0,0,0,0,909,1906
53,Grosseto,11,977,0,0,0,0,0,0,977,882,0,0,0,0,0,0,882,1859
53,Grosseto,12,995,0,0,0,0,0,0,995,872,0,0,0,0,0,0,872,1867
53,Grosseto,13,943,0,0,0,0,0,0,943,893,0,0,0,0,0,0,893,1836
53,Grosseto,14,945,0,0,0,0,0,0,945,881,0,0,0,0,0,0,881,1826
53,Grosseto,15,958,0,0,0,0,0,0,958,876,0,0,0,0,0,0,876,1834
53,Grosseto,16,916,0,0,0,0,0,0,916,885,0,0,0,0,0,0,885,1801
53,Grosseto,17,916,0,0,0,0,0,0,916,869,0,0,0,0,0,0,869,1785
53,Grosseto,18,950,0,0,0,0,0,0,950,867,2,0,0,0,0,0,869,1819
53,Grosseto,19,960,0,0,0,0,0,0,960,895,11,0,0,0,0,0,906,1866
53,Grosseto,20,1021,2,0,0,0,0,0,1023,893,11,0,0,0,0,0,904,1927
53,Grosseto,21,961,1,0,0,0,0,0,962,878,26,0,0,0,0,0,904,1866
53,Grosseto,22,1029,8,0,0,0,0,0,1037,843,54,0,0,0,0,0,897,1934
53,Grosseto,23,958,11,0,0,1,0,0,970,766,52,0,1,0,0,0,819,1789
53,Grosseto,24,1031,30,0,0,0,0,0,1061,863,80,0,0,0,0,0,943,2004
53,Grosseto,25,976,30,0,0,0,0,0,1006,826,111,1,0,0,0,0,938,1944
53,Grosseto,26,993,49,1,0,2,0,0,1045,802,142,2,0,0,0,0,946,1991
53,Grosseto,27,1019,54,1,0,0,0,0,1074,851,163,5,1,0,0,0,1020,2094
53,Grosseto,28,970,109,2,0,0,0,0,1081,766,218,4,0,0,0,0,988,2069
53,Grosseto,29,972,123,1,0,0,0,0,1096,744,276,6,3,0,0,0,1029,2125
53,Grosseto,30,954,196,4,0,1,0,0,1155,723,327,9,3,1,0,0,1063,2218
53,Grosseto,31,861,234,3,0,2,0,0,1100,633,370,9,1,1,0,0,1014,2114
53,Grosseto,32,751,252,8,0,0,0,0,1011,623,429,17,0,0,0,0,1069,2080
53,Grosseto,33,813,284,4,0,1,0,0,1102,572,430,15,1,0,0,0,1018,2120
53,Grosseto,34,773,361,10,0,1,0,0,1145,546,478,25,2,1,0,0,1052,2197
53,Grosseto,35,769,383,10,0,2,0,0,1164,556,551,18,1,0,0,0,1126,2290
53,Grosseto,36,724,423,14,1,0,0,0,1162,583,601,36,1,0,0,0,1221,2383
53,Grosseto,37,710,490,12,1,2,0,0,1215,535,648,34,3,1,0,0,1221,2436
53,Grosseto,38,761,548,19,0,0,0,0,1328,471,671,48,3,0,0,0,1193,2521
53,Grosseto,39,686,613,38,1,1,0,0,1339,525,762,41,6,0,0,0,1334,2673
53,Grosseto,40,676,702,27,0,1,0,0,1406,543,797,68,3,1,0,0,1412,2818
53,Grosseto,41,688,726,28,2,1,0,0,1445,544,897,62,12,1,0,0,1516,2961
53,Grosseto,42,683,787,41,5,1,0,0,1517,546,958,87,14,0,0,0,1605,3122
53,Grosseto,43,696,895,52,3,3,0,0,1649,488,1054,87,14,0,0,0,1643,3292
53,Grosseto,44,663,930,58,3,1,0,0,1655,539,1093,103,12,1,0,0,1748,3403
53,Grosseto,45,633,985,75,5,1,0,0,1699,486,1157,113,14,0,0,0,1770,3469
53,Grosseto,46,616,993,73,7,1,0,0,1690,484,1252,119,30,1,0,0,1886,3576
53,Grosseto,47,539,1099,74,3,0,0,0,1715,413,1208,143,37,0,0,0,1801,3516
53,Grosseto,48,533,1081,93,5,0,0,0,1712,381,1180,151,33,0,0,0,1745,3457
53,Grosseto,49,515,1189,86,4,0,0,0,1794,397,1300,164,30,0,0,0,1891,3685
53,Grosseto,50,486,1189,113,6,2,0,0,1796,366,1248,163,39,0,0,0,1816,3612
53,Grosseto,51,426,1193,119,8,0,0,0,1746,348,1251,161,36,2,0,0,1798,3544
53,Grosseto,52,393,1241,138,8,0,0,0,1780,301,1325,171,68,0,0,0,1865,3645
53,Grosseto,53,358,1272,167,18,0,0,0,1815,322,1351,177,55,0,0,0,1905,3720
53,Grosseto,54,345,1292,137,17,3,0,0,1794,302,1413,190,66,0,0,0,1971,3765
53,Grosseto,55,350,1250,140,21,2,0,0,1763,257,1332,214,89,0,0,0,1892,3655
53,Grosseto,56,257,1231,129,13,0,0,0,1630,211,1256,155,89,0,0,0,1711,3341
53,Grosseto,57,249,1178,130,22,0,0,0,1579,228,1279,162,79,1,0,0,1749,3328
53,Grosseto,58,213,1230,125,22,0,0,0,1590,195,1247,153,94,0,0,0,1689,3279
53,Grosseto,59,220,1132,136,20,0,0,0,1508,184,1189,148,118,1,0,0,1640,3148
53,Grosseto,60,199,1111,115,28,1,0,0,1454,177,1211,157,132,1,0,0,1678,3132
53,Grosseto,61,178,1135,122,27,3,0,0,1465,181,1208,155,149,0,0,0,1693,3158
53,Grosseto,62,155,1188,118,42,1,0,0,1504,161,1204,142,144,0,0,0,1651,3155
53,Grosseto,63,160,1139,106,43,0,0,0,1448,152,1219,141,165,0,0,0,1677,3125
53,Grosseto,64,148,1151,100,45,0,0,0,1444,143,1122,140,195,0,0,0,1600,3044
53,Grosseto,65,150,1129,79,34,0,0,0,1392,99,1100,117,179,0,0,0,1495,2887
53,Grosseto,66,90,1167,106,49,0,0,0,1412,103,1019,84,203,0,0,0,1409,2821
53,Grosseto,67,126,1077,80,54,2,0,0,1339,113,997,105,215,0,0,0,1430,2769
53,Grosseto,68,127,1193,77,55,0,0,0,1452,115,1098,91,231,0,0,0,1535,2987
53,Grosseto,69,104,1234,72,70,0,0,0,1480,107,1119,72,318,0,0,0,1616,3096
53,Grosseto,70,95,1279,71,82,1,0,0,1528,94,1165,79,347,1,0,0,1686,3214
53,Grosseto,71,85,1222,70,81,1,0,0,1459,95,1121,76,375,0,0,0,1667,3126
53,Grosseto,72,95,1239,50,116,2,0,0,1502,82,1083,48,411,0,0,0,1624,3126
53,Grosseto,73,61,915,41,105,0,0,0,1122,64,845,55,395,0,0,0,1359,2481
53,Grosseto,74,78,906,55,88,0,0,0,1127,51,779,39,396,0,0,0,1265,2392
53,Grosseto,75,71,871,34,85,0,0,0,1061,57,742,37,409,0,0,0,1245,2306
53,Grosseto,76,66,819,22,87,0,0,0,994,56,703,35,438,0,0,0,1232,2226
53,Grosseto,77,55,854,27,109,0,0,0,1045,54,679,43,486,1,0,0,1263,2308
53,Grosseto,78,65,897,37,108,0,0,0,1107,61,729,35,647,0,0,0,1472,2579
53,Grosseto,79,79,841,23,140,0,0,0,1083,55,606,26,658,0,0,0,1345,2428
53,Grosseto,80,82,790,28,139,0,0,0,1039,76,564,31,682,0,0,0,1353,2392
53,Grosseto,81,59,688,13,105,0,0,0,865,70,481,24,682,0,0,0,1257,2122
53,Grosseto,82,46,599,17,132,0,0,0,794,53,393,13,627,0,0,0,1086,1880
53,Grosseto,83,46,592,9,114,0,0,0,761,61,320,20,685,0,0,0,1086,1847
53,Grosseto,84,33,500,8,141,0,0,0,682,32,262,13,688,0,0,0,995,1677
53,Grosseto,85,43,409,4,125,0,0,0,581,38,185,16,706,0,0,0,945,1526
53,Grosseto,86,26,381,8,111,0,0,0,526,36,163,14,596,0,0,0,809,1335
53,Grosseto,87,31,343,8,113,0,0,0,495,34,145,12,653,0,0,0,844,1339
53,Grosseto,88,25,257,4,126,0,0,0,412,29,101,12,641,0,0,0,783,1195
53,Grosseto,89,17,183,2,87,0,0,0,289,16,66,4,500,0,0,0,586,875
53,Grosseto,90,11,156,2,103,0,0,0,272,23,58,6,515,0,0,0,602,874
53,Grosseto,91,11,145,3,82,0,0,0,241,16,40,2,456,0,0,0,514,755
53,Grosseto,92,13,75,3,73,0,0,0,164,26,28,3,379,0,0,0,436,600
53,Grosseto,93,13,69,0,58,0,0,0,140,16,12,2,286,0,0,0,316,456
53,Grosseto,94,3,37,0,44,0,0,0,84,16,6,2,241,0,0,0,265,349
53,Grosseto,95,2,28,0,34,0,0,0,64,8,7,0,199,0,0,0,214,278
53,Grosseto,96,1,11,1,20,0,0,0,33,9,6,1,136,0,0,0,152,185
53,Grosseto,97,0,13,0,20,0,0,0,33,3,3,0,111,0,0,0,117,150
53,Grosseto,98,0,6,0,12,0,0,0,18,1,0,0,76,0,0,0,77,95
53,Grosseto,99,1,3,0,11,0,0,0,15,1,0,0,31,0,0,0,32,47
53,Grosseto,100,0,3,0,8,0,0,0,11,4,0,1,51,0,0,0,56,67
54,Perugia,0,2355,0,0,0,0,0,0,2355,2106,0,0,0,0,0,0,2106,4461
54,Perugia,1,2424,0,0,0,0,0,0,2424,2290,0,0,0,0,0,0,2290,4714
54,Perugia,2,2566,0,0,0,0,0,0,2566,2409,0,0,0,0,0,0,2409,4975
54,Perugia,3,2626,0,0,0,0,0,0,2626,2468,0,0,0,0,0,0,2468,5094
54,Perugia,4,2689,0,0,0,0,0,0,2689,2642,0,0,0,0,0,0,2642,5331
54,Perugia,5,2866,0,0,0,0,0,0,2866,2684,0,0,0,0,0,0,2684,5550
54,Perugia,6,2908,0,0,0,0,0,0,2908,2911,0,0,0,0,0,0,2911,5819
54,Perugia,7,3004,0,0,0,0,0,0,3004,2898,0,0,0,0,0,0,2898,5902
54,Perugia,8,3089,0,0,0,0,0,0,3089,2844,0,0,0,0,0,0,2844,5933
54,Perugia,9,3147,0,0,0,0,0,0,3147,2887,0,0,0,0,0,0,2887,6034
54,Perugia,10,3184,0,0,0,0,0,0,3184,3147,0,0,0,0,0,0,3147,6331
54,Perugia,11,3197,0,0,0,0,0,0,3197,2984,0,0,0,0,0,0,2984,6181
54,Perugia,12,3192,0,0,0,0,0,0,3192,2946,0,0,0,0,0,0,2946,6138
54,Perugia,13,3153,0,0,0,0,0,0,3153,2966,0,0,0,0,0,0,2966,6119
54,Perugia,14,3013,0,0,0,0,0,0,3013,2905,0,0,0,0,0,0,2905,5918
54,Perugia,15,3097,0,0,0,0,0,0,3097,2787,0,0,0,0,0,0,2787,5884
54,Perugia,16,2968,0,0,0,0,0,0,2968,2847,0,0,0,0,0,0,2847,5815
54,Perugia,17,2999,0,0,0,0,0,0,2999,2801,1,0,0,0,0,0,2802,5801
54,Perugia,18,3001,0,0,0,0,0,0,3001,2896,3,0,0,0,0,0,2899,5900
54,Perugia,19,3138,0,0,0,0,0,0,3138,2637,18,0,0,0,0,0,2655,5793
54,Perugia,20,3143,3,0,0,0,0,0,3146,2702,36,0,0,1,0,0,2739,5885
54,Perugia,21,3071,5,0,0,0,0,0,3076,2748,60,0,0,0,0,0,2808,5884
54,Perugia,22,3102,14,1,0,0,0,0,3117,2720,121,0,0,0,0,0,2841,5958
54,Perugia,23,3048,46,0,0,1,0,0,3095,2748,153,1,0,0,0,0,2902,5997
54,Perugia,24,2993,47,0,0,0,0,0,3040,2660,216,0,0,0,0,0,2876,5916
54,Perugia,25,3157,99,1,0,0,0,0,3257,2669,322,3,0,0,0,0,2994,6251
54,Perugia,26,3215,156,0,0,0,0,0,3371,2693,490,4,1,1,0,0,3189,6560
54,Perugia,27,3101,203,5,0,0,0,0,3309,2480,602,7,1,0,0,0,3090,6399
54,Perugia,28,2998,333,6,0,1,0,0,3338,2450,751,19,0,0,0,0,3220,6558
54,Perugia,29,3005,486,3,1,2,0,0,3497,2365,966,18,2,1,0,0,3352,6849
54,Perugia,30,2883,657,9,0,3,0,0,3552,2368,1247,25,2,2,0,0,3644,7196
54,Perugia,31,2649,786,15,1,1,0,0,3452,2023,1389,30,7,1,0,0,3450,6902
54,Perugia,32,2496,946,13,1,3,0,0,3459,1922,1513,50,6,0,0,0,3491,6950
54,Perugia,33,2412,1085,23,0,4,0,0,3524,1903,1754,48,7,2,0,0,3714,7238
54,Perugia,34,2247,1329,24,1,3,0,0,3604,1771,1970,63,7,2,0,0,3813,7417
54,Perugia,35,2326,1607,22,4,1,0,0,3960,1646,2242,89,5,5,0,0,3987,7947
54,Perugia,36,2120,1720,39,1,3,0,0,3883,1584,2154,96,9,1,0,0,3844,7727
54,Perugia,37,2038,1874,54,2,1,0,0,3969,1510,2461,93,14,4,0,0,4082,8051
54,Perugia,38,1904,2066,63,2,1,0,0,4036,1424,2552,136,14,1,0,0,4127,8163
54,Perugia,39,1950,2182,78,1,1,0,0,4212,1290,2748,155,22,0,0,0,4215,8427
54,Perugia,40,1864,2361,94,4,4,0,0,4327,1409,2885,161,24,1,0,0,4480,8807
54,Perugia,41,1808,2631,108,4,4,0,0,4555,1310,3052,198,34,3,0,0,4597,9152
54,Perugia,42,1820,2662,134,5,4,0,0,4625,1274,3329,203,35,3,0,0,4844,9469
54,Perugia,43,1756,2910,149,7,2,0,0,4824,1314,3476,242,41,4,0,0,5077,9901
54,Perugia,44,1675,3227,162,9,3,0,0,5076,1234,3674,262,53,1,0,0,5224,10300
54,Perugia,45,1623,3265,137,13,6,0,0,5044,1100,3683,295,66,0,0,0,5144,10188
54,Perugia,46,1439,3273,202,11,4,0,0,4929,1092,3674,313,68,2,0,0,5149,10078
54,Perugia,47,1383,3409,203,12,5,0,0,5012,984,3761,319,74,2,0,0,5140,10152
54,Perugia,48,1242,3500,230,15,3,0,0,4990,918,3753,305,79,1,0,0,5056,10046
54,Perugia,49,1191,3524,233,22,1,0,0,4971,904,3967,381,79,0,0,0,5331,10302
54,Perugia,50,1091,3570,237,21,2,0,0,4921,867,3949,384,141,0,0,0,5341,10262
54,Perugia,51,1003,3629,258,18,2,0,0,4910,840,4044,358,104,1,0,0,5347,10257
54,Perugia,52,1040,3687,256,28,8,0,0,5019,744,3931,368,135,2,0,0,5180,10199
54,Perugia,53,966,3882,259,43,2,0,0,5152,746,4132,377,171,1,0,0,5427,10579
54,Perugia,54,865,4033,289,39,2,0,0,5228,662,4164,425,201,1,0,0,5453,10681
54,Perugia,55,775,3589,254,53,5,0,0,4676,617,3984,356,188,0,0,0,5145,9821
54,Perugia,56,729,3631,262,38,3,0,0,4663,492,3930,373,230,1,0,0,5026,9689
54,Perugia,57,673,3770,253,55,2,0,0,4753,524,3865,346,273,0,0,0,5008,9761
54,Perugia,58,607,3694,274,59,1,0,0,4635,488,3878,359,260,0,0,0,4985,9620
54,Perugia,59,546,3590,235,72,2,0,0,4445,476,3697,325,306,0,0,0,4804,9249
54,Perugia,60,516,3315,193,63,4,0,0,4091,424,3475,296,308,0,0,0,4503,8594
54,Perugia,61,469,3266,212,76,2,0,0,4025,370,3426,280,373,0,1,0,4450,8475
54,Perugia,62,424,3412,205,92,4,0,0,4137,366,3375,257,365,0,0,0,4363,8500
54,Perugia,63,433,3309,166,100,0,0,0,4008,321,3390,227,370,0,0,0,4308,8316
54,Perugia,64,372,3231,186,88,0,0,0,3877,305,3255,196,474,0,0,0,4230,8107
54,Perugia,65,370,3239,150,106,2,0,0,3867,288,3108,195,540,0,0,0,4131,7998
54,Perugia,66,310,2989,125,100,1,0,0,3525,270,2886,181,544,0,0,0,3881,7406
54,Perugia,67,327,3149,139,119,1,0,0,3735,251,3046,196,628,0,0,0,4121,7856
54,Perugia,68,298,3263,141,166,4,0,0,3872,259,3033,174,634,1,0,0,4101,7973
54,Perugia,69,264,3312,124,157,0,0,0,3857,249,3065,189,772,0,0,0,4275,8132
54,Perugia,70,286,3494,120,185,2,0,0,4087,267,3206,153,892,0,0,0,4518,8605
54,Perugia,71,291,3185,88,210,0,0,0,3774,230,2847,133,923,0,0,0,4133,7907
54,Perugia,72,275,2945,94,212,1,0,0,3527,199,2702,125,991,0,0,0,4017,7544
54,Perugia,73,214,2362,58,169,0,0,0,2803,169,2060,96,877,0,0,0,3202,6005
54,Perugia,74,222,2470,57,204,1,0,0,2954,182,2170,80,1056,0,0,0,3488,6442
54,Perugia,75,226,2592,48,243,0,0,0,3109,177,2102,78,1140,0,0,0,3497,6606
54,Perugia,76,218,2259,59,237,0,0,0,2773,161,1795,66,1179,1,0,0,3202,5975
54,Perugia,77,203,2220,44,276,0,0,0,2743,168,1777,72,1276,0,0,0,3293,6036
54,Perugia,78,211,2458,49,279,0,0,0,2997,186,1832,81,1568,0,0,0,3667,6664
54,Perugia,79,192,2274,42,326,1,0,0,2835,196,1762,65,1684,0,0,0,3707,6542
54,Perugia,80,203,2325,45,337,0,0,0,2910,152,1606,49,1864,0,0,0,3671,6581
54,Perugia,81,143,1891,26,299,1,0,0,2360,139,1257,56,1836,0,0,0,3288,5648
54,Perugia,82,134,1635,17,310,0,0,0,2096,152,1081,35,1797,0,0,0,3065,5161
54,Perugia,83,151,1566,23,335,0,0,0,2075,146,913,29,1886,0,0,0,2974,5049
54,Perugia,84,126,1418,21,358,1,0,0,1924,157,777,18,1964,0,0,0,2916,4840
54,Perugia,85,108,1260,12,345,0,0,0,1725,123,612,25,1851,0,0,0,2611,4336
54,Perugia,86,91,1052,8,319,0,0,0,1470,118,468,18,1731,0,0,0,2335,3805
54,Perugia,87,81,932,7,362,1,0,0,1383,115,371,22,1880,0,0,0,2388,3771
54,Perugia,88,71,783,3,325,1,0,0,1183,92,299,13,1799,0,0,0,2203,3386
54,Perugia,89,39,566,4,259,0,0,0,868,102,170,15,1502,0,0,0,1789,2657
54,Perugia,90,44,468,5,234,0,0,0,751,83,141,9,1339,0,0,0,1572,2323
54,Perugia,91,36,361,2,223,0,0,0,622,83,116,7,1276,0,0,0,1482,2104
54,Perugia,92,35,237,3,220,0,0,0,495,78,73,11,1038,0,0,0,1200,1695
54,Perugia,93,16,194,2,165,0,0,0,377,54,33,7,943,0,0,0,1037,1414
54,Perugia,94,18,125,0,140,0,0,0,283,62,32,6,717,0,0,0,817,1100
54,Perugia,95,6,73,0,96,0,0,0,175,36,11,4,526,0,0,0,577,752
54,Perugia,96,9,40,0,78,0,0,0,127,26,15,6,391,0,0,0,438,565
54,Perugia,97,4,28,1,59,0,0,0,92,15,8,1,303,0,0,0,327,419
54,Perugia,98,2,13,1,35,0,0,0,51,16,3,1,214,0,0,0,234,285
54,Perugia,99,0,10,0,12,0,0,0,22,10,2,0,108,0,0,0,120,142
54,Perugia,100,2,3,0,15,0,0,0,20,19,4,1,141,0,0,0,165,185
55,Terni,0,674,0,0,0,0,0,0,674,681,0,0,0,0,0,0,681,1355
55,Terni,1,694,0,0,0,0,0,0,694,670,0,0,0,0,0,0,670,1364
55,Terni,2,736,0,0,0,0,0,0,736,736,0,0,0,0,0,0,736,1472
55,Terni,3,724,0,0,0,0,0,0,724,728,0,0,0,0,0,0,728,1452
55,Terni,4,866,0,0,0,0,0,0,866,759,0,0,0,0,0,0,759,1625
55,Terni,5,876,0,0,0,0,0,0,876,831,0,0,0,0,0,0,831,1707
55,Terni,6,896,0,0,0,0,0,0,896,873,0,0,0,0,0,0,873,1769
55,Terni,7,906,0,0,0,0,0,0,906,872,0,0,0,0,0,0,872,1778
55,Terni,8,969,0,0,0,0,0,0,969,948,0,0,0,0,0,0,948,1917
55,Terni,9,923,0,0,0,0,0,0,923,899,0,0,0,0,0,0,899,1822
55,Terni,10,1012,0,0,0,0,0,0,1012,891,0,0,0,0,0,0,891,1903
55,Terni,11,1053,0,0,0,0,0,0,1053,978,0,0,0,0,0,0,978,2031
55,Terni,12,997,0,0,0,0,0,0,997,958,0,0,0,0,0,0,958,1955
55,Terni,13,1015,0,0,0,0,0,0,1015,914,0,0,0,0,0,0,914,1929
55,Terni,14,993,0,0,0,0,0,0,993,910,0,0,0,0,0,0,910,1903
55,Terni,15,955,0,0,0,0,0,0,955,899,0,0,0,0,0,0,899,1854
55,Terni,16,978,0,0,0,0,0,0,978,943,0,0,0,0,0,0,943,1921
55,Terni,17,952,0,0,0,0,0,0,952,903,0,0,0,0,0,0,903,1855
55,Terni,18,993,0,0,0,0,0,0,993,957,1,0,0,0,0,0,958,1951
55,Terni,19,1061,1,0,0,0,0,0,1062,945,5,0,0,0,0,0,950,2012
55,Terni,20,1071,1,0,0,0,1,0,1073,924,13,0,0,0,0,0,937,2010
55,Terni,21,1061,1,0,0,0,0,0,1062,899,10,0,0,0,0,0,909,1971
55,Terni,22,1046,6,0,0,0,0,0,1052,878,23,0,0,0,0,0,901,1953
55,Terni,23,1031,9,0,0,0,0,0,1040,858,40,0,0,0,0,0,898,1938
55,Terni,24,1033,12,0,0,0,0,0,1045,902,68,0,0,0,0,0,970,2015
55,Terni,25,950,26,1,0,0,0,0,977,890,82,1,0,1,0,0,974,1951
55,Terni,26,1035,38,0,0,1,0,0,1074,866,125,2,0,1,0,0,994,2068
55,Terni,27,1016,55,0,0,0,0,0,1071,846,188,6,1,0,0,0,1041,2112
55,Terni,28,1003,107,4,0,0,0,0,1114,843,222,4,0,0,0,0,1069,2183
55,Terni,29,949,124,2,0,0,1,0,1076,799,275,0,0,0,0,0,1074,2150
55,Terni,30,967,183,0,0,0,0,0,1150,721,342,3,1,0,0,0,1067,2217
55,Terni,31,853,268,8,0,1,0,0,1130,649,417,12,2,0,0,0,1080,2210
55,Terni,32,874,276,4,0,0,0,0,1154,644,499,13,2,1,0,0,1159,2313
55,Terni,33,826,316,8,0,0,0,0,1150,589,558,21,1,2,0,0,1171,2321
55,Terni,34,765,381,11,0,0,0,0,1157,549,563,18,3,0,0,0,1133,2290
55,Terni,35,781,433,7,0,1,0,0,1222,592,646,22,5,1,0,0,1266,2488
55,Terni,36,719,545,16,1,1,0,0,1282,563,711,28,2,0,0,0,1304,2586
55,Terni,37,684,615,19,0,0,0,0,1318,519,740,48,5,1,0,0,1313,2631
55,Terni,38,627,655,21,0,1,0,0,1304,454,760,39,7,1,0,0,1261,2565
55,Terni,39,621,697,24,0,0,0,0,1342,468,857,37,7,0,0,0,1369,2711
55,Terni,40,620,736,25,2,0,0,0,1383,485,979,50,8,0,0,0,1522,2905
55,Terni,41,626,811,38,3,0,0,0,1478,406,1055,78,13,0,0,0,1552,3030
55,Terni,42,634,931,40,2,0,0,0,1607,406,1019,89,12,0,0,0,1526,3133
55,Terni,43,598,962,44,1,0,0,0,1605,397,1168,91,20,0,0,0,1676,3281
55,Terni,44,529,1038,52,3,2,0,0,1624,401,1336,104,24,0,0,0,1865,3489
55,Terni,45,541,1087,58,2,1,0,0,1689,380,1285,120,17,0,0,0,1802,3491
55,Terni,46,492,1061,83,3,0,0,0,1639,361,1318,126,21,1,0,0,1827,3466
55,Terni,47,479,1135,91,4,1,0,0,1710,370,1382,130,27,0,0,0,1909,3619
55,Terni,48,446,1158,92,15,2,0,0,1713,307,1309,145,31,0,0,0,1792,3505
55,Terni,49,409,1312,80,9,0,0,0,1810,309,1412,145,37,0,0,0,1903,3713
55,Terni,50,401,1290,98,7,1,0,0,1797,271,1450,144,49,0,0,1,1915,3712
55,Terni,51,351,1267,98,12,1,0,0,1729,262,1412,142,52,0,0,0,1868,3597
55,Terni,52,348,1229,105,21,1,0,0,1704,233,1472,155,49,0,0,0,1909,3613
55,Terni,53,321,1361,106,14,2,0,0,1804,244,1449,159,71,0,0,0,1923,3727
55,Terni,54,276,1355,122,15,0,0,0,1768,212,1499,144,78,1,0,0,1934,3702
55,Terni,55,230,1359,105,16,1,0,0,1711,200,1449,149,69,0,0,0,1867,3578
55,Terni,56,233,1269,118,21,0,0,0,1641,178,1374,146,76,0,0,0,1774,3415
55,Terni,57,224,1218,118,21,1,0,0,1582,148,1356,135,91,0,0,0,1730,3312
55,Terni,58,178,1259,90,20,0,0,0,1547,142,1319,142,101,1,0,0,1705,3252
55,Terni,59,179,1173,93,26,0,0,0,1471,146,1280,111,109,0,0,0,1646,3117
55,Terni,60,191,1193,91,22,2,0,0,1499,115,1207,127,126,0,0,0,1575,3074
55,Terni,61,160,1123,93,34,1,0,0,1411,125,1148,113,130,0,0,0,1516,2927
55,Terni,62,135,1169,78,35,0,0,0,1417,126,1251,117,161,1,0,0,1656,3073
55,Terni,63,139,1153,70,38,0,0,0,1400,106,1225,120,173,0,0,0,1624,3024
55,Terni,64,118,1097,70,42,1,0,0,1328,92,1215,100,164,0,0,0,1571,2899
55,Terni,65,115,1087,73,45,1,0,0,1321,105,1129,96,206,0,0,0,1536,2857
55,Terni,66,101,1071,83,50,0,0,0,1305,98,1142,78,200,0,0,0,1518,2823
55,Terni,67,105,1132,70,45,0,0,0,1352,84,1103,85,220,0,0,0,1492,2844
55,Terni,68,105,1078,65,58,0,0,0,1306,87,1132,87,270,0,0,0,1576,2882
55,Terni,69,118,1198,79,72,1,0,0,1468,87,1142,77,276,0,0,0,1582,3050
55,Terni,70,101,1346,63,75,1,0,0,1586,84,1198,64,338,0,0,0,1684,3270
55,Terni,71,107,1227,52,84,0,0,0,1470,69,1117,56,350,0,0,0,1592,3062
55,Terni,72,87,1162,41,93,0,0,0,1383,69,1079,58,370,0,0,0,1576,2959
55,Terni,73,74,905,29,72,1,0,0,1081,44,858,60,328,0,0,0,1290,2371
55,Terni,74,70,894,22,84,0,0,0,1070,78,822,41,394,0,0,0,1335,2405
55,Terni,75,64,990,30,88,1,0,0,1173,62,839,30,474,0,0,0,1405,2578
55,Terni,76,66,937,28,89,0,0,0,1120,47,755,56,468,0,0,0,1326,2446
55,Terni,77,71,931,20,92,0,0,0,1114,55,730,28,498,0,0,0,1311,2425
55,Terni,78,78,1010,22,123,0,0,0,1233,65,720,25,621,0,0,0,1431,2664
55,Terni,79,68,881,14,129,0,0,0,1092,62,629,34,636,0,0,0,1361,2453
55,Terni,80,53,827,12,154,0,0,0,1046,53,519,33,718,0,0,0,1323,2369
55,Terni,81,48,715,12,126,0,0,0,901,57,496,20,730,0,0,0,1303,2204
55,Terni,82,43,596,15,118,0,0,0,772,33,370,19,647,0,0,0,1069,1841
55,Terni,83,41,576,13,145,0,0,0,775,65,346,13,699,0,0,0,1123,1898
55,Terni,84,53,509,7,120,0,0,0,689,46,269,12,663,0,0,0,990,1679
55,Terni,85,42,455,11,136,0,0,0,644,42,234,9,747,0,0,0,1032,1676
55,Terni,86,21,389,7,140,0,0,0,557,45,157,13,619,0,0,0,834,1391
55,Terni,87,17,329,5,133,0,0,0,484,30,126,9,674,0,0,0,839,1323
55,Terni,88,15,281,5,129,0,0,0,430,38,124,10,676,0,0,0,848,1278
55,Terni,89,13,204,2,104,0,0,0,323,24,90,10,575,0,0,0,699,1022
55,Terni,90,12,137,3,117,0,0,0,269,26,58,3,486,0,0,0,573,842
55,Terni,91,8,111,6,84,0,0,0,209,29,42,4,459,0,0,0,534,743
55,Terni,92,1,101,0,82,0,0,0,184,24,22,2,367,0,0,0,415,599
55,Terni,93,8,78,0,76,0,0,0,162,12,20,2,315,0,0,0,349,511
55,Terni,94,6,46,0,57,0,0,0,109,10,17,1,242,0,0,0,270,379
55,Terni,95,2,24,0,46,0,0,0,72,16,11,2,210,0,0,0,239,311
55,Terni,96,0,18,0,22,0,0,0,40,10,1,0,149,0,0,0,160,200
55,Terni,97,0,11,0,23,0,0,0,34,7,3,0,116,0,0,0,126,160
55,Terni,98,1,6,0,15,0,0,0,22,2,2,0,68,0,0,0,72,94
55,Terni,99,0,3,0,2,0,0,0,5,0,0,0,38,0,0,0,38,43
55,Terni,100,0,7,0,4,0,0,0,11,9,2,1,46,0,0,0,58,69
56,Viterbo,0,1103,0,0,0,0,0,0,1103,1000,0,0,0,0,0,0,1000,2103
56,Viterbo,1,1138,0,0,0,0,0,0,1138,1011,0,0,0,0,0,0,1011,2149
56,Viterbo,2,1149,0,0,0,0,0,0,1149,1121,0,0,0,0,0,0,1121,2270
56,Viterbo,3,1191,0,0,0,0,0,0,1191,1192,0,0,0,0,0,0,1192,2383
56,Viterbo,4,1282,0,0,0,0,0,0,1282,1190,0,0,0,0,0,0,1190,2472
56,Viterbo,5,1292,0,0,0,0,0,0,1292,1201,0,0,0,0,0,0,1201,2493
56,Viterbo,6,1308,0,0,0,0,0,0,1308,1264,0,0,0,0,0,0,1264,2572
56,Viterbo,7,1382,0,0,0,0,0,0,1382,1238,0,0,0,0,0,0,1238,2620
56,Viterbo,8,1363,0,0,0,0,0,0,1363,1326,0,0,0,0,0,0,1326,2689
56,Viterbo,9,1432,0,0,0,0,0,0,1432,1353,0,0,0,0,0,0,1353,2785
56,Viterbo,10,1460,0,0,0,0,0,0,1460,1384,0,0,0,0,0,0,1384,2844
56,Viterbo,11,1439,0,0,0,0,0,0,1439,1303,0,0,0,0,0,0,1303,2742
56,Viterbo,12,1412,0,0,0,0,0,0,1412,1410,0,0,0,0,0,0,1410,2822
56,Viterbo,13,1353,0,0,0,0,0,0,1353,1300,0,0,0,0,0,0,1300,2653
56,Viterbo,14,1421,0,0,0,0,0,0,1421,1288,0,0,0,0,0,0,1288,2709
56,Viterbo,15,1382,0,0,0,0,0,0,1382,1271,0,0,0,0,0,0,1271,2653
56,Viterbo,16,1393,0,0,0,0,0,0,1393,1305,0,0,0,0,0,0,1305,2698
56,Viterbo,17,1410,0,1,0,0,0,0,1411,1348,0,0,0,0,0,0,1348,2759
56,Viterbo,18,1428,1,0,0,0,0,0,1429,1329,2,0,0,0,0,0,1331,2760
56,Viterbo,19,1451,1,0,0,0,0,0,1452,1314,3,0,0,0,0,0,1317,2769
56,Viterbo,20,1611,4,0,0,0,0,0,1615,1334,21,0,0,0,0,0,1355,2970
56,Viterbo,21,1514,9,0,0,0,0,0,1523,1368,26,0,0,0,0,0,1394,2917
56,Viterbo,22,1537,7,0,1,0,0,0,1545,1300,46,0,0,0,0,0,1346,2891
56,Viterbo,23,1601,12,0,0,0,0,0,1613,1378,63,0,0,0,0,0,1441,3054
56,Viterbo,24,1527,25,0,0,0,0,0,1552,1370,86,1,0,0,0,0,1457,3009
56,Viterbo,25,1636,30,0,0,0,0,0,1666,1291,121,1,0,0,0,0,1413,3079
56,Viterbo,26,1652,66,1,0,0,0,0,1719,1341,159,4,0,1,0,0,1505,3224
56,Viterbo,27,1571,81,1,0,1,0,0,1654,1240,239,3,0,0,0,0,1482,3136
56,Viterbo,28,1593,150,2,0,1,0,0,1746,1345,309,7,1,0,0,0,1662,3408
56,Viterbo,29,1535,179,4,0,0,0,0,1718,1217,433,6,0,1,0,0,1657,3375
56,Viterbo,30,1547,276,4,0,1,1,0,1829,1204,552,11,1,1,0,0,1769,3598
56,Viterbo,31,1468,344,3,0,1,0,0,1816,1087,561,17,1,0,0,0,1666,3482
56,Viterbo,32,1378,387,6,0,0,0,0,1771,969,720,30,5,1,0,0,1725,3496
56,Viterbo,33,1357,475,12,1,1,0,0,1846,943,812,32,4,2,0,0,1793,3639
56,Viterbo,34,1269,597,12,3,1,0,0,1882,940,867,32,2,1,0,0,1842,3724
56,Viterbo,35,1173,670,8,2,1,0,0,1854,883,991,42,7,1,0,0,1924,3778
56,Viterbo,36,1102,834,22,0,0,0,0,1958,850,1104,48,12,2,0,0,2016,3974
56,Viterbo,37,1070,964,24,0,1,0,0,2059,803,1180,60,10,0,0,0,2053,4112
56,Viterbo,38,1026,948,35,0,0,0,0,2009,732,1199,52,5,1,0,0,1989,3998
56,Viterbo,39,1027,1084,46,1,2,0,0,2160,694,1273,81,11,0,0,0,2059,4219
56,Viterbo,40,985,1220,57,0,1,1,0,2264,666,1456,106,17,2,0,0,2247,4511
56,Viterbo,41,944,1312,61,1,1,0,0,2319,628,1498,107,18,2,0,0,2253,4572
56,Viterbo,42,943,1351,66,1,2,0,0,2363,595,1589,128,19,1,0,0,2332,4695
56,Viterbo,43,947,1489,79,5,1,0,0,2521,595,1708,140,29,1,0,0,2473,4994
56,Viterbo,44,865,1558,94,1,3,0,0,2521,585,1802,142,25,1,0,0,2555,5076
56,Viterbo,45,776,1549,115,6,0,0,0,2446,503,1810,180,28,0,0,0,2521,4967
56,Viterbo,46,717,1662,104,6,1,0,0,2490,489,1870,200,35,0,0,0,2594,5084
56,Viterbo,47,689,1646,132,9,2,0,1,2479,451,1897,170,42,0,0,0,2560,5039
56,Viterbo,48,616,1722,136,14,3,0,0,2491,424,1845,192,48,0,0,0,2509,5000
56,Viterbo,49,554,1751,139,8,0,0,0,2452,422,1940,214,57,0,1,0,2634,5086
56,Viterbo,50,531,1794,153,16,3,0,0,2497,366,1921,216,70,0,0,0,2573,5070
56,Viterbo,51,476,1816,170,15,1,1,0,2479,363,2017,204,87,1,0,0,2672,5151
56,Viterbo,52,488,1993,179,21,3,0,0,2684,342,1931,200,85,0,0,0,2558,5242
56,Viterbo,53,473,1981,181,17,2,0,0,2654,350,1989,206,105,0,0,0,2650,5304
56,Viterbo,54,456,1995,173,21,2,0,0,2647,299,1981,229,112,0,0,0,2621,5268
56,Viterbo,55,362,1923,185,33,0,0,0,2503,258,1924,197,129,1,0,0,2509,5012
56,Viterbo,56,330,1806,173,32,2,0,0,2343,245,1876,182,134,1,0,0,2438,4781
56,Viterbo,57,290,1827,149,31,4,0,0,2301,236,1886,170,147,0,0,0,2439,4740
56,Viterbo,58,266,1810,126,44,2,0,0,2248,201,1846,167,160,1,0,0,2375,4623
56,Viterbo,59,256,1790,139,42,0,0,0,2227,193,1744,170,176,1,0,0,2284,4511
56,Viterbo,60,219,1767,126,51,2,0,0,2165,161,1685,147,208,0,0,0,2201,4366
56,Viterbo,61,212,1683,144,41,1,0,0,2081,177,1724,152,226,0,0,0,2279,4360
56,Viterbo,62,207,1684,112,46,0,0,0,2049,155,1683,146,263,2,0,0,2249,4298
56,Viterbo,63,211,1668,117,69,1,0,0,2066,159,1653,127,275,0,0,0,2214,4280
56,Viterbo,64,194,1744,102,60,1,0,0,2101,133,1653,131,286,1,0,0,2204,4305
56,Viterbo,65,163,1664,96,52,0,0,0,1975,135,1520,102,314,0,0,0,2071,4046
56,Viterbo,66,136,1614,72,74,1,0,0,1897,147,1456,109,304,1,0,0,2017,3914
56,Viterbo,67,149,1500,125,57,1,0,0,1832,105,1409,103,329,1,0,0,1947,3779
56,Viterbo,68,139,1655,100,88,1,0,0,1983,90,1367,96,367,0,0,0,1920,3903
56,Viterbo,69,157,1549,100,96,0,0,0,1902,112,1443,90,452,1,0,0,2098,4000
56,Viterbo,70,140,1674,61,108,0,0,0,1983,100,1436,77,479,0,0,0,2092,4075
56,Viterbo,71,154,1650,63,117,0,0,0,1984,96,1427,75,528,0,0,0,2126,4110
56,Viterbo,72,135,1518,67,130,0,0,0,1850,93,1300,72,573,0,0,0,2038,3888
56,Viterbo,73,81,1226,38,122,0,0,0,1467,92,994,51,546,0,0,0,1683,3150
56,Viterbo,74,101,1197,55,112,0,0,1,1466,79,969,47,573,0,0,0,1668,3134
56,Viterbo,75,82,1159,39,119,1,0,0,1400,81,900,47,589,0,0,0,1617,3017
56,Viterbo,76,73,1030,39,129,0,0,0,1271,64,812,34,590,0,1,0,1501,2772
56,Viterbo,77,81,1042,38,127,0,0,0,1288,78,748,33,664,0,0,0,1523,2811
56,Viterbo,78,93,1045,19,157,0,0,0,1314,87,731,43,807,0,0,0,1668,2982
56,Viterbo,79,74,1038,25,189,0,0,0,1326,73,663,33,857,0,0,0,1626,2952
56,Viterbo,80,61,960,17,171,0,0,0,1209,78,633,26,839,0,0,0,1576,2785
56,Viterbo,81,57,829,12,164,0,0,0,1062,76,512,26,867,0,0,0,1481,2543
56,Viterbo,82,57,727,12,153,0,0,0,949,71,424,17,842,0,0,0,1354,2303
56,Viterbo,83,55,638,11,168,0,0,0,872,51,366,18,838,0,0,0,1273,2145
56,Viterbo,84,43,574,5,157,0,0,0,779,51,283,11,855,0,0,0,1200,1979
56,Viterbo,85,29,499,14,156,0,0,0,698,50,237,16,851,0,0,0,1154,1852
56,Viterbo,86,34,433,6,158,0,0,0,631,51,175,11,747,0,0,0,984,1615
56,Viterbo,87,35,325,6,138,0,0,0,504,45,132,6,711,0,0,0,894,1398
56,Viterbo,88,30,293,3,109,0,0,0,435,39,110,7,807,0,0,0,963,1398
56,Viterbo,89,19,224,2,129,0,0,0,374,40,76,5,618,0,0,0,739,1113
56,Viterbo,90,11,148,0,98,0,0,0,257,35,56,8,542,0,0,0,641,898
56,Viterbo,91,14,120,0,92,0,0,0,226,24,42,4,484,0,0,0,554,780
56,Viterbo,92,5,93,1,70,0,0,0,169,26,27,3,390,0,0,0,446,615
56,Viterbo,93,4,66,0,68,0,0,0,138,25,16,3,290,0,0,0,334,472
56,Viterbo,94,6,45,1,60,0,0,0,112,23,10,2,224,0,0,0,259,371
56,Viterbo,95,3,20,0,38,0,0,0,61,21,7,1,220,0,0,0,249,310
56,Viterbo,96,2,13,0,24,0,0,0,39,15,6,1,151,0,0,0,173,212
56,Viterbo,97,0,6,0,19,0,0,0,25,8,5,0,107,0,0,0,120,145
56,Viterbo,98,1,5,0,8,0,0,0,14,5,0,0,86,0,0,0,91,105
56,Viterbo,99,1,3,0,8,0,0,0,12,2,1,0,24,0,0,0,27,39
56,Viterbo,100,1,1,0,3,0,0,0,5,2,0,0,49,0,0,0,51,56
57,Rieti,0,483,0,0,0,0,0,0,483,421,0,0,0,0,0,0,421,904
57,Rieti,1,519,0,0,0,0,0,0,519,482,0,0,0,0,0,0,482,1001
57,Rieti,2,518,0,0,0,0,0,0,518,518,0,0,0,0,0,0,518,1036
57,Rieti,3,562,0,0,0,0,0,0,562,520,0,0,0,0,0,0,520,1082
57,Rieti,4,570,0,0,0,0,0,0,570,544,0,0,0,0,0,0,544,1114
57,Rieti,5,616,0,0,0,0,0,0,616,510,0,0,0,0,0,0,510,1126
57,Rieti,6,615,0,0,0,0,0,0,615,567,0,0,0,0,0,0,567,1182
57,Rieti,7,637,0,0,0,0,0,0,637,615,0,0,0,0,0,0,615,1252
57,Rieti,8,606,0,0,0,0,0,0,606,601,0,0,0,0,0,0,601,1207
57,Rieti,9,689,0,0,0,0,0,0,689,585,0,0,0,0,0,0,585,1274
57,Rieti,10,656,0,0,0,0,0,0,656,632,0,0,0,0,0,0,632,1288
57,Rieti,11,633,0,0,0,0,0,0,633,615,0,0,0,0,0,0,615,1248
57,Rieti,12,720,0,0,0,0,0,0,720,618,0,0,0,0,0,0,618,1338
57,Rieti,13,650,0,0,0,0,0,0,650,580,0,0,0,0,0,0,580,1230
57,Rieti,14,662,0,0,0,0,0,0,662,618,0,0,0,0,0,0,618,1280
57,Rieti,15,695,0,0,0,0,0,0,695,595,0,0,0,0,0,0,595,1290
57,Rieti,16,653,0,0,0,0,0,0,653,653,0,0,0,0,0,0,653,1306
57,Rieti,17,638,0,0,0,0,0,0,638,630,0,0,0,0,0,0,630,1268
57,Rieti,18,669,1,0,0,0,0,0,670,684,0,0,0,0,0,0,684,1354
57,Rieti,19,697,0,0,0,0,0,0,697,714,4,0,0,0,0,0,718,1415
57,Rieti,20,797,1,0,0,0,0,0,798,660,7,0,0,0,0,0,667,1465
57,Rieti,21,814,2,0,0,0,0,0,816,661,8,0,0,0,0,0,669,1485
57,Rieti,22,855,7,1,0,0,0,0,863,677,19,0,0,0,0,0,696,1559
57,Rieti,23,860,6,0,0,2,0,0,868,686,25,0,0,0,0,0,711,1579
57,Rieti,24,890,12,0,0,0,0,0,902,729,31,0,0,0,0,0,760,1662
57,Rieti,25,818,20,0,1,0,0,0,839,665,55,0,0,0,0,0,720,1559
57,Rieti,26,859,33,1,0,1,0,0,894,706,91,4,2,0,0,0,803,1697
57,Rieti,27,889,47,0,0,0,0,0,936,656,102,1,0,0,0,0,759,1695
57,Rieti,28,795,62,0,0,0,0,0,857,654,139,4,0,0,0,0,797,1654
57,Rieti,29,780,101,1,0,0,0,0,882,622,190,5,0,0,0,0,817,1699
57,Rieti,30,746,121,0,0,0,0,0,867,589,211,5,1,0,0,0,806,1673
57,Rieti,31,722,175,0,0,0,0,0,897,525,269,9,0,1,0,0,804,1701
57,Rieti,32,651,171,2,0,0,0,0,824,553,307,13,3,0,0,0,876,1700
57,Rieti,33,643,240,3,0,0,0,0,886,449,364,13,3,0,0,0,829,1715
57,Rieti,34,588,296,5,0,0,0,0,889,420,405,9,1,0,0,0,835,1724
57,Rieti,35,564,323,11,0,0,0,0,898,412,373,14,1,0,0,0,800,1698
57,Rieti,36,546,368,7,0,2,0,0,923,362,449,23,3,1,0,0,838,1761
57,Rieti,37,524,354,9,0,0,0,0,887,391,520,25,3,1,0,0,940,1827
57,Rieti,38,515,391,13,1,0,0,0,920,379,509,20,2,0,0,0,910,1830
57,Rieti,39,501,483,9,0,0,0,0,993,329,557,33,7,0,0,0,926,1919
57,Rieti,40,520,527,18,5,0,0,0,1070,338,669,34,8,1,0,0,1050,2120
57,Rieti,41,470,566,19,0,0,0,0,1055,327,664,38,11,0,0,0,1040,2095
57,Rieti,42,414,613,24,1,0,0,0,1052,329,695,52,7,0,0,0,1083,2135
57,Rieti,43,429,655,39,3,2,0,0,1128,309,750,62,12,0,0,0,1133,2261
57,Rieti,44,429,743,22,0,0,0,0,1194,275,827,62,14,1,0,0,1179,2373
57,Rieti,45,407,724,38,5,0,0,0,1174,292,803,64,14,1,0,0,1174,2348
57,Rieti,46,364,752,38,5,0,0,0,1159,257,824,70,22,0,0,0,1173,2332
57,Rieti,47,337,720,40,5,0,0,0,1102,229,870,68,17,0,0,0,1184,2286
57,Rieti,48,315,786,50,5,0,0,0,1156,205,950,72,23,1,0,0,1251,2407
57,Rieti,49,351,872,73,4,0,0,0,1300,184,918,76,29,0,0,0,1207,2507
57,Rieti,50,294,828,65,3,0,0,0,1190,213,957,84,30,0,0,0,1284,2474
57,Rieti,51,288,862,56,0,0,0,0,1206,197,945,76,35,0,0,0,1253,2459
57,Rieti,52,268,891,72,11,2,0,0,1244,165,977,72,46,0,0,0,1260,2504
57,Rieti,53,243,995,58,8,2,0,0,1306,178,1016,73,43,0,0,0,1310,2616
57,Rieti,54,222,959,57,19,0,0,0,1257,167,984,93,58,0,0,0,1302,2559
57,Rieti,55,215,962,69,21,0,0,0,1267,129,972,77,73,0,0,0,1251,2518
57,Rieti,56,186,924,95,11,1,0,0,1217,156,928,82,73,1,0,0,1240,2457
57,Rieti,57,159,943,78,20,0,0,0,1200,158,921,73,74,0,0,0,1226,2426
57,Rieti,58,161,947,54,13,1,0,0,1176,116,900,63,90,0,0,0,1169,2345
57,Rieti,59,136,867,50,15,0,0,0,1068,115,887,65,97,0,0,0,1164,2232
57,Rieti,60,137,860,43,13,0,0,0,1053,107,861,64,94,0,0,0,1126,2179
57,Rieti,61,116,814,48,25,1,0,0,1004,83,820,44,120,0,0,0,1067,2071
57,Rieti,62,123,861,46,23,1,0,0,1054,93,810,55,109,0,0,0,1067,2121
57,Rieti,63,122,840,56,22,0,0,0,1040,89,774,49,118,0,0,0,1030,2070
57,Rieti,64,92,869,38,24,1,0,0,1024,71,785,51,129,0,0,0,1036,2060
57,Rieti,65,93,816,48,31,0,0,0,988,78,794,38,143,1,0,0,1054,2042
57,Rieti,66,96,812,53,39,0,0,0,1000,65,754,33,135,0,0,0,987,1987
57,Rieti,67,74,825,46,28,0,0,0,973,66,767,45,153,1,0,0,1032,2005
57,Rieti,68,87,888,47,56,0,0,0,1078,68,725,39,191,0,0,0,1023,2101
57,Rieti,69,69,863,39,50,0,0,0,1021,63,720,41,179,1,0,0,1004,2025
57,Rieti,70,75,895,37,58,0,0,0,1065,68,780,28,256,0,0,0,1132,2197
57,Rieti,71,66,821,40,54,0,0,0,981,63,648,23,240,0,0,0,974,1955
57,Rieti,72,71,774,23,47,0,0,0,915,48,611,21,264,0,0,0,944,1859
57,Rieti,73,51,610,25,47,0,0,0,733,43,509,23,225,0,0,0,800,1533
57,Rieti,74,48,622,26,56,0,0,0,752,58,446,20,238,1,0,0,763,1515
57,Rieti,75,51,610,18,68,0,0,0,747,45,472,25,264,0,0,0,806,1553
57,Rieti,76,54,526,14,58,1,0,0,653,28,411,13,293,0,0,0,745,1398
57,Rieti,77,55,524,22,55,0,0,0,656,39,404,14,330,0,0,0,787,1443
57,Rieti,78,37,565,18,90,0,0,0,710,42,490,14,378,0,0,0,924,1634
57,Rieti,79,50,537,13,70,0,0,0,670,47,390,9,388,0,0,0,834,1504
57,Rieti,80,40,526,15,99,0,0,0,680,36,364,14,404,0,0,0,818,1498
57,Rieti,81,28,475,11,88,0,0,0,602,31,266,11,434,0,0,0,742,1344
57,Rieti,82,29,418,5,65,0,0,0,517,26,233,7,349,0,0,0,615,1132
57,Rieti,83,41,393,5,92,0,0,0,531,37,254,4,423,0,0,0,718,1249
57,Rieti,84,30,301,5,99,0,0,0,435,29,199,6,396,0,0,0,630,1065
57,Rieti,85,22,317,3,82,0,0,0,424,29,157,3,404,0,0,0,593,1017
57,Rieti,86,26,237,3,74,0,0,0,340,28,113,6,327,0,0,0,474,814
57,Rieti,87,17,221,2,77,0,0,0,317,26,119,3,415,0,0,0,563,880
57,Rieti,88,14,197,0,94,0,0,0,305,25,77,4,374,0,0,0,480,785
57,Rieti,89,9,151,0,93,0,0,0,253,24,74,0,318,0,0,0,416,669
57,Rieti,90,13,93,1,69,0,0,0,176,24,46,0,287,0,0,0,357,533
57,Rieti,91,8,87,1,56,0,0,0,152,22,49,1,285,0,0,0,357,509
57,Rieti,92,7,61,2,46,0,0,0,116,11,23,1,248,0,0,0,283,399
57,Rieti,93,3,45,0,39,0,0,0,87,11,20,1,200,0,0,0,232,319
57,Rieti,94,2,28,1,40,0,0,0,71,13,10,1,147,0,0,0,171,242
57,Rieti,95,0,21,0,22,0,0,0,43,5,10,0,117,0,0,0,132,175
57,Rieti,96,3,18,0,16,0,0,0,37,3,6,1,101,0,0,0,111,148
57,Rieti,97,2,9,0,10,0,0,0,21,3,1,0,66,0,0,0,70,91
57,Rieti,98,0,6,0,11,0,0,0,17,1,1,2,38,0,0,0,42,59
57,Rieti,99,0,4,0,3,0,0,0,7,3,2,0,17,0,0,0,22,29
57,Rieti,100,0,5,0,5,0,0,0,10,1,1,0,31,0,0,0,33,43
58,Roma,0,16035,0,0,0,0,0,0,16035,15187,0,0,0,0,0,0,15187,31222
58,Roma,1,16494,0,0,0,0,0,0,16494,16263,0,0,0,0,0,0,16263,32757
58,Roma,2,18223,0,0,0,0,0,0,18223,17238,0,0,0,0,0,0,17238,35461
58,Roma,3,18804,0,0,0,0,0,0,18804,17912,0,0,0,0,0,0,17912,36716
58,Roma,4,19737,0,0,0,0,0,0,19737,18336,0,0,0,0,0,0,18336,38073
58,Roma,5,19907,0,0,0,0,0,0,19907,18796,0,0,0,0,0,0,18796,38703
58,Roma,6,21087,0,0,0,0,0,0,21087,20023,0,0,0,0,0,0,20023,41110
58,Roma,7,21261,0,0,0,0,0,0,21261,20090,0,0,0,0,0,0,20090,41351
58,Roma,8,21587,0,0,0,0,0,0,21587,20437,0,0,0,0,0,0,20437,42024
58,Roma,9,21850,0,0,0,0,0,0,21850,20325,0,0,0,0,0,0,20325,42175
58,Roma,10,21739,0,0,0,0,0,0,21739,20817,0,0,0,0,0,0,20817,42556
58,Roma,11,22193,0,0,0,0,0,0,22193,20727,0,0,0,0,0,0,20727,42920
58,Roma,12,21832,0,0,0,0,0,0,21832,20515,0,0,0,0,0,0,20515,42347
58,Roma,13,21204,0,0,0,0,0,0,21204,19748,0,0,0,0,0,0,19748,40952
58,Roma,14,21136,0,0,0,0,0,0,21136,19917,0,0,0,0,0,0,19917,41053
58,Roma,15,20719,0,0,0,0,0,0,20719,19736,0,0,0,0,0,0,19736,40455
58,Roma,16,20460,0,0,0,0,0,0,20460,19068,0,0,0,0,0,0,19068,39528
58,Roma,17,20466,0,0,0,0,0,0,20466,19271,1,0,0,0,0,0,19272,39738
58,Roma,18,20740,2,0,0,0,0,0,20742,19246,9,1,0,0,0,0,19256,39998
58,Roma,19,20406,4,0,0,0,0,0,20410,18709,39,0,0,0,0,0,18748,39158
58,Roma,20,21062,17,0,0,1,0,0,21080,19070,110,1,0,0,0,0,19181,40261
58,Roma,21,20746,31,0,0,2,0,0,20779,18750,240,0,0,1,0,0,18991,39770
58,Roma,22,21113,70,0,0,0,0,0,21183,18656,413,4,2,2,0,0,19077,40260
58,Roma,23,21351,151,1,1,4,0,0,21508,18571,599,7,0,5,0,0,19182,40690
58,Roma,24,21046,236,0,0,5,1,1,21289,18613,1032,9,2,3,0,0,19659,40948
58,Roma,25,21060,407,5,1,5,1,0,21479,18837,1528,28,0,6,0,0,20399,41878
58,Roma,26,21716,698,8,0,3,0,0,22425,18906,2234,20,4,5,0,0,21169,43594
58,Roma,27,20954,1177,20,1,6,1,0,22159,18323,2954,35,2,8,0,0,21322,43481
58,Roma,28,21245,1682,20,0,12,0,0,22959,17974,4077,51,9,4,0,0,22115,45074
58,Roma,29,20233,2595,32,1,9,0,0,22870,17010,5201,89,14,10,0,0,22324,45194
58,Roma,30,20188,3588,40,1,13,0,0,23830,16411,6819,138,16,11,0,0,23395,47225
58,Roma,31,18793,4517,59,2,17,1,0,23389,15489,8089,166,23,13,0,0,23780,47169
58,Roma,32,17815,5859,85,3,23,0,0,23785,14300,9319,259,28,8,1,0,23915,47700
58,Roma,33,17614,7199,124,4,30,0,0,24971,14126,10922,305,38,18,0,0,25409,50380
58,Roma,34,16930,8822,145,6,19,0,1,25923,13615,12174,407,45,21,0,0,26262,52185
58,Roma,35,16468,10095,197,11,30,0,0,26801,12955,13289,454,49,16,0,1,26764,53565
58,Roma,36,15706,11565,268,14,40,0,0,27593,12836,14709,527,51,27,0,0,28150,55743
58,Roma,37,14912,12484,284,13,31,0,0,27724,12144,15704,684,83,20,0,0,28635,56359
58,Roma,38,14345,13883,383,14,41,0,0,28666,11892,16774,798,96,12,0,0,29572,58238
58,Roma,39,13937,14825,482,28,41,1,0,29314,11613,17724,960,128,24,1,0,30450,59764
58,Roma,40,14175,16085,548,33,28,0,0,30869,11538,19181,1153,157,14,0,0,32043,62912
58,Roma,41,13983,16868,668,41,46,0,0,31606,11220,20057,1326,192,24,0,0,32819,64425
58,Roma,42,13371,18198,793,45,47,0,0,32454,11482,21246,1462,221,27,0,0,34438,66892
58,Roma,43,13525,19528,951,63,52,0,0,34119,11421,22836,1759,277,27,0,0,36320,70439
58,Roma,44,13763,20764,1063,69,55,0,0,35714,11440,24385,2024,319,37,0,1,38206,73920
58,Roma,45,12682,21694,1252,85,52,0,0,35765,10733,24660,2165,381,30,0,0,37969,73734
58,Roma,46,12234,22570,1343,96,56,0,0,36299,10134,25726,2343,426,23,0,0,38652,74951
58,Roma,47,11214,23095,1474,95,46,0,1,35925,9489,25852,2705,534,24,0,0,38604,74529
58,Roma,48,10665,23695,1575,124,59,1,1,36120,8843,26273,2830,609,25,0,0,38580,74700
58,Roma,49,9911,24439,1794,165,38,0,0,36347,8636,26710,3079,717,23,0,0,39165,75512
58,Roma,50,9250,24405,1933,188,56,0,1,35833,8038,26702,3277,809,21,0,0,38847,74680
58,Roma,51,8469,24617,2016,216,68,0,0,35386,7679,26881,3426,904,14,0,0,38904,74290
58,Roma,52,8212,25219,2186,256,62,0,0,35935,7148,26813,3388,1045,16,0,0,38410,74345
58,Roma,53,7486,25638,2233,269,55,0,1,35682,6775,26916,3506,1120,19,0,0,38336,74018
58,Roma,54,7108,26399,2328,314,53,0,1,36203,6286,27703,3692,1352,25,0,0,39058,75261
58,Roma,55,5944,24932,2274,385,61,0,1,33597,5615,26183,3500,1485,27,0,1,36811,70408
58,Roma,56,5232,24188,2191,349,44,0,0,32004,5260,24807,3356,1517,25,0,0,34965,66969
58,Roma,57,4876,23587,2094,411,35,0,2,31005,4735,24192,3153,1765,20,0,0,33865,64870
58,Roma,58,4301,22454,1901,421,47,0,0,29124,4380,22925,3155,1909,20,0,2,32391,61515
58,Roma,59,3919,21769,1884,459,44,0,1,28076,4114,22393,2974,2038,13,0,1,31533,59609
58,Roma,60,3428,20902,1783,486,52,0,1,26652,3794,21391,2869,2204,13,0,0,30271,56923
58,Roma,61,3212,20603,1771,464,37,0,1,26088,3506,21026,2608,2375,15,0,0,29530,55618
58,Roma,62,2950,20217,1644,602,24,1,0,25438,3038,20327,2572,2635,14,0,1,28587,54025
58,Roma,63,2576,19811,1544,562,15,0,0,24508,3068,19657,2342,2759,6,0,0,27832,52340
58,Roma,64,2208,19188,1433,684,24,0,0,23537,2925,19029,2320,3104,3,0,0,27381,50918
58,Roma,65,2105,18039,1257,736,16,0,0,22153,2605,17915,2075,3181,10,0,0,25786,47939
58,Roma,66,1810,17639,1216,770,14,0,1,21450,2346,17131,2039,3482,6,0,0,25004,46454
58,Roma,67,1803,17123,1076,789,16,0,1,20808,2263,16506,1946,3798,10,0,0,24523,45331
58,Roma,68,1700,17631,1030,873,21,0,0,21255,2214,16821,1868,4204,4,0,0,25111,46366
58,Roma,69,1461,17339,1004,1022,12,0,0,20838,2101,16289,1741,4573,2,0,0,24706,45544
58,Roma,70,1530,17968,962,1160,17,0,0,21637,2195,17121,1693,5214,4,0,1,26228,47865
58,Roma,71,1356,17901,951,1352,18,0,0,21578,2067,16497,1622,5859,6,0,0,26051,47629
58,Roma,72,1305,17406,849,1369,16,0,0,20945,2026,15904,1617,6337,3,0,0,25887,46832
58,Roma,73,1041,13604,656,1172,4,0,0,16477,1690,12269,1246,5699,5,0,0,20909,37386
58,Roma,74,962,13463,627,1290,16,0,0,16358,1668,11553,1163,6110,3,0,1,20498,36856
58,Roma,75,964,13691,585,1426,12,0,0,16678,1758,11876,1150,7004,2,0,0,21790,38468
58,Roma,76,909,13079,540,1573,12,0,1,16114,1657,10949,1070,7317,4,0,0,20997,37111
58,Roma,77,862,12928,473,1688,10,0,0,15961,1662,10349,964,7919,7,0,1,20902,36863
58,Roma,78,848,13444,453,1980,14,0,0,16739,1873,10558,992,9513,0,0,0,22936,39675
58,Roma,79,778,12689,381,1991,4,0,0,15843,1657,9351,808,9777,2,0,0,21595,37438
58,Roma,80,686,11608,365,2041,6,0,0,14706,1579,8158,761,9917,3,0,0,20418,35124
58,Roma,81,602,10054,309,2043,3,0,0,13011,1488,6770,589,9720,0,0,0,18567,31578
58,Roma,82,515,8785,241,1976,4,0,0,11521,1387,5667,575,9482,0,0,0,17111,28632
58,Roma,83,462,8291,226,2081,5,0,0,11065,1333,4858,466,9934,0,0,0,16591,27656
58,Roma,84,438,7159,183,1958,3,0,0,9741,1303,4117,393,9679,0,0,1,15493,25234
58,Roma,85,350,6101,152,1891,2,0,0,8496,1146,3201,354,9233,0,0,0,13934,22430
58,Roma,86,283,5105,107,1774,1,0,0,7270,1106,2575,265,8700,1,0,0,12647,19917
58,Roma,87,276,4482,95,1721,1,0,1,6576,967,2041,262,8301,0,0,0,11571,18147
58,Roma,88,229,3776,64,1723,2,0,0,5794,1001,1695,223,8209,0,0,0,11128,16922
58,Roma,89,204,2802,57,1426,1,0,0,4490,752,1029,201,6857,0,0,0,8839,13329
58,Roma,90,153,2171,32,1159,0,0,0,3515,713,802,130,6002,0,0,0,7647,11162
58,Roma,91,126,1568,25,1068,2,0,0,2789,579,613,105,5248,0,0,0,6545,9334
58,Roma,92,102,1145,25,897,0,0,0,2169,532,403,100,4438,0,0,0,5473,7642
58,Roma,93,68,801,18,694,0,0,0,1581,412,271,79,3553,1,0,0,4316,5897
58,Roma,94,48,549,10,618,0,0,0,1225,341,164,66,2840,0,0,0,3411,4636
58,Roma,95,44,390,5,448,0,0,0,887,260,140,35,2257,0,0,0,2692,3579
58,Roma,96,31,211,3,362,0,0,0,607,199,82,30,1618,0,0,0,1929,2536
58,Roma,97,29,169,5,214,0,0,0,417,142,57,28,1316,0,0,0,1543,1960
58,Roma,98,30,99,2,174,0,0,0,305,102,34,19,906,0,0,0,1061,1366
58,Roma,99,10,43,1,73,0,0,0,127,59,12,8,410,0,0,0,489,616
58,Roma,100,31,54,1,128,0,0,0,214,117,41,21,787,0,0,0,966,1180
59,Latina,0,2346,0,0,0,0,0,0,2346,2189,0,0,0,0,0,0,2189,4535
59,Latina,1,2489,0,0,0,0,0,0,2489,2260,0,0,0,0,0,0,2260,4749
59,Latina,2,2539,0,0,0,0,0,0,2539,2312,0,0,0,0,0,0,2312,4851
59,Latina,3,2450,0,0,0,0,0,0,2450,2397,0,0,0,0,0,0,2397,4847
59,Latina,4,2620,0,0,0,0,0,0,2620,2477,0,0,0,0,0,0,2477,5097
59,Latina,5,2709,0,0,0,0,0,0,2709,2596,0,0,0,0,0,0,2596,5305
59,Latina,6,2788,0,0,0,0,0,0,2788,2634,0,0,0,0,0,0,2634,5422
59,Latina,7,2732,0,0,0,0,0,0,2732,2706,0,0,0,0,0,0,2706,5438
59,Latina,8,2855,0,0,0,0,0,0,2855,2695,0,0,0,0,0,0,2695,5550
59,Latina,9,2795,0,0,0,0,0,0,2795,2704,0,0,0,0,0,0,2704,5499
59,Latina,10,2763,0,0,0,0,0,0,2763,2669,0,0,0,0,0,0,2669,5432
59,Latina,11,2788,0,0,0,0,0,0,2788,2608,0,0,0,0,0,0,2608,5396
59,Latina,12,2774,0,0,0,0,0,0,2774,2673,0,0,0,0,0,0,2673,5447
59,Latina,13,2655,0,0,0,0,0,0,2655,2611,0,0,0,0,0,0,2611,5266
59,Latina,14,2713,0,0,0,0,0,0,2713,2541,0,0,0,0,0,0,2541,5254
59,Latina,15,2745,0,0,0,0,0,0,2745,2635,0,0,0,0,0,0,2635,5380
59,Latina,16,2737,0,0,0,0,0,0,2737,2576,0,0,0,0,0,0,2576,5313
59,Latina,17,2799,0,0,0,0,0,0,2799,2603,0,0,0,0,0,0,2603,5402
59,Latina,18,3005,0,0,0,0,0,0,3005,2640,3,0,0,0,0,0,2643,5648
59,Latina,19,3029,1,0,0,0,0,0,3030,2691,10,0,0,0,0,0,2701,5731
59,Latina,20,3104,3,0,0,0,0,0,3107,2579,17,0,0,0,0,0,2596,5703
59,Latina,21,3105,4,0,0,0,0,0,3109,2694,47,0,0,0,0,0,2741,5850
59,Latina,22,3167,15,0,0,0,0,0,3182,2767,81,2,0,0,0,0,2850,6032
59,Latina,23,3179,26,0,0,0,0,0,3205,2724,129,1,1,0,0,0,2855,6060
59,Latina,24,3241,44,0,0,0,0,0,3285,2657,200,1,0,0,0,0,2858,6143
59,Latina,25,3202,81,1,0,0,0,0,3284,2755,271,1,3,0,0,0,3030,6314
59,Latina,26,3284,136,1,0,1,0,0,3422,2764,475,2,0,0,0,0,3241,6663
59,Latina,27,3061,267,2,0,0,0,0,3330,2607,570,5,1,0,0,0,3183,6513
59,Latina,28,3221,337,13,1,0,0,0,3572,2439,802,14,3,0,0,0,3258,6830
59,Latina,29,2980,486,7,1,1,0,0,3475,2216,989,13,0,1,0,0,3219,6694
59,Latina,30,2915,645,7,0,1,0,0,3568,2091,1287,25,3,2,0,0,3408,6976
59,Latina,31,2730,806,10,0,1,0,0,3547,1941,1468,19,4,0,0,0,3432,6979
59,Latina,32,2629,1073,13,0,1,0,0,3716,1672,1481,38,4,0,0,0,3195,6911
59,Latina,33,2431,1177,25,1,1,0,0,3635,1618,1727,50,4,0,1,0,3400,7035
59,Latina,34,2318,1418,24,1,1,0,0,3762,1503,1838,55,6,2,0,0,3404,7166
59,Latina,35,2162,1527,28,2,1,0,0,3720,1365,1978,65,6,0,0,0,3414,7134
59,Latina,36,2074,1766,40,1,0,0,0,3881,1309,2250,82,14,1,0,0,3656,7537
59,Latina,37,1970,1876,47,1,2,0,0,3896,1275,2325,80,11,1,0,0,3692,7588
59,Latina,38,1772,2119,57,3,0,0,0,3951,1088,2456,108,16,0,0,0,3668,7619
59,Latina,39,1713,2206,69,7,0,0,0,3995,1064,2611,137,28,1,0,0,3841,7836
59,Latina,40,1713,2337,87,6,1,0,0,4144,1080,2779,138,26,0,0,0,4023,8167
59,Latina,41,1692,2553,82,2,1,0,0,4330,1004,2914,172,23,0,0,0,4113,8443
59,Latina,42,1565,2835,107,8,1,0,0,4516,997,3083,178,30,0,0,0,4288,8804
59,Latina,43,1573,2975,115,11,1,0,0,4675,982,3364,193,49,1,0,0,4589,9264
59,Latina,44,1352,3112,134,12,1,0,0,4611,978,3427,178,42,0,0,0,4625,9236
59,Latina,45,1366,3158,179,11,0,0,0,4714,876,3524,225,58,0,0,0,4683,9397
59,Latina,46,1278,3155,172,15,2,0,0,4622,832,3568,241,73,1,0,0,4715,9337
59,Latina,47,1213,3219,188,18,3,0,0,4641,777,3573,299,84,0,0,1,4734,9375
59,Latina,48,1057,3375,190,17,2,0,0,4641,662,3588,268,90,0,0,0,4608,9249
59,Latina,49,990,3355,206,21,0,0,0,4572,601,3736,280,115,1,0,0,4733,9305
59,Latina,50,878,3436,189,35,2,0,0,4540,579,3749,311,119,1,0,0,4759,9299
59,Latina,51,835,3563,210,32,2,0,0,4642,574,3680,296,134,2,0,0,4686,9328
59,Latina,52,712,3669,216,28,0,0,0,4625,555,3755,288,182,1,0,0,4781,9406
59,Latina,53,700,3666,228,38,2,0,1,4635,534,3675,304,147,0,0,0,4660,9295
59,Latina,54,638,3591,230,39,4,0,1,4503,481,3770,297,209,1,0,0,4758,9261
59,Latina,55,544,3415,242,39,1,0,0,4241,438,3494,265,209,2,0,0,4408,8649
59,Latina,56,469,3300,206,38,0,0,0,4013,380,3402,233,221,2,0,0,4238,8251
59,Latina,57,431,3242,186,52,2,0,0,3913,363,3413,247,251,0,0,1,4275,8188
59,Latina,58,385,3132,194,62,3,0,0,3776,338,3204,222,296,1,0,0,4061,7837
59,Latina,59,345,3114,172,67,0,0,0,3698,307,3081,230,297,2,0,0,3917,7615
59,Latina,60,310,2929,164,72,0,0,0,3475,297,2886,192,308,1,0,0,3684,7159
59,Latina,61,306,2890,163,76,2,0,0,3437,230,2904,159,380,0,0,0,3673,7110
59,Latina,62,262,2864,128,86,1,0,0,3341,250,2811,150,374,0,0,0,3585,6926
59,Latina,63,214,2854,154,89,1,0,0,3312,244,2836,153,395,0,0,1,3629,6941
59,Latina,64,219,2960,141,92,1,0,0,3413,217,2797,149,498,0,0,0,3661,7074
59,Latina,65,208,2737,96,107,1,0,0,3149,193,2509,119,465,0,0,0,3286,6435
59,Latina,66,183,2656,103,117,0,0,0,3059,184,2450,122,524,0,0,0,3280,6339
59,Latina,67,181,2722,101,119,0,0,0,3123,179,2556,109,584,0,0,0,3428,6551
59,Latina,68,140,2749,118,135,0,0,0,3142,180,2583,142,678,0,0,0,3583,6725
59,Latina,69,173,2806,131,137,1,0,0,3248,199,2539,138,718,0,0,0,3594,6842
59,Latina,70,172,3034,102,172,0,0,0,3480,194,2599,115,884,0,0,0,3792,7272
59,Latina,71,167,3002,82,201,0,0,0,3452,168,2315,122,945,0,0,0,3550,7002
59,Latina,72,133,2695,73,206,0,0,0,3107,170,2243,96,988,0,0,0,3497,6604
59,Latina,73,88,1865,51,147,0,0,0,2151,101,1482,67,702,0,0,0,2352,4503
59,Latina,74,83,1768,46,182,0,0,0,2079,115,1405,60,810,0,0,0,2390,4469
59,Latina,75,76,1872,44,181,1,0,0,2174,103,1463,36,969,0,0,0,2571,4745
59,Latina,76,78,1819,40,201,1,0,0,2139,110,1344,47,1008,0,0,0,2509,4648
59,Latina,77,82,1802,33,203,0,0,0,2120,126,1239,40,1043,0,0,0,2448,4568
59,Latina,78,92,1858,49,284,1,0,0,2284,113,1263,56,1232,0,0,0,2664,4948
59,Latina,79,87,1783,35,256,0,0,0,2161,117,1113,49,1223,0,0,0,2502,4663
59,Latina,80,56,1561,17,235,0,0,0,1869,87,994,27,1344,0,1,0,2453,4322
59,Latina,81,55,1389,15,250,0,0,0,1709,113,837,29,1269,0,0,0,2248,3957
59,Latina,82,47,1202,25,254,0,0,0,1528,102,673,23,1181,0,0,0,1979,3507
59,Latina,83,57,1162,11,238,1,0,0,1469,77,605,24,1253,0,0,0,1959,3428
59,Latina,84,45,929,12,275,0,0,0,1261,93,474,28,1176,0,0,0,1771,3032
59,Latina,85,37,771,10,218,0,0,0,1036,77,375,21,1132,0,0,0,1605,2641
59,Latina,86,26,700,0,201,0,0,0,927,60,309,11,1057,0,0,0,1437,2364
59,Latina,87,30,579,7,223,0,0,0,839,69,235,12,1031,0,0,0,1347,2186
59,Latina,88,26,485,6,219,0,0,0,736,83,176,16,1042,0,0,0,1317,2053
59,Latina,89,20,345,3,213,0,0,0,581,64,137,10,821,0,0,0,1032,1613
59,Latina,90,12,285,3,153,0,0,0,453,43,84,4,749,0,0,0,880,1333
59,Latina,91,10,191,2,132,0,0,0,335,41,55,2,630,0,0,0,728,1063
59,Latina,92,6,152,1,117,0,0,0,276,36,58,2,533,0,0,0,629,905
59,Latina,93,6,101,1,79,0,0,0,187,23,37,1,401,0,0,0,462,649
59,Latina,94,2,66,1,72,0,0,0,141,31,25,3,356,0,0,0,415,556
59,Latina,95,4,48,2,44,0,0,0,98,20,20,0,264,0,0,0,304,402
59,Latina,96,3,31,0,45,0,0,0,79,9,10,2,199,0,0,0,220,299
59,Latina,97,1,20,0,34,0,0,0,55,12,9,3,134,0,0,0,158,213
59,Latina,98,2,11,1,20,0,0,0,34,4,7,0,112,0,0,0,123,157
59,Latina,99,1,8,0,11,0,0,0,20,2,1,0,62,0,0,0,65,85
59,Latina,100,0,8,1,12,0,0,0,21,5,5,0,83,0,0,0,93,114
60,Frosinone,0,1738,0,0,0,0,0,0,1738,1618,0,0,0,0,0,0,1618,3356
60,Frosinone,1,1861,0,0,0,0,0,0,1861,1810,0,0,0,0,0,0,1810,3671
60,Frosinone,2,2042,0,0,0,0,0,0,2042,1890,0,0,0,0,0,0,1890,3932
60,Frosinone,3,1937,0,0,0,0,0,0,1937,1939,0,0,0,0,0,0,1939,3876
60,Frosinone,4,1971,0,0,0,0,0,0,1971,1893,0,0,0,0,0,0,1893,3864
60,Frosinone,5,2058,0,0,0,0,0,0,2058,1961,0,0,0,0,0,0,1961,4019
60,Frosinone,6,2086,0,0,0,0,0,0,2086,2101,0,0,0,0,0,0,2101,4187
60,Frosinone,7,2118,0,0,0,0,0,0,2118,2020,0,0,0,0,0,0,2020,4138
60,Frosinone,8,2282,0,0,0,0,0,0,2282,2110,0,0,0,0,0,0,2110,4392
60,Frosinone,9,2214,0,0,0,0,0,0,2214,2035,0,0,0,0,0,0,2035,4249
60,Frosinone,10,2199,0,0,0,0,0,0,2199,2144,0,0,0,0,0,0,2144,4343
60,Frosinone,11,2276,0,0,0,0,0,0,2276,2077,0,0,0,0,0,0,2077,4353
60,Frosinone,12,2131,0,0,0,0,0,0,2131,2062,0,0,0,0,0,0,2062,4193
60,Frosinone,13,2154,0,0,0,0,0,0,2154,2076,0,0,0,0,0,0,2076,4230
60,Frosinone,14,2265,0,0,0,0,0,0,2265,2086,0,0,0,0,0,0,2086,4351
60,Frosinone,15,2191,0,0,0,0,0,0,2191,2115,0,0,0,0,0,0,2115,4306
60,Frosinone,16,2199,0,0,0,0,0,0,2199,2080,0,0,0,0,0,0,2080,4279
60,Frosinone,17,2246,0,0,0,0,0,0,2246,1994,2,0,0,0,0,0,1996,4242
60,Frosinone,18,2410,0,0,0,0,0,0,2410,2134,6,0,0,0,0,0,2140,4550
60,Frosinone,19,2497,3,0,0,0,0,0,2500,2122,13,0,0,0,0,0,2135,4635
60,Frosinone,20,2544,2,0,0,0,0,0,2546,2182,28,0,0,0,0,0,2210,4756
60,Frosinone,21,2657,9,0,0,0,0,0,2666,2175,54,2,0,0,0,0,2231,4897
60,Frosinone,22,2595,10,0,0,0,0,0,2605,2243,73,0,0,2,0,0,2318,4923
60,Frosinone,23,2644,25,2,0,1,0,0,2672,2216,112,3,0,0,0,0,2331,5003
60,Frosinone,24,2710,41,0,0,0,0,0,2751,2294,156,2,0,0,0,0,2452,5203
60,Frosinone,25,2643,76,0,0,0,0,0,2719,2250,269,1,1,0,0,0,2521,5240
60,Frosinone,26,2841,136,0,1,0,0,0,2978,2377,355,3,0,0,0,0,2735,5713
60,Frosinone,27,2743,193,2,0,0,0,0,2938,2244,504,5,0,0,0,0,2753,5691
60,Frosinone,28,2704,275,1,0,0,0,0,2980,2087,633,10,1,0,0,0,2731,5711
60,Frosinone,29,2682,413,1,0,0,0,0,3096,1973,820,9,0,0,0,0,2802,5898
60,Frosinone,30,2472,522,4,1,1,0,0,3000,1809,1003,20,1,0,0,0,2833,5833
60,Frosinone,31,2320,677,3,1,0,0,0,3001,1686,1049,31,2,0,0,0,2768,5769
60,Frosinone,32,2119,792,10,0,0,0,0,2921,1538,1266,30,3,0,0,0,2837,5758
60,Frosinone,33,2084,945,16,0,1,0,0,3046,1384,1419,33,5,1,0,0,2842,5888
60,Frosinone,34,1954,1114,18,4,0,0,0,3090,1322,1602,35,3,0,0,0,2962,6052
60,Frosinone,35,1859,1319,27,0,2,0,0,3207,1195,1773,45,10,0,0,0,3023,6230
60,Frosinone,36,1800,1425,38,3,1,0,0,3267,1072,1855,51,14,1,0,0,2993,6260
60,Frosinone,37,1558,1560,28,2,0,0,0,3148,1104,1987,57,15,0,0,0,3163,6311
60,Frosinone,38,1490,1668,37,2,0,0,0,3197,925,2137,80,12,1,0,0,3155,6352
60,Frosinone,39,1405,1768,59,2,0,0,0,3234,942,2210,92,24,0,0,0,3268,6502
60,Frosinone,40,1360,1965,62,5,0,0,0,3392,905,2303,136,33,1,0,0,3378,6770
60,Frosinone,41,1326,1994,57,5,0,0,0,3382,872,2382,108,33,0,0,0,3395,6777
60,Frosinone,42,1224,2223,77,5,0,0,0,3529,800,2610,120,33,0,0,0,3563,7092
60,Frosinone,43,1201,2369,101,8,1,0,0,3680,729,2646,146,30,0,0,0,3551,7231
60,Frosinone,44,1200,2460,91,11,0,0,0,3762,710,2828,147,44,0,0,0,3729,7491
60,Frosinone,45,1033,2436,108,15,0,0,0,3592,694,2758,141,46,0,0,0,3639,7231
60,Frosinone,46,955,2401,107,8,0,0,0,3471,584,2939,166,53,1,0,0,3743,7214
60,Frosinone,47,915,2643,131,12,1,0,0,3702,591,2917,182,57,1,0,0,3748,7450
60,Frosinone,48,808,2686,102,20,1,0,0,3617,523,2904,183,69,0,0,0,3679,7296
60,Frosinone,49,813,2771,123,17,0,0,0,3724,511,3123,183,87,0,0,0,3904,7628
60,Frosinone,50,711,2775,114,16,0,0,0,3616,446,3019,166,115,0,0,0,3746,7362
60,Frosinone,51,656,2880,150,32,1,0,0,3719,427,3186,205,102,0,0,0,3920,7639
60,Frosinone,52,578,2908,142,29,0,0,0,3657,404,3181,174,111,0,0,0,3870,7527
60,Frosinone,53,490,3012,168,24,1,0,0,3695,365,3183,194,152,2,0,0,3896,7591
60,Frosinone,54,506,3088,164,31,0,0,0,3789,377,3346,179,179,0,0,0,4081,7870
60,Frosinone,55,451,2869,150,41,0,0,0,3511,312,3112,179,165,0,0,0,3768,7279
60,Frosinone,56,418,2955,160,39,0,0,0,3572,314,3071,169,227,0,0,0,3781,7353
60,Frosinone,57,382,2850,122,38,0,0,0,3392,344,2944,138,252,0,0,0,3678,7070
60,Frosinone,58,361,2957,123,53,0,0,0,3494,246,2988,127,296,0,0,0,3657,7151
60,Frosinone,59,320,2813,149,64,0,0,0,3346,232,2947,115,289,0,0,0,3583,6929
60,Frosinone,60,292,2804,96,62,0,0,0,3254,230,2825,133,340,0,0,0,3528,6782
60,Frosinone,61,302,2856,105,75,0,0,0,3338,228,2674,106,382,0,0,0,3390,6728
60,Frosinone,62,276,2760,92,83,0,0,0,3211,189,2639,96,381,0,0,0,3305,6516
60,Frosinone,63,252,2864,102,91,0,0,0,3309,178,2700,121,433,0,0,0,3432,6741
60,Frosinone,64,223,2789,88,84,0,0,0,3184,190,2572,106,472,0,0,0,3340,6524
60,Frosinone,65,221,2633,72,102,0,0,0,3028,202,2457,87,452,0,0,0,3198,6226
60,Frosinone,66,210,2590,83,83,0,0,0,2966,202,2318,70,518,0,0,0,3108,6074
60,Frosinone,67,182,2699,65,107,0,0,0,3053,152,2300,64,602,0,0,0,3118,6171
60,Frosinone,68,154,2653,74,124,0,0,0,3005,165,2254,73,677,0,0,0,3169,6174
60,Frosinone,69,168,2769,87,171,0,0,0,3195,149,2278,74,708,0,0,0,3209,6404
60,Frosinone,70,170,2843,57,173,0,0,0,3243,163,2315,71,832,0,0,0,3381,6624
60,Frosinone,71,142,2726,55,158,0,0,0,3081,148,2146,51,857,0,0,0,3202,6283
60,Frosinone,72,128,2330,53,177,0,0,0,2688,138,1868,46,889,0,0,0,2941,5629
60,Frosinone,73,81,1597,25,120,0,0,0,1823,79,1215,31,648,0,0,0,1973,3796
60,Frosinone,74,83,1679,36,171,0,0,0,1969,101,1274,30,811,0,0,0,2216,4185
60,Frosinone,75,93,1679,28,154,0,0,0,1954,117,1240,32,836,0,0,0,2225,4179
60,Frosinone,76,80,1529,15,142,0,0,0,1766,90,1105,31,816,0,0,0,2042,3808
60,Frosinone,77,56,1462,21,176,0,0,0,1715,97,1042,18,926,0,0,0,2083,3798
60,Frosinone,78,92,1727,27,194,0,0,0,2040,96,1033,23,1096,0,0,0,2248,4288
60,Frosinone,79,70,1566,23,236,0,0,0,1895,101,1022,23,1224,0,0,0,2370,4265
60,Frosinone,80,61,1436,11,236,0,0,0,1744,101,880,14,1254,0,0,0,2249,3993
60,Frosinone,81,60,1257,12,234,0,0,0,1563,105,723,16,1201,0,0,0,2045,3608
60,Frosinone,82,56,1103,4,222,0,0,0,1385,75,692,8,1139,0,0,0,1914,3299
60,Frosinone,83,53,1035,11,228,0,0,0,1327,95,608,13,1201,0,0,0,1917,3244
60,Frosinone,84,36,884,6,247,0,0,0,1173,91,520,16,1253,0,0,0,1880,3053
60,Frosinone,85,29,818,8,249,0,0,0,1104,72,404,11,1168,0,0,0,1655,2759
60,Frosinone,86,25,630,2,226,0,0,0,883,71,349,10,1092,0,0,0,1522,2405
60,Frosinone,87,26,596,2,248,0,0,0,872,84,266,5,1109,0,0,0,1464,2336
60,Frosinone,88,22,488,4,240,0,0,0,754,78,215,2,1096,0,0,0,1391,2145
60,Frosinone,89,16,386,2,204,0,0,0,608,71,163,6,865,0,0,0,1105,1713
60,Frosinone,90,18,269,0,188,0,0,0,475,66,111,4,783,0,0,0,964,1439
60,Frosinone,91,14,172,0,142,0,0,0,328,43,101,6,651,0,0,0,801,1129
60,Frosinone,92,6,134,0,143,0,0,0,283,40,63,5,573,0,0,0,681,964
60,Frosinone,93,10,93,0,108,0,0,0,211,28,30,4,420,0,0,0,482,693
60,Frosinone,94,2,65,0,84,0,0,0,151,34,38,0,363,0,0,0,435,586
60,Frosinone,95,4,36,0,76,0,0,0,116,24,21,1,307,0,0,0,353,469
60,Frosinone,96,3,25,1,64,0,0,0,93,18,19,0,233,0,0,0,270,363
60,Frosinone,97,2,19,0,37,0,0,0,58,17,4,1,149,0,0,0,171,229
60,Frosinone,98,1,16,0,30,0,0,0,47,13,3,1,117,0,0,0,134,181
60,Frosinone,99,1,2,0,7,0,0,0,10,7,2,0,44,0,0,0,53,63
60,Frosinone,100,1,6,0,16,0,0,0,23,7,7,0,73,0,0,0,87,110
61,Caserta,0,4034,0,0,0,0,0,0,4034,3937,0,0,0,0,0,0,3937,7971
61,Caserta,1,4102,0,0,0,0,0,0,4102,3981,0,0,0,0,0,0,3981,8083
61,Caserta,2,4234,0,0,0,0,0,0,4234,4017,0,0,0,0,0,0,4017,8251
61,Caserta,3,4295,0,0,0,0,0,0,4295,4085,0,0,0,0,0,0,4085,8380
61,Caserta,4,4341,0,0,0,0,0,0,4341,4010,0,0,0,0,0,0,4010,8351
61,Caserta,5,4348,0,0,0,0,0,0,4348,4265,0,0,0,0,0,0,4265,8613
61,Caserta,6,4629,0,0,0,0,0,0,4629,4306,0,0,0,0,0,0,4306,8935
61,Caserta,7,4765,0,0,0,0,0,0,4765,4461,0,0,0,0,0,0,4461,9226
61,Caserta,8,4896,0,0,0,0,0,0,4896,4812,0,0,0,0,0,0,4812,9708
61,Caserta,9,5031,0,0,0,0,0,0,5031,4788,0,0,0,0,0,0,4788,9819
61,Caserta,10,5077,0,0,0,0,0,0,5077,4828,0,0,0,0,0,0,4828,9905
61,Caserta,11,5148,0,0,0,0,0,0,5148,4868,0,0,0,0,0,0,4868,10016
61,Caserta,12,5182,0,0,0,0,0,0,5182,4966,0,0,0,0,0,0,4966,10148
61,Caserta,13,5281,0,0,0,0,0,0,5281,4870,0,0,0,0,0,0,4870,10151
61,Caserta,14,5520,0,0,0,0,0,0,5520,5179,0,0,0,0,0,0,5179,10699
61,Caserta,15,5457,0,0,0,0,0,0,5457,5168,0,0,0,0,0,0,5168,10625
61,Caserta,16,5389,0,0,0,0,0,0,5389,5184,0,0,0,0,0,0,5184,10573
61,Caserta,17,5560,0,0,0,0,0,0,5560,5293,2,0,0,0,0,0,5295,10855
61,Caserta,18,5543,2,0,0,0,0,0,5545,5244,10,0,0,0,0,0,5254,10799
61,Caserta,19,5701,0,0,0,0,0,0,5701,5200,31,0,0,0,0,0,5231,10932
61,Caserta,20,5884,7,0,0,0,0,0,5891,5149,67,0,0,0,0,0,5216,11107
61,Caserta,21,5871,33,1,0,2,0,0,5907,5282,110,0,0,0,0,0,5392,11299
61,Caserta,22,5811,33,0,0,0,0,0,5844,5142,219,2,1,0,0,0,5364,11208
61,Caserta,23,5699,83,0,0,0,0,0,5782,5231,313,0,0,0,0,0,5544,11326
61,Caserta,24,5767,152,1,0,1,0,0,5921,5073,497,2,0,0,0,0,5572,11493
61,Caserta,25,5645,227,1,0,0,0,0,5873,4895,738,6,2,0,0,0,5641,11514
61,Caserta,26,5651,386,1,2,1,0,0,6041,4861,1033,5,4,1,0,0,5904,11945
61,Caserta,27,5478,565,4,0,0,0,0,6047,4524,1443,14,2,0,0,0,5983,12030
61,Caserta,28,5134,755,2,1,1,1,0,5894,4138,1762,18,1,1,0,0,5920,11814
61,Caserta,29,4792,1021,6,2,2,0,0,5823,3621,2380,23,5,0,0,0,6029,11852
61,Caserta,30,4539,1373,12,0,1,0,0,5925,3164,2678,24,1,1,0,1,5869,11794
61,Caserta,31,4022,1789,14,3,0,0,0,5828,2680,3054,40,10,0,0,0,5784,11612
61,Caserta,32,3708,2125,22,0,0,0,0,5855,2362,3483,40,9,1,0,0,5895,11750
61,Caserta,33,3360,2519,25,3,3,0,0,5910,2082,3790,40,8,0,0,0,5920,11830
61,Caserta,34,3064,2950,27,2,1,0,0,6044,1850,4104,72,19,0,0,0,6045,12089
61,Caserta,35,2843,3368,38,5,3,0,0,6257,1634,4486,59,15,1,0,0,6195,12452
61,Caserta,36,2585,3715,33,3,1,0,0,6337,1499,4694,74,22,2,0,0,6291,12628
61,Caserta,37,2325,3944,44,7,2,0,0,6322,1372,4640,85,28,0,0,0,6125,12447
61,Caserta,38,2130,4081,63,4,0,0,0,6278,1291,4895,94,39,0,0,0,6319,12597
61,Caserta,39,2135,4301,72,3,3,0,0,6514,1239,5096,141,38,1,0,0,6515,13029
61,Caserta,40,2003,4602,84,8,1,0,0,6698,1109,5287,143,41,1,0,0,6581,13279
61,Caserta,41,1848,4670,72,10,3,0,0,6603,1078,5338,150,61,0,0,0,6627,13230
61,Caserta,42,1812,4963,101,17,1,0,0,6894,1048,5639,182,74,0,0,0,6943,13837
61,Caserta,43,1695,5223,115,18,3,0,0,7054,1025,5709,163,92,0,0,0,6989,14043
61,Caserta,44,1657,5379,115,20,1,0,0,7172,1049,6074,186,100,1,1,0,7411,14583
61,Caserta,45,1436,5392,111,23,3,0,0,6965,1005,5942,177,113,0,0,0,7237,14202
61,Caserta,46,1338,5320,109,31,2,0,0,6800,1022,5898,219,127,0,0,0,7266,14066
61,Caserta,47,1292,5538,121,39,3,0,0,6993,935,5962,215,163,1,0,0,7276,14269
61,Caserta,48,1207,5561,133,46,4,0,0,6951,948,5812,218,175,0,0,0,7153,14104
61,Caserta,49,1097,5816,132,43,0,0,0,7088,874,6011,208,216,1,0,0,7310,14398
61,Caserta,50,1070,5886,137,45,0,0,0,7138,899,6100,221,264,0,0,0,7484,14622
61,Caserta,51,981,6004,137,42,1,0,0,7165,824,6089,234,239,1,0,0,7387,14552
61,Caserta,52,887,5950,154,68,0,0,0,7059,910,5967,265,280,1,0,1,7424,14483
61,Caserta,53,845,6109,142,75,3,0,0,7174,809,6048,219,314,0,0,0,7390,14564
61,Caserta,54,724,6287,156,81,1,0,0,7249,802,6129,240,392,0,0,0,7563,14812
61,Caserta,55,689,5736,154,73,1,0,0,6653,760,5641,198,398,0,0,0,6997,13650
61,Caserta,56,596,5546,132,84,1,0,0,6359,726,5343,209,491,1,0,0,6770,13129
61,Caserta,57,556,5420,114,114,1,0,0,6205,677,5359,187,501,0,0,0,6724,12929
61,Caserta,58,532,5216,119,102,3,0,0,5972,626,4958,181,551,0,0,0,6316,12288
61,Caserta,59,402,5233,88,107,1,0,0,5831,654,4763,158,576,0,0,0,6151,11982
61,Caserta,60,433,4836,109,107,1,0,0,5486,600,4486,165,623,0,0,1,5875,11361
61,Caserta,61,373,4765,107,132,1,0,0,5378,492,4287,137,631,0,0,0,5547,10925
61,Caserta,62,310,4508,101,145,0,0,0,5064,452,4235,145,685,0,0,0,5517,10581
61,Caserta,63,325,4646,83,159,0,0,0,5213,468,4125,150,811,1,0,0,5555,10768
61,Caserta,64,273,4568,74,173,1,0,0,5089,473,4231,138,892,0,0,1,5735,10824
61,Caserta,65,250,4051,68,167,1,0,0,4537,387,3518,120,856,0,0,0,4881,9418
61,Caserta,66,249,3970,59,193,0,0,0,4471,394,3289,101,910,0,0,0,4694,9165
61,Caserta,67,204,4009,61,213,0,0,0,4487,355,3294,107,1003,0,0,0,4759,9246
61,Caserta,68,169,4056,66,225,0,0,0,4516,347,3354,103,1158,0,0,0,4962,9478
61,Caserta,69,194,3897,66,235,0,0,0,4392,342,3319,83,1259,0,0,0,5003,9395
61,Caserta,70,160,3942,46,291,0,0,0,4439,342,3201,94,1306,0,0,0,4943,9382
61,Caserta,71,169,3732,58,291,0,0,0,4250,309,2907,93,1422,0,0,0,4731,8981
61,Caserta,72,157,3728,44,311,1,0,0,4241,292,2818,79,1656,0,0,0,4845,9086
61,Caserta,73,107,2906,41,289,0,0,0,3343,242,2160,57,1395,0,0,0,3854,7197
61,Caserta,74,113,2437,33,292,0,0,0,2875,241,1735,42,1299,0,0,0,3317,6192
61,Caserta,75,113,2516,30,298,0,0,0,2957,271,1923,35,1483,0,0,0,3712,6669
61,Caserta,76,93,2357,25,319,0,0,0,2794,233,1607,33,1487,0,0,0,3360,6154
61,Caserta,77,83,2095,28,316,0,0,0,2522,248,1516,40,1595,0,0,0,3399,5921
61,Caserta,78,100,2279,27,397,0,0,1,2804,242,1567,35,1846,0,0,0,3690,6494
61,Caserta,79,61,2073,19,434,0,0,0,2587,269,1253,32,1879,0,0,0,3433,6020
61,Caserta,80,44,1744,18,427,0,0,0,2233,241,1162,27,1767,0,0,0,3197,5430
61,Caserta,81,53,1570,9,419,0,0,0,2051,203,947,26,1676,0,0,0,2852,4903
61,Caserta,82,55,1324,12,391,0,0,1,1783,190,817,23,1715,0,0,0,2745,4528
61,Caserta,83,43,1245,10,410,0,0,0,1708,195,672,22,1759,0,0,1,2649,4357
61,Caserta,84,37,981,3,364,0,0,0,1385,169,494,26,1651,0,0,0,2340,3725
61,Caserta,85,29,861,11,382,0,0,0,1283,185,414,19,1469,0,0,0,2087,3370
61,Caserta,86,33,738,4,365,1,0,0,1141,135,365,10,1473,0,0,0,1983,3124
61,Caserta,87,22,552,2,343,0,0,0,919,141,283,8,1357,0,0,1,1790,2709
61,Caserta,88,23,483,1,314,0,0,0,821,138,211,19,1270,0,0,0,1638,2459
61,Caserta,89,19,312,2,240,0,0,0,573,115,141,8,1012,0,0,0,1276,1849
61,Caserta,90,13,239,1,224,0,0,0,477,83,111,3,870,0,0,0,1067,1544
61,Caserta,91,12,167,2,150,0,0,0,331,89,73,6,762,0,0,0,930,1261
61,Caserta,92,14,120,0,167,0,0,0,301,67,56,1,588,0,0,0,712,1013
61,Caserta,93,5,89,0,111,0,0,0,205,63,37,6,461,0,0,0,567,772
61,Caserta,94,6,44,0,91,0,0,0,141,34,23,3,355,0,0,0,415,556
61,Caserta,95,4,45,0,55,0,0,0,104,29,16,2,281,0,0,0,328,432
61,Caserta,96,3,27,0,42,0,0,0,72,16,10,1,189,0,0,0,216,288
61,Caserta,97,6,17,0,26,0,0,0,49,16,3,0,137,0,0,0,156,205
61,Caserta,98,1,5,0,23,0,0,0,29,12,2,0,95,0,0,0,109,138
61,Caserta,99,0,0,0,9,0,0,0,9,5,1,0,38,0,0,0,44,53
61,Caserta,100,4,7,0,9,0,0,0,20,12,3,0,79,0,0,0,94,114
62,Benevento,0,970,0,0,0,0,0,0,970,961,0,0,0,0,0,0,961,1931
62,Benevento,1,1043,0,0,0,0,0,0,1043,1008,0,0,0,0,0,0,1008,2051
62,Benevento,2,1040,0,0,0,0,0,0,1040,1013,0,0,0,0,0,0,1013,2053
62,Benevento,3,1046,0,0,0,0,0,0,1046,984,0,0,0,0,0,0,984,2030
62,Benevento,4,1059,0,0,0,0,0,0,1059,982,0,0,0,0,0,0,982,2041
62,Benevento,5,1130,0,0,0,0,0,0,1130,1018,0,0,0,0,0,0,1018,2148
62,Benevento,6,1112,0,0,0,0,0,0,1112,1007,0,0,0,0,0,0,1007,2119
62,Benevento,7,1204,0,0,0,0,0,0,1204,1066,0,0,0,0,0,0,1066,2270
62,Benevento,8,1144,0,0,0,0,0,0,1144,1151,0,0,0,0,0,0,1151,2295
62,Benevento,9,1233,0,0,0,0,0,0,1233,1175,0,0,0,0,0,0,1175,2408
62,Benevento,10,1235,0,0,0,0,0,0,1235,1146,0,0,0,0,0,0,1146,2381
62,Benevento,11,1236,0,0,0,0,0,0,1236,1246,0,0,0,0,0,0,1246,2482
62,Benevento,12,1270,0,0,0,0,0,0,1270,1180,0,0,0,0,0,0,1180,2450
62,Benevento,13,1316,0,0,0,0,0,0,1316,1209,0,0,0,0,0,0,1209,2525
62,Benevento,14,1379,0,0,0,0,0,0,1379,1227,0,0,0,0,0,0,1227,2606
62,Benevento,15,1353,0,0,0,0,0,0,1353,1249,0,0,0,0,0,0,1249,2602
62,Benevento,16,1396,0,0,0,0,0,0,1396,1326,0,0,0,0,0,0,1326,2722
62,Benevento,17,1384,0,0,0,0,0,0,1384,1336,0,0,0,0,0,0,1336,2720
62,Benevento,18,1544,0,0,0,0,0,0,1544,1403,0,0,0,0,0,0,1403,2947
62,Benevento,19,1527,0,0,0,0,0,0,1527,1388,3,0,0,0,0,0,1391,2918
62,Benevento,20,1662,2,0,0,0,0,0,1664,1449,10,0,0,0,0,0,1459,3123
62,Benevento,21,1660,7,0,0,0,0,0,1667,1459,28,0,0,0,0,0,1487,3154
62,Benevento,22,1717,7,0,0,0,0,0,1724,1446,32,0,0,0,0,0,1478,3202
62,Benevento,23,1707,15,0,0,0,0,0,1722,1420,64,0,0,0,0,0,1484,3206
62,Benevento,24,1770,32,0,0,0,0,0,1802,1444,118,1,0,0,0,0,1563,3365
62,Benevento,25,1672,60,0,0,1,0,0,1733,1489,138,3,0,0,0,0,1630,3363
62,Benevento,26,1777,84,0,0,0,0,0,1861,1437,211,0,1,0,0,0,1649,3510
62,Benevento,27,1690,124,0,0,0,0,0,1814,1358,274,2,0,0,0,0,1634,3448
62,Benevento,28,1706,160,3,0,0,0,0,1869,1284,422,2,0,0,0,0,1708,3577
62,Benevento,29,1498,276,1,0,0,0,0,1775,1122,481,6,1,0,0,0,1610,3385
62,Benevento,30,1513,333,0,0,0,0,0,1846,1047,603,8,1,1,0,0,1660,3506
62,Benevento,31,1362,366,1,0,0,0,0,1729,871,690,8,1,0,0,0,1570,3299
62,Benevento,32,1173,472,9,0,0,0,0,1654,800,753,14,2,0,0,0,1569,3223
62,Benevento,33,1138,561,1,0,0,0,0,1700,753,845,14,3,0,0,0,1615,3315
62,Benevento,34,1063,668,3,1,0,0,0,1735,672,923,19,3,0,0,0,1617,3352
62,Benevento,35,909,723,8,1,0,0,0,1641,587,988,27,5,0,0,0,1607,3248
62,Benevento,36,906,769,9,1,0,0,0,1685,526,1039,24,6,0,0,0,1595,3280
62,Benevento,37,838,870,12,0,0,0,0,1720,498,1139,24,4,0,0,0,1665,3385
62,Benevento,38,746,909,12,1,0,0,0,1668,433,1186,21,6,0,0,0,1646,3314
62,Benevento,39,688,1015,15,4,0,0,0,1722,396,1259,32,13,0,0,0,1700,3422
62,Benevento,40,677,1016,18,2,0,0,0,1713,408,1288,41,11,0,0,0,1748,3461
62,Benevento,41,625,1083,22,3,0,0,0,1733,399,1389,39,11,0,0,0,1838,3571
62,Benevento,42,611,1300,17,2,0,0,0,1930,385,1424,43,21,0,0,0,1873,3803
62,Benevento,43,601,1248,37,1,1,0,0,1888,323,1551,47,21,0,0,0,1942,3830
62,Benevento,44,550,1339,34,3,0,0,0,1926,341,1595,53,26,0,0,0,2015,3941
62,Benevento,45,543,1394,40,4,0,0,0,1981,336,1555,61,30,0,0,0,1982,3963
62,Benevento,46,509,1414,37,7,0,0,0,1967,294,1671,66,32,0,0,0,2063,4030
62,Benevento,47,467,1485,45,8,0,0,0,2005,266,1688,72,38,0,0,0,2064,4069
62,Benevento,48,443,1554,43,6,0,0,0,2046,267,1741,66,49,0,0,0,2123,4169
62,Benevento,49,419,1596,43,13,0,0,0,2071,310,1803,68,49,0,0,0,2230,4301
62,Benevento,50,398,1676,56,12,1,0,0,2143,279,1781,81,67,0,0,0,2208,4351
62,Benevento,51,379,1676,65,9,0,0,0,2129,265,1861,81,73,0,0,0,2280,4409
62,Benevento,52,343,1747,56,15,0,0,0,2161,280,1831,91,93,0,0,0,2295,4456
62,Benevento,53,305,1818,61,18,0,0,0,2202,224,1866,75,95,0,0,0,2260,4462
62,Benevento,54,344,1832,64,23,0,0,0,2263,269,1918,72,144,0,0,0,2403,4666
62,Benevento,55,284,1797,70,31,0,0,0,2182,244,1781,73,108,0,0,0,2206,4388
62,Benevento,56,256,1749,52,31,0,0,0,2088,187,1690,71,126,0,0,0,2074,4162
62,Benevento,57,231,1756,40,22,1,0,0,2050,204,1745,63,138,0,0,0,2150,4200
62,Benevento,58,215,1721,50,32,0,0,0,2018,178,1681,62,158,0,0,0,2079,4097
62,Benevento,59,196,1663,31,46,0,0,0,1936,178,1588,62,195,0,0,0,2023,3959
62,Benevento,60,179,1530,44,20,0,0,0,1773,162,1450,56,203,0,0,0,1871,3644
62,Benevento,61,163,1527,39,28,0,0,0,1757,153,1426,50,200,0,0,0,1829,3586
62,Benevento,62,126,1439,47,44,0,0,0,1656,131,1386,35,203,0,0,0,1755,3411
62,Benevento,63,148,1520,38,54,0,0,0,1760,125,1307,46,234,0,0,0,1712,3472
62,Benevento,64,125,1455,35,51,0,0,0,1666,119,1362,37,257,0,0,0,1775,3441
62,Benevento,65,110,1354,33,48,0,0,0,1545,108,1223,27,283,0,0,0,1641,3186
62,Benevento,66,87,1333,32,49,0,0,0,1501,104,1214,29,277,0,0,0,1624,3125
62,Benevento,67,108,1359,27,63,1,0,0,1558,95,1119,29,306,0,0,0,1549,3107
62,Benevento,68,103,1352,42,71,0,0,0,1568,104,1135,35,356,0,0,0,1630,3198
62,Benevento,69,85,1397,27,69,0,0,0,1578,89,1147,31,417,0,0,0,1684,3262
62,Benevento,70,85,1368,33,97,0,0,0,1583,103,1175,29,460,0,0,0,1767,3350
62,Benevento,71,101,1353,19,100,0,0,0,1573,107,1034,25,472,0,0,0,1638,3211
62,Benevento,72,71,1256,19,86,0,0,0,1432,82,968,19,464,0,0,0,1533,2965
62,Benevento,73,52,928,16,71,0,0,0,1067,70,703,14,398,0,0,0,1185,2252
62,Benevento,74,39,882,10,86,0,0,0,1017,79,683,12,453,0,0,0,1227,2244
62,Benevento,75,43,976,6,97,0,0,0,1122,83,647,15,512,0,0,0,1257,2379
62,Benevento,76,43,790,15,87,0,0,0,935,72,580,16,462,0,0,0,1130,2065
62,Benevento,77,40,769,10,107,0,0,0,926,68,556,10,537,0,0,0,1171,2097
62,Benevento,78,52,925,9,148,0,0,0,1134,102,663,14,638,0,0,0,1417,2551
62,Benevento,79,38,871,13,136,0,0,0,1058,94,637,15,689,0,0,0,1435,2493
62,Benevento,80,34,821,4,139,0,0,0,998,72,512,11,678,0,0,0,1273,2271
62,Benevento,81,53,722,8,177,0,0,0,960,86,461,11,741,0,0,0,1299,2259
62,Benevento,82,35,628,5,154,0,0,0,822,74,395,7,699,0,0,0,1175,1997
62,Benevento,83,21,603,7,162,0,0,0,793,73,365,9,731,0,0,0,1178,1971
62,Benevento,84,26,505,3,182,0,0,0,716,75,273,5,699,0,0,0,1052,1768
62,Benevento,85,26,435,2,165,0,0,0,628,76,242,7,751,0,0,0,1076,1704
62,Benevento,86,23,406,2,167,0,0,0,598,71,192,5,665,0,0,0,933,1531
62,Benevento,87,20,327,0,144,0,0,0,491,71,186,4,679,0,0,0,940,1431
62,Benevento,88,15,269,3,174,0,0,0,461,73,144,3,656,0,0,0,876,1337
62,Benevento,89,14,208,1,115,0,0,0,338,56,107,3,486,0,0,0,652,990
62,Benevento,90,9,156,2,118,0,0,0,285,52,76,2,481,0,0,0,611,896
62,Benevento,91,11,105,0,128,0,0,0,244,50,57,2,462,0,0,0,571,815
62,Benevento,92,6,94,0,75,0,0,0,175,45,47,1,349,0,0,0,442,617
62,Benevento,93,6,56,1,77,0,0,0,140,40,35,0,317,0,0,0,392,532
62,Benevento,94,10,35,0,49,0,0,0,94,18,7,0,226,0,0,0,251,345
62,Benevento,95,4,26,0,35,0,0,0,65,15,10,0,176,0,0,0,201,266
62,Benevento,96,3,14,1,25,0,0,0,43,15,7,0,138,0,0,0,160,203
62,Benevento,97,2,15,0,18,0,0,0,35,15,7,0,111,0,0,0,133,168
62,Benevento,98,1,7,0,13,0,0,0,21,6,5,1,60,0,0,0,72,93
62,Benevento,99,0,3,0,7,0,0,0,10,5,1,0,34,0,0,0,40,50
62,Benevento,100,3,8,0,10,0,0,0,21,3,3,0,44,0,0,0,50,71
63,Napoli,0,13868,0,0,0,0,0,0,13868,12771,0,0,0,0,0,0,12771,26639
63,Napoli,1,14197,0,0,0,0,0,0,14197,13631,0,0,0,0,0,0,13631,27828
63,Napoli,2,14271,0,0,0,0,0,0,14271,13467,0,0,0,0,0,0,13467,27738
63,Napoli,3,14542,0,0,0,0,0,0,14542,13874,0,0,0,0,0,0,13874,28416
63,Napoli,4,14787,0,0,0,0,0,0,14787,13984,0,0,0,0,0,0,13984,28771
63,Napoli,5,15071,0,0,0,0,0,0,15071,14232,0,0,0,0,0,0,14232,29303
63,Napoli,6,15821,0,0,0,0,0,0,15821,14946,0,0,0,0,0,0,14946,30767
63,Napoli,7,16232,0,0,0,0,0,0,16232,15203,0,0,0,0,0,0,15203,31435
63,Napoli,8,16860,0,0,0,0,0,0,16860,15342,0,0,0,0,0,0,15342,32202
63,Napoli,9,16909,0,0,0,0,0,0,16909,16298,0,0,0,0,0,0,16298,33207
63,Napoli,10,17273,0,0,0,0,0,0,17273,16477,0,0,0,0,0,0,16477,33750
63,Napoli,11,17638,0,0,0,0,0,0,17638,16934,0,0,0,0,0,0,16934,34572
63,Napoli,12,18038,0,0,0,0,0,0,18038,16764,0,0,0,0,0,0,16764,34802
63,Napoli,13,17891,0,0,0,0,0,0,17891,17079,0,0,0,0,0,0,17079,34970
63,Napoli,14,18490,0,0,0,0,0,0,18490,17462,0,0,0,0,0,0,17462,35952
63,Napoli,15,18642,0,0,0,0,0,0,18642,17990,0,0,0,0,0,0,17990,36632
63,Napoli,16,18476,0,0,0,0,0,0,18476,17660,0,0,0,0,0,0,17660,36136
63,Napoli,17,19128,1,1,0,0,0,0,19130,17881,1,0,0,0,0,0,17882,37012
63,Napoli,18,19407,2,1,1,0,0,0,19411,18303,24,0,0,0,0,0,18327,37738
63,Napoli,19,19538,14,1,0,0,0,0,19553,18166,97,1,1,0,0,0,18265,37818
63,Napoli,20,19773,58,0,0,0,0,0,19831,17989,226,2,1,0,0,0,18218,38049
63,Napoli,21,19525,78,0,0,0,0,0,19603,17761,458,4,0,0,0,0,18223,37826
63,Napoli,22,19342,227,5,0,0,0,0,19574,17654,754,2,0,0,0,0,18410,37984
63,Napoli,23,19019,363,15,0,0,0,0,19397,17566,1235,8,1,1,0,0,18811,38208
63,Napoli,24,19150,624,15,0,1,0,0,19790,17171,1789,10,1,1,0,0,18972,38762
63,Napoli,25,18713,962,11,0,1,0,0,19687,16648,2673,16,1,1,0,0,19339,39026
63,Napoli,26,18931,1580,23,0,1,0,0,20535,16194,3869,23,4,2,0,0,20092,40627
63,Napoli,27,17966,2182,26,0,1,0,0,20175,14965,4942,42,7,0,0,0,19956,40131
63,Napoli,28,16643,3135,40,1,2,0,0,19821,13252,6077,53,9,4,0,0,19395,39216
63,Napoli,29,15473,4101,41,1,2,0,0,19618,11948,7473,72,15,1,0,0,19509,39127
63,Napoli,30,14419,5154,56,1,1,0,0,19631,10603,8995,91,15,11,0,0,19715,39346
63,Napoli,31,12856,6374,81,1,4,0,0,19316,8903,9647,112,30,6,0,0,18698,38014
63,Napoli,32,11319,7392,84,3,7,0,0,18805,7738,10664,144,28,7,0,1,18582,37387
63,Napoli,33,10636,8767,87,7,7,0,0,19504,6800,11843,165,40,0,0,0,18848,38352
63,Napoli,34,9520,9501,104,11,1,0,0,19137,6260,12914,215,53,5,0,0,19447,38584
63,Napoli,35,8648,10648,139,7,3,0,0,19445,5620,13726,229,62,3,1,0,19641,39086
63,Napoli,36,8238,11805,156,12,5,0,0,20216,5187,14517,285,91,2,0,0,20082,40298
63,Napoli,37,7128,11870,153,18,5,0,0,19174,4846,14866,301,82,2,0,0,20097,39271
63,Napoli,38,6806,12943,190,19,5,0,0,19963,4358,15354,367,122,3,0,0,20204,40167
63,Napoli,39,6305,13586,232,27,7,0,0,20157,4139,15995,438,133,7,1,0,20713,40870
63,Napoli,40,6057,14272,237,28,5,0,0,20599,4051,16669,507,185,2,0,0,21414,42013
63,Napoli,41,5864,14991,301,35,12,1,0,21204,3911,17196,543,221,6,0,0,21877,43081
63,Napoli,42,5624,15699,342,41,5,1,0,21712,4081,17739,580,243,0,0,0,22643,44355
63,Napoli,43,5707,16828,363,57,11,0,0,22966,3872,18547,636,305,3,0,0,23363,46329
63,Napoli,44,5402,17637,436,65,6,0,0,23546,3944,19581,758,357,2,0,0,24642,48188
63,Napoli,45,4935,17337,453,72,8,0,0,22805,3659,19449,779,412,8,0,0,24307,47112
63,Napoli,46,4732,17993,458,76,4,0,0,23263,3538,19475,861,470,1,0,0,24345,47608
63,Napoli,47,4358,17650,503,113,8,0,1,22633,3453,19641,932,553,3,0,0,24582,47215
63,Napoli,48,3908,17624,506,117,14,0,0,22169,3213,19364,965,530,4,0,0,24076,46245
63,Napoli,49,3765,18395,563,136,9,0,0,22868,3148,19584,918,698,1,1,0,24350,47218
63,Napoli,50,3431,18401,544,156,5,0,0,22537,2992,19473,948,764,2,0,0,24179,46716
63,Napoli,51,3279,18749,602,169,8,0,0,22807,3084,19962,1056,862,4,0,0,24968,47775
63,Napoli,52,3138,19182,614,206,6,0,0,23146,2992,19986,996,1009,2,0,0,24985,48131
63,Napoli,53,2838,19193,637,227,10,0,0,22905,2831,19790,1055,1104,3,0,0,24783,47688
63,Napoli,54,2755,19478,677,256,12,0,0,23178,2766,19981,1108,1316,1,0,1,25173,48351
63,Napoli,55,2398,18344,571,308,11,0,0,21632,2677,18962,974,1425,1,0,0,24039,45671
63,Napoli,56,2205,18149,602,289,5,0,0,21250,2566,18451,931,1545,2,0,0,23495,44745
63,Napoli,57,1997,17501,539,338,9,0,0,20384,2330,17766,982,1640,2,0,1,22721,43105
63,Napoli,58,1827,16500,522,360,7,0,0,19216,2223,16873,899,1776,0,0,0,21771,40987
63,Napoli,59,1651,16549,524,391,9,0,0,19124,2161,16407,840,2013,4,0,0,21425,40549
63,Napoli,60,1492,15898,461,409,5,0,0,18265,2069,15522,791,2119,1,0,0,20502,38767
63,Napoli,61,1416,15734,466,498,9,0,0,18123,1914,15293,834,2244,0,0,0,20285,38408
63,Napoli,62,1241,14974,405,513,6,1,0,17140,1717,14311,751,2420,2,0,0,19201,36341
63,Napoli,63,1106,15411,401,552,4,1,0,17475,1781,14409,674,2661,1,0,0,19526,37001
63,Napoli,64,1073,15203,369,606,2,0,0,17253,1716,13845,639,2874,1,0,0,19075,36328
63,Napoli,65,926,13854,317,624,2,0,0,15723,1440,12545,589,2880,0,0,0,17454,33177
63,Napoli,66,898,13369,314,655,4,0,0,15240,1487,11818,585,3061,2,0,0,16953,32193
63,Napoli,67,726,13246,287,741,4,0,0,15004,1413,11461,536,3373,0,1,0,16784,31788
63,Napoli,68,736,13354,282,816,2,1,0,15191,1473,11454,532,3636,1,1,0,17097,32288
63,Napoli,69,734,13216,257,870,3,0,0,15080,1384,11080,501,3910,0,0,0,16875,31955
63,Napoli,70,718,13357,226,1035,2,0,0,15338,1445,10759,489,4390,0,0,0,17083,32421
63,Napoli,71,661,12568,260,1054,2,0,0,14545,1444,10167,443,4750,1,0,0,16805,31350
63,Napoli,72,606,12662,208,1181,2,0,1,14660,1352,10036,370,5378,0,0,0,17136,31796
63,Napoli,73,500,10836,158,1184,3,0,0,12681,1214,8275,341,4863,0,0,0,14693,27374
63,Napoli,74,361,8324,142,973,2,0,1,9803,961,6179,277,4331,0,0,0,11748,21551
63,Napoli,75,397,8622,127,1099,0,0,0,10245,1059,6467,250,5055,1,0,0,12832,23077
63,Napoli,76,354,7965,126,1141,0,0,0,9586,1035,5787,230,5069,0,0,0,12121,21707
63,Napoli,77,325,7141,99,1215,0,0,0,8780,966,5232,217,5243,1,0,0,11659,20439
63,Napoli,78,320,7250,87,1280,1,0,0,8938,1078,4921,179,5772,1,0,0,11951,20889
63,Napoli,79,274,6510,73,1316,0,0,0,8173,951,4404,177,5795,0,0,0,11327,19500
63,Napoli,80,263,5686,80,1306,1,0,0,7336,908,3714,147,5658,0,0,0,10427,17763
63,Napoli,81,219,4965,60,1261,0,0,0,6505,796,3067,158,5491,0,0,0,9512,16017
63,Napoli,82,202,4111,51,1216,0,0,0,5580,780,2403,119,5345,0,0,0,8647,14227
63,Napoli,83,172,3659,33,1245,0,0,0,5109,722,2167,102,5265,0,0,0,8256,13365
63,Napoli,84,167,3139,27,1201,0,0,0,4534,682,1675,93,5045,0,0,0,7495,12029
63,Napoli,85,153,2759,28,1153,0,0,0,4093,670,1406,83,4947,0,0,0,7106,11199
63,Napoli,86,138,2233,27,1128,0,0,0,3526,587,1109,69,4647,0,0,0,6412,9938
63,Napoli,87,78,1825,20,1025,1,0,0,2949,556,836,63,4181,0,0,0,5636,8585
63,Napoli,88,90,1460,21,905,0,0,0,2476,522,704,57,3838,0,0,0,5121,7597
63,Napoli,89,91,1069,13,775,1,0,0,1949,461,471,55,3179,0,0,1,4167,6116
63,Napoli,90,59,756,9,691,0,0,0,1515,377,369,54,2750,0,0,0,3550,5065
63,Napoli,91,39,550,8,562,0,0,0,1159,328,241,30,2275,0,0,0,2874,4033
63,Napoli,92,46,377,4,446,0,0,0,873,253,175,16,1786,0,0,0,2230,3103
63,Napoli,93,30,264,6,328,0,0,0,628,229,117,26,1431,0,0,0,1803,2431
63,Napoli,94,26,168,2,238,0,0,0,434,146,89,13,1112,0,0,0,1360,1794
63,Napoli,95,21,101,2,159,0,0,0,283,133,57,8,835,0,0,0,1033,1316
63,Napoli,96,19,80,1,128,0,0,0,228,81,42,7,605,0,0,0,735,963
63,Napoli,97,14,53,2,97,0,0,0,166,70,28,4,406,0,0,0,508,674
63,Napoli,98,11,28,0,63,0,0,0,102,50,20,3,304,0,0,0,377,479
63,Napoli,99,10,19,1,27,0,0,0,57,23,17,1,129,0,0,0,170,227
63,Napoli,100,28,35,0,58,0,0,0,121,71,31,6,289,0,0,0,397,518
64,Avellino,0,1458,0,0,0,0,0,0,1458,1422,0,0,0,0,0,0,1422,2880
64,Avellino,1,1559,0,0,0,0,0,0,1559,1534,0,0,0,0,0,0,1534,3093
64,Avellino,2,1565,0,0,0,0,0,0,1565,1515,0,0,0,0,0,0,1515,3080
64,Avellino,3,1576,0,0,0,0,0,0,1576,1446,0,0,0,0,0,0,1446,3022
64,Avellino,4,1591,0,0,0,0,0,0,1591,1472,0,0,0,0,0,0,1472,3063
64,Avellino,5,1622,0,0,0,0,0,0,1622,1616,0,0,0,0,0,0,1616,3238
64,Avellino,6,1718,0,0,0,0,0,0,1718,1594,0,0,0,0,0,0,1594,3312
64,Avellino,7,1694,0,0,0,0,0,0,1694,1632,0,0,0,0,0,0,1632,3326
64,Avellino,8,1838,0,0,0,0,0,0,1838,1718,0,0,0,0,0,0,1718,3556
64,Avellino,9,1882,0,0,0,0,0,0,1882,1776,0,0,0,0,0,0,1776,3658
64,Avellino,10,1870,0,0,0,0,0,0,1870,1861,0,0,0,0,0,0,1861,3731
64,Avellino,11,1927,0,0,0,0,0,0,1927,1813,0,0,0,0,0,0,1813,3740
64,Avellino,12,1941,0,0,0,0,0,0,1941,1835,0,0,0,0,0,0,1835,3776
64,Avellino,13,1992,0,0,0,0,0,0,1992,1787,0,0,0,0,0,0,1787,3779
64,Avellino,14,2068,0,0,0,0,0,0,2068,1959,0,0,0,0,0,0,1959,4027
64,Avellino,15,2084,0,0,0,0,0,0,2084,2010,0,0,0,0,0,0,2010,4094
64,Avellino,16,2106,0,0,0,0,0,0,2106,1973,0,0,0,0,0,0,1973,4079
64,Avellino,17,2121,1,0,0,0,0,0,2122,1988,1,0,0,0,0,0,1989,4111
64,Avellino,18,2189,1,0,0,0,0,0,2190,2059,3,1,0,0,0,0,2063,4253
64,Avellino,19,2355,1,0,0,0,0,0,2356,2095,7,0,0,0,0,0,2102,4458
64,Avellino,20,2448,4,1,0,0,0,0,2453,2146,14,0,0,0,0,0,2160,4613
64,Avellino,21,2449,8,1,0,0,0,0,2458,2129,26,0,0,0,0,0,2155,4613
64,Avellino,22,2488,10,1,0,0,0,0,2499,2163,54,0,0,0,0,0,2217,4716
64,Avellino,23,2408,24,1,0,0,0,0,2433,2162,89,0,1,0,0,0,2252,4685
64,Avellino,24,2372,31,0,0,0,0,0,2403,2124,137,1,0,0,0,0,2262,4665
64,Avellino,25,2617,57,0,0,0,0,0,2674,2104,201,5,1,0,0,0,2311,4985
64,Avellino,26,2608,123,0,0,0,0,0,2731,2210,342,3,1,0,0,0,2556,5287
64,Avellino,27,2514,154,0,0,0,0,0,2668,2009,447,5,0,0,0,0,2461,5129
64,Avellino,28,2452,266,1,0,0,0,0,2719,1947,577,9,0,0,0,0,2533,5252
64,Avellino,29,2346,337,2,0,0,0,0,2685,1753,768,7,3,0,0,0,2531,5216
64,Avellino,30,2262,465,5,0,0,0,0,2732,1633,905,6,1,0,0,0,2545,5277
64,Avellino,31,1944,598,5,0,0,0,0,2547,1340,1057,16,6,0,0,0,2419,4966
64,Avellino,32,1874,759,2,0,0,0,0,2635,1212,1186,15,2,0,0,0,2415,5050
64,Avellino,33,1763,963,3,1,1,0,0,2731,1176,1304,19,6,0,0,0,2505,5236
64,Avellino,34,1566,984,14,1,0,0,0,2565,1027,1475,28,4,0,0,0,2534,5099
64,Avellino,35,1380,1115,15,1,0,0,0,2511,907,1568,31,3,0,0,0,2509,5020
64,Avellino,36,1370,1254,18,2,1,0,0,2645,799,1613,28,7,0,1,0,2448,5093
64,Avellino,37,1240,1359,25,1,0,0,0,2625,693,1795,30,15,0,0,0,2533,5158
64,Avellino,38,1152,1441,20,2,0,0,0,2615,634,1752,38,9,0,0,0,2433,5048
64,Avellino,39,1055,1609,26,0,0,0,0,2690,643,1883,51,15,0,0,0,2592,5282
64,Avellino,40,979,1665,28,6,1,0,0,2679,576,2173,58,25,0,0,0,2832,5511
64,Avellino,41,962,1818,27,6,0,0,0,2813,590,2145,59,25,0,0,0,2819,5632
64,Avellino,42,918,1969,34,7,3,0,0,2931,533,2306,61,28,0,0,0,2928,5859
64,Avellino,43,879,2010,51,5,0,0,0,2945,541,2399,81,34,1,0,0,3056,6001
64,Avellino,44,834,2108,38,8,0,0,0,2988,519,2432,90,53,0,0,0,3094,6082
64,Avellino,45,720,2109,60,9,1,0,0,2899,448,2465,84,51,0,0,0,3048,5947
64,Avellino,46,747,2282,53,13,0,0,0,3095,425,2555,95,53,0,0,0,3128,6223
64,Avellino,47,671,2334,57,14,0,0,0,3076,451,2637,91,64,0,0,0,3243,6319
64,Avellino,48,601,2350,77,17,0,0,0,3045,416,2687,111,70,0,0,0,3284,6329
64,Avellino,49,643,2538,64,20,0,0,0,3265,418,2700,108,82,0,0,0,3308,6573
64,Avellino,50,586,2619,79,21,1,0,0,3306,421,2861,116,95,0,0,0,3493,6799
64,Avellino,51,557,2634,67,18,0,0,0,3276,387,2812,109,113,0,0,0,3421,6697
64,Avellino,52,545,2687,78,39,0,0,0,3349,384,2793,107,117,0,0,0,3401,6750
64,Avellino,53,492,2875,78,29,0,0,0,3474,352,2778,114,142,0,0,0,3386,6860
64,Avellino,54,475,2940,84,29,0,0,0,3528,361,2975,105,202,0,0,0,3643,7171
64,Avellino,55,458,2802,76,40,0,0,0,3376,348,2701,113,192,0,0,0,3354,6730
64,Avellino,56,403,2619,82,32,1,0,0,3137,306,2677,102,193,0,0,0,3278,6415
64,Avellino,57,361,2702,81,44,1,0,0,3189,312,2619,113,216,0,0,0,3260,6449
64,Avellino,58,331,2603,77,41,0,0,0,3052,326,2516,77,286,0,1,0,3206,6258
64,Avellino,59,334,2521,54,56,0,0,0,2965,313,2487,86,241,0,0,0,3127,6092
64,Avellino,60,283,2384,54,57,1,0,0,2779,247,2286,83,261,0,0,0,2877,5656
64,Avellino,61,257,2372,60,68,1,0,0,2758,245,2215,74,325,0,0,0,2859,5617
64,Avellino,62,209,2251,48,55,0,0,0,2563,226,2185,74,317,0,0,0,2802,5365
64,Avellino,63,206,2299,66,80,0,0,0,2651,196,1977,68,364,0,0,0,2605,5256
64,Avellino,64,177,2211,59,71,0,0,0,2518,207,1996,78,391,0,0,0,2672,5190
64,Avellino,65,182,2179,51,79,0,0,0,2491,177,1880,34,389,0,0,0,2480,4971
64,Avellino,66,168,2066,54,74,1,0,0,2363,189,1827,54,436,0,0,0,2506,4869
64,Avellino,67,176,2058,41,100,0,0,0,2375,171,1724,39,435,0,0,0,2369,4744
64,Avellino,68,161,2032,40,96,0,0,0,2329,160,1747,55,507,0,0,0,2469,4798
64,Avellino,69,135,2028,29,113,0,0,1,2306,169,1624,34,558,0,0,0,2385,4691
64,Avellino,70,133,2047,40,128,0,0,0,2348,168,1622,49,622,0,0,0,2461,4809
64,Avellino,71,104,1922,37,128,0,0,0,2191,168,1563,49,674,0,0,0,2454,4645
64,Avellino,72,107,1966,37,149,1,0,0,2260,147,1403,45,717,0,0,0,2312,4572
64,Avellino,73,92,1369,27,132,1,0,0,1621,108,1046,20,562,0,0,0,1736,3357
64,Avellino,74,62,1376,15,151,0,0,0,1604,102,992,21,598,0,0,0,1713,3317
64,Avellino,75,85,1281,15,133,0,0,0,1514,119,984,26,688,0,0,0,1817,3331
64,Avellino,76,58,1237,19,157,0,0,0,1471,106,903,20,738,0,0,0,1767,3238
64,Avellino,77,65,1149,14,143,0,0,0,1371,112,803,26,731,0,0,0,1672,3043
64,Avellino,78,72,1289,18,194,0,0,0,1573,114,903,22,913,0,0,0,1952,3525
64,Avellino,79,64,1300,8,192,0,0,0,1564,133,881,19,978,1,0,0,2012,3576
64,Avellino,80,61,1113,10,209,0,0,0,1393,110,749,21,955,0,0,0,1835,3228
64,Avellino,81,51,1019,13,223,0,0,0,1306,122,643,15,1049,0,0,0,1829,3135
64,Avellino,82,48,887,10,229,0,0,0,1174,112,591,12,949,0,0,0,1664,2838
64,Avellino,83,41,891,13,254,0,0,0,1199,89,496,13,1071,0,0,0,1669,2868
64,Avellino,84,41,728,10,247,1,0,0,1027,94,414,11,1003,0,0,0,1522,2549
64,Avellino,85,40,653,4,271,0,0,0,968,88,405,15,981,0,0,0,1489,2457
64,Avellino,86,38,549,3,216,0,0,0,806,85,298,7,945,0,0,0,1335,2141
64,Avellino,87,20,487,6,218,0,0,0,731,87,250,8,993,0,0,0,1338,2069
64,Avellino,88,37,392,2,232,0,0,0,663,88,225,6,974,0,0,0,1293,1956
64,Avellino,89,14,303,8,200,0,0,0,525,75,162,7,765,0,0,0,1009,1534
64,Avellino,90,15,222,2,160,0,0,0,399,58,99,7,706,0,0,0,870,1269
64,Avellino,91,10,158,3,150,0,0,0,321,49,70,4,616,0,0,0,739,1060
64,Avellino,92,12,139,1,124,0,0,0,276,38,60,4,476,0,0,0,578,854
64,Avellino,93,5,67,2,88,0,0,0,162,43,36,3,428,0,0,0,510,672
64,Avellino,94,5,59,0,80,0,0,0,144,25,25,5,323,0,0,0,378,522
64,Avellino,95,1,50,0,54,0,0,0,105,14,22,1,235,0,0,0,272,377
64,Avellino,96,3,26,1,51,0,0,0,81,12,11,2,187,0,0,0,212,293
64,Avellino,97,3,18,1,32,0,0,0,54,9,12,0,146,0,0,0,167,221
64,Avellino,98,5,5,0,32,0,0,0,42,11,7,1,104,0,0,0,123,165
64,Avellino,99,1,4,0,9,0,0,0,14,4,3,0,47,0,0,0,54,68
64,Avellino,100,0,11,0,9,0,0,0,20,7,8,2,60,0,0,0,77,97
65,Salerno,0,4410,0,0,0,0,0,0,4410,4005,0,0,0,0,0,0,4005,8415
65,Salerno,1,4605,0,0,0,0,0,0,4605,4182,0,0,0,0,0,0,4182,8787
65,Salerno,2,4599,0,0,0,0,0,0,4599,4334,0,0,0,0,0,0,4334,8933
65,Salerno,3,4645,0,0,0,0,0,0,4645,4364,0,0,0,0,0,0,4364,9009
65,Salerno,4,4855,0,0,0,0,0,0,4855,4449,0,0,0,0,0,0,4449,9304
65,Salerno,5,4653,0,0,0,0,0,0,4653,4628,0,0,0,0,0,0,4628,9281
65,Salerno,6,5069,0,0,0,0,0,0,5069,4711,0,0,0,0,0,0,4711,9780
65,Salerno,7,5098,0,0,0,0,0,0,5098,4807,0,0,0,0,0,0,4807,9905
65,Salerno,8,5172,0,0,0,0,0,0,5172,4818,0,0,0,0,0,0,4818,9990
65,Salerno,9,5319,0,0,0,0,0,0,5319,4972,0,0,0,0,0,0,4972,10291
65,Salerno,10,5288,0,0,0,0,0,0,5288,5131,0,0,0,0,0,0,5131,10419
65,Salerno,11,5358,0,0,0,0,0,0,5358,5107,0,0,0,0,0,0,5107,10465
65,Salerno,12,5444,0,0,0,0,0,0,5444,5087,0,0,0,0,0,0,5087,10531
65,Salerno,13,5485,0,0,0,0,0,0,5485,5282,0,0,0,0,0,0,5282,10767
65,Salerno,14,5664,0,0,0,0,0,0,5664,5382,0,0,0,0,0,0,5382,11046
65,Salerno,15,5688,0,0,0,0,0,0,5688,5509,0,0,0,0,0,0,5509,11197
65,Salerno,16,5723,0,0,0,0,0,0,5723,5362,0,0,0,0,0,0,5362,11085
65,Salerno,17,5954,1,0,0,0,0,0,5955,5533,1,0,0,0,0,0,5534,11489
65,Salerno,18,6278,0,0,0,0,0,0,6278,5604,2,0,0,0,0,0,5606,11884
65,Salerno,19,6409,1,0,0,0,0,0,6410,5675,16,0,0,0,0,0,5691,12101
65,Salerno,20,6265,9,0,0,0,0,0,6274,5607,54,0,0,0,0,0,5661,11935
65,Salerno,21,6350,14,0,0,1,0,0,6365,5511,127,0,0,0,0,0,5638,12003
65,Salerno,22,6431,29,0,0,0,0,0,6460,5812,183,2,0,0,0,0,5997,12457
65,Salerno,23,6306,69,1,0,1,0,0,6377,5683,319,0,0,0,0,0,6002,12379
65,Salerno,24,6319,120,2,0,0,0,0,6441,5504,467,6,0,0,0,0,5977,12418
65,Salerno,25,6560,184,0,0,2,0,0,6746,5682,700,4,0,0,0,0,6386,13132
65,Salerno,26,6670,351,0,1,2,0,0,7024,5615,1022,11,3,0,0,0,6651,13675
65,Salerno,27,6345,515,6,1,0,0,0,6867,5183,1438,10,1,0,0,0,6632,13499
65,Salerno,28,6249,773,6,0,2,0,0,7030,4906,1831,15,4,0,0,0,6756,13786
65,Salerno,29,5911,1060,12,1,1,0,0,6985,4379,2192,21,1,1,0,0,6594,13579
65,Salerno,30,5645,1384,10,3,1,0,0,7043,4106,2816,28,6,2,0,0,6958,14001
65,Salerno,31,5104,1720,10,1,0,0,0,6835,3494,3100,38,12,1,0,0,6645,13480
65,Salerno,32,4622,2148,5,1,1,0,0,6777,3182,3370,33,8,2,0,0,6595,13372
65,Salerno,33,4273,2567,22,1,3,0,0,6866,2834,3677,47,12,1,0,0,6571,13437
65,Salerno,34,4041,2955,30,3,0,0,0,7029,2614,4153,53,28,0,0,0,6848,13877
65,Salerno,35,3763,3230,24,3,2,0,0,7022,2332,4344,92,20,0,0,0,6788,13810
65,Salerno,36,3516,3535,38,8,1,0,0,7098,2175,4635,87,18,1,0,0,6916,14014
65,Salerno,37,3286,3824,45,2,1,0,0,7158,1935,4856,106,27,1,0,0,6925,14083
65,Salerno,38,3028,4011,69,5,4,1,0,7118,1762,4981,129,25,0,0,0,6897,14015
65,Salerno,39,2752,4316,64,8,5,0,0,7145,1714,5150,167,31,0,0,0,7062,14207
65,Salerno,40,2754,4609,81,11,2,0,0,7457,1604,5361,188,63,2,0,0,7218,14675
65,Salerno,41,2563,4905,94,10,1,0,0,7573,1569,5580,181,53,2,0,0,7385,14958
65,Salerno,42,2546,5128,114,16,2,0,0,7806,1589,5954,188,86,2,0,0,7819,15625
65,Salerno,43,2440,5329,123,17,1,0,0,7910,1521,6155,229,91,2,0,0,7998,15908
65,Salerno,44,2288,5682,135,19,1,0,0,8125,1470,6527,239,110,1,0,0,8347,16472
65,Salerno,45,2218,5814,164,30,4,0,0,8230,1337,6597,263,121,0,0,0,8318,16548
65,Salerno,46,1972,5808,161,24,3,0,0,7968,1293,6734,256,132,2,0,0,8417,16385
65,Salerno,47,1943,6152,177,33,3,0,0,8308,1250,6850,303,169,0,0,0,8572,16880
65,Salerno,48,1806,6035,181,38,1,0,0,8061,1242,6754,281,166,1,0,0,8444,16505
65,Salerno,49,1621,6509,172,34,4,0,0,8340,1233,7103,334,191,1,0,0,8862,17202
65,Salerno,50,1568,6430,213,41,1,0,0,8253,1121,7129,322,237,0,0,0,8809,17062
65,Salerno,51,1498,6615,213,50,2,0,0,8378,1130,7023,336,257,1,0,0,8747,17125
65,Salerno,52,1366,6780,205,56,3,0,0,8410,1115,7177,344,307,0,0,0,8943,17353
65,Salerno,53,1303,6877,220,70,0,0,0,8470,1066,7253,356,373,0,0,0,9048,17518
65,Salerno,54,1301,6986,255,93,0,0,0,8635,1068,7240,319,437,1,0,0,9065,17700
65,Salerno,55,1063,6645,235,80,4,0,0,8027,934,7000,340,421,0,0,0,8695,16722
65,Salerno,56,1029,6518,214,118,3,0,0,7882,933,7102,325,493,0,0,0,8853,16735
65,Salerno,57,898,6685,213,100,3,0,0,7899,867,6788,285,592,0,0,0,8532,16431
65,Salerno,58,881,6545,201,131,2,0,0,7760,856,6574,290,606,0,0,0,8326,16086
65,Salerno,59,719,6658,182,141,0,0,0,7700,850,6163,307,696,0,0,0,8016,15716
65,Salerno,60,662,6230,173,149,0,0,0,7214,725,5955,285,675,0,0,0,7640,14854
65,Salerno,61,618,6082,202,165,2,0,0,7069,690,5898,267,767,0,0,0,7622,14691
65,Salerno,62,513,5908,173,168,0,0,0,6762,657,5577,222,829,0,0,0,7285,14047
65,Salerno,63,545,5945,157,177,1,0,0,6825,626,5359,211,934,0,0,0,7130,13955
65,Salerno,64,485,5706,148,194,1,0,0,6534,582,5313,222,996,0,0,0,7113,13647
65,Salerno,65,414,5399,144,226,0,0,0,6183,559,4765,186,1053,0,0,0,6563,12746
65,Salerno,66,367,5133,118,215,2,0,0,5835,464,4431,183,1099,0,0,0,6177,12012
65,Salerno,67,355,5203,123,257,1,0,0,5939,445,4517,161,1201,0,0,0,6324,12263
65,Salerno,68,366,5250,128,274,0,0,1,6019,481,4324,171,1316,0,0,0,6292,12311
65,Salerno,69,317,5111,121,307,0,0,0,5856,455,4361,176,1508,0,0,0,6500,12356
65,Salerno,70,315,5242,104,321,1,0,0,5983,491,4392,147,1698,0,0,0,6728,12711
65,Salerno,71,279,4957,100,331,0,0,0,5667,377,3982,107,1742,0,0,0,6208,11875
65,Salerno,72,252,4873,82,373,2,0,0,5582,382,3716,128,1762,0,0,0,5988,11570
65,Salerno,73,170,3518,73,306,1,0,0,4068,301,2622,79,1432,0,0,0,4434,8502
65,Salerno,74,166,3127,54,297,1,0,0,3645,262,2394,71,1517,0,0,0,4244,7889
65,Salerno,75,170,3302,48,357,1,0,0,3878,334,2434,69,1790,0,0,0,4627,8505
65,Salerno,76,150,3202,52,371,0,0,0,3775,295,2352,71,1874,0,0,0,4592,8367
65,Salerno,77,138,2917,55,364,0,0,0,3474,295,2022,57,1900,0,0,0,4274,7748
65,Salerno,78,135,3252,35,466,0,0,0,3888,314,2192,69,2333,0,0,0,4908,8796
65,Salerno,79,133,3176,42,519,1,0,0,3871,310,2094,60,2549,0,0,0,5013,8884
65,Salerno,80,118,2655,30,540,0,0,0,3343,300,1760,41,2412,0,0,0,4513,7856
65,Salerno,81,116,2480,19,495,0,0,0,3110,277,1484,55,2507,0,0,0,4323,7433
65,Salerno,82,111,2029,23,524,0,0,0,2687,229,1304,43,2391,0,0,0,3967,6654
65,Salerno,83,99,2056,16,603,0,0,0,2774,238,1147,38,2575,0,0,0,3998,6772
65,Salerno,84,89,1706,15,515,0,0,0,2325,254,994,28,2452,0,0,0,3728,6053
65,Salerno,85,74,1605,19,549,0,0,0,2247,240,778,25,2476,0,0,0,3519,5766
65,Salerno,86,79,1288,7,527,0,0,0,1901,199,602,29,2256,0,0,0,3086,4987
65,Salerno,87,65,1098,5,519,0,0,0,1687,166,535,23,2030,0,0,0,2754,4441
65,Salerno,88,61,933,4,479,0,0,0,1477,210,455,19,2080,0,0,0,2764,4241
65,Salerno,89,33,702,4,415,0,0,0,1154,161,291,20,1789,0,0,0,2261,3415
65,Salerno,90,32,507,5,354,0,0,0,898,138,214,10,1557,0,0,0,1919,2817
65,Salerno,91,29,389,2,304,0,0,0,724,114,121,6,1277,0,0,0,1518,2242
65,Salerno,92,20,231,5,242,0,0,0,498,106,114,10,1013,0,0,0,1243,1741
65,Salerno,93,24,161,1,186,0,0,0,372,75,74,7,858,0,0,0,1014,1386
65,Salerno,94,9,127,1,146,0,0,0,283,70,49,3,697,0,0,0,819,1102
65,Salerno,95,5,90,2,126,0,0,0,223,53,28,3,509,0,0,0,593,816
65,Salerno,96,2,47,1,95,0,0,0,145,40,20,1,379,0,0,0,440,585
65,Salerno,97,6,24,0,47,0,0,0,77,33,14,1,312,0,0,0,360,437
65,Salerno,98,5,31,0,41,0,0,0,77,16,10,0,179,0,0,0,205,282
65,Salerno,99,2,4,0,17,0,0,0,23,6,3,0,73,0,0,0,82,105
65,Salerno,100,6,16,1,28,0,0,0,51,16,9,0,133,0,0,0,158,209
66,L'Aquila,0,1043,0,0,0,0,0,0,1043,994,0,0,0,0,0,0,994,2037
66,L'Aquila,1,1093,0,0,0,0,0,0,1093,1029,0,0,0,0,0,0,1029,2122
66,L'Aquila,2,1173,0,0,0,0,0,0,1173,1036,0,0,0,0,0,0,1036,2209
66,L'Aquila,3,1213,0,0,0,0,0,0,1213,1122,0,0,0,0,0,0,1122,2335
66,L'Aquila,4,1172,0,0,0,0,0,0,1172,1113,0,0,0,0,0,0,1113,2285
66,L'Aquila,5,1220,0,0,0,0,0,0,1220,1106,0,0,0,0,0,0,1106,2326
66,L'Aquila,6,1286,0,0,0,0,0,0,1286,1259,0,0,0,0,0,0,1259,2545
66,L'Aquila,7,1303,0,0,0,0,0,0,1303,1194,0,0,0,0,0,0,1194,2497
66,L'Aquila,8,1290,0,0,0,0,0,0,1290,1260,0,0,0,0,0,0,1260,2550
66,L'Aquila,9,1287,0,0,0,0,0,0,1287,1201,0,0,0,0,0,0,1201,2488
66,L'Aquila,10,1323,0,0,0,0,0,0,1323,1184,0,0,0,0,0,0,1184,2507
66,L'Aquila,11,1260,0,0,0,0,0,0,1260,1180,0,0,0,0,0,0,1180,2440
66,L'Aquila,12,1246,0,0,0,0,0,0,1246,1147,0,0,0,0,0,0,1147,2393
66,L'Aquila,13,1234,0,0,0,0,0,0,1234,1257,0,0,0,0,0,0,1257,2491
66,L'Aquila,14,1349,0,0,0,0,0,0,1349,1177,0,0,0,0,0,0,1177,2526
66,L'Aquila,15,1310,0,0,0,0,0,0,1310,1153,0,0,0,0,0,0,1153,2463
66,L'Aquila,16,1230,0,0,0,0,0,0,1230,1155,0,0,0,0,0,0,1155,2385
66,L'Aquila,17,1311,0,0,0,0,0,0,1311,1226,0,0,0,0,0,0,1226,2537
66,L'Aquila,18,1413,0,0,0,0,0,0,1413,1230,7,0,0,0,0,0,1237,2650
66,L'Aquila,19,1448,2,0,0,0,0,0,1450,1241,14,0,0,0,0,0,1255,2705
66,L'Aquila,20,1438,3,0,0,0,0,0,1441,1264,39,0,0,0,0,0,1303,2744
66,L'Aquila,21,1379,3,1,0,0,0,0,1383,1279,39,0,1,0,0,0,1319,2702
66,L'Aquila,22,1420,7,0,0,0,0,0,1427,1300,57,0,0,1,0,0,1358,2785
66,L'Aquila,23,1469,29,0,0,0,0,0,1498,1308,82,3,0,0,0,0,1393,2891
66,L'Aquila,24,1565,36,0,0,0,0,0,1601,1326,121,1,1,0,0,0,1449,3050
66,L'Aquila,25,1574,41,0,0,0,0,0,1615,1276,142,2,2,2,0,0,1424,3039
66,L'Aquila,26,1642,66,1,0,0,0,0,1709,1352,201,0,0,0,0,0,1553,3262
66,L'Aquila,27,1635,92,2,0,1,0,0,1730,1350,276,3,1,0,0,0,1630,3360
66,L'Aquila,28,1644,156,2,0,0,0,0,1802,1216,354,6,1,1,0,0,1578,3380
66,L'Aquila,29,1627,213,1,0,1,0,0,1842,1172,418,5,3,0,0,0,1598,3440
66,L'Aquila,30,1550,243,4,0,0,0,0,1797,1104,562,6,3,0,0,0,1675,3472
66,L'Aquila,31,1437,353,3,0,0,0,0,1793,1012,612,12,1,0,1,0,1638,3431
66,L'Aquila,32,1387,456,1,1,0,0,0,1845,977,730,14,1,0,0,0,1722,3567
66,L'Aquila,33,1334,511,9,0,0,0,0,1854,913,804,25,4,0,0,0,1746,3600
66,L'Aquila,34,1236,600,9,0,0,0,0,1845,842,887,29,5,0,1,0,1764,3609
66,L'Aquila,35,1150,696,8,0,0,0,0,1854,827,895,41,5,1,0,0,1769,3623
66,L'Aquila,36,1156,783,14,0,0,0,0,1953,799,1060,24,4,0,0,0,1887,3840
66,L'Aquila,37,1074,913,24,1,0,0,0,2012,663,1113,37,10,1,0,0,1824,3836
66,L'Aquila,38,994,966,23,1,1,0,0,1985,643,1106,55,10,0,0,0,1814,3799
66,L'Aquila,39,982,1060,30,1,0,0,0,2073,650,1209,54,7,2,0,0,1922,3995
66,L'Aquila,40,986,1178,53,0,1,0,0,2218,557,1253,53,9,0,0,0,1872,4090
66,L'Aquila,41,895,1200,29,3,0,0,0,2127,568,1307,69,21,0,0,0,1965,4092
66,L'Aquila,42,921,1287,58,1,1,0,0,2268,505,1370,81,13,0,0,0,1969,4237
66,L'Aquila,43,844,1335,70,2,0,0,0,2251,552,1487,84,18,1,0,0,2142,4393
66,L'Aquila,44,790,1455,51,2,2,0,0,2300,495,1614,116,30,1,0,0,2256,4556
66,L'Aquila,45,701,1298,62,10,0,1,0,2072,483,1580,96,23,0,0,0,2182,4254
66,L'Aquila,46,657,1468,82,8,0,1,0,2216,426,1693,130,34,1,0,0,2284,4500
66,L'Aquila,47,681,1497,85,4,0,0,0,2267,415,1649,129,31,0,0,0,2224,4491
66,L'Aquila,48,635,1545,74,7,2,1,0,2264,393,1635,135,41,0,0,0,2204,4468
66,L'Aquila,49,557,1654,86,11,1,0,0,2309,373,1653,130,50,0,0,1,2207,4516
66,L'Aquila,50,529,1679,90,11,0,0,0,2309,377,1768,128,58,0,0,0,2331,4640
66,L'Aquila,51,493,1683,107,17,1,0,0,2301,333,1829,142,53,1,0,0,2358,4659
66,L'Aquila,52,493,1722,110,22,1,0,0,2348,286,1885,134,74,0,0,0,2379,4727
66,L'Aquila,53,448,1771,133,16,0,1,0,2369,282,1847,140,79,0,0,0,2348,4717
66,L'Aquila,54,437,1925,108,19,1,0,0,2490,269,1861,151,99,0,0,0,2380,4870
66,L'Aquila,55,399,1771,124,16,1,0,0,2311,281,1874,158,125,1,1,0,2440,4751
66,L'Aquila,56,359,1795,133,22,1,0,0,2310,259,1793,114,121,0,0,0,2287,4597
66,L'Aquila,57,320,1722,117,30,0,0,0,2189,252,1822,134,134,0,0,0,2342,4531
66,L'Aquila,58,326,1786,97,36,0,0,0,2245,227,1817,122,149,1,0,0,2316,4561
66,L'Aquila,59,276,1779,97,27,0,0,0,2179,239,1767,113,173,0,0,0,2292,4471
66,L'Aquila,60,270,1684,100,44,0,0,0,2098,174,1697,108,166,0,0,0,2145,4243
66,L'Aquila,61,245,1698,90,39,0,0,0,2072,201,1666,118,184,0,0,0,2169,4241
66,L'Aquila,62,222,1786,89,46,1,1,0,2145,175,1584,98,210,0,0,0,2067,4212
66,L'Aquila,63,225,1715,91,52,0,0,0,2083,178,1564,88,256,0,0,0,2086,4169
66,L'Aquila,64,203,1754,75,44,0,0,0,2076,163,1627,94,269,0,0,0,2153,4229
66,L'Aquila,65,165,1608,81,57,0,0,0,1911,127,1473,77,275,0,0,0,1952,3863
66,L'Aquila,66,157,1599,68,67,0,0,0,1891,145,1386,77,307,0,0,0,1915,3806
66,L'Aquila,67,143,1507,68,61,0,0,0,1779,121,1399,82,321,0,0,0,1923,3702
66,L'Aquila,68,139,1629,73,78,0,0,0,1919,135,1327,59,349,0,0,0,1870,3789
66,L'Aquila,69,132,1565,59,86,0,0,0,1842,138,1460,57,400,0,1,1,2057,3899
66,L'Aquila,70,148,1653,56,89,1,0,0,1947,129,1337,59,505,0,0,0,2030,3977
66,L'Aquila,71,128,1534,45,95,0,0,1,1803,154,1239,50,494,0,0,0,1937,3740
66,L'Aquila,72,117,1384,39,107,2,1,0,1650,120,1097,36,466,0,0,0,1719,3369
66,L'Aquila,73,60,1004,36,54,0,0,0,1154,80,776,29,386,0,0,0,1271,2425
66,L'Aquila,74,70,1056,32,90,0,0,0,1248,91,816,31,447,0,0,0,1385,2633
66,L'Aquila,75,78,1011,27,88,0,0,0,1204,88,779,25,490,0,0,0,1382,2586
66,L'Aquila,76,88,926,15,93,0,0,0,1122,83,699,27,515,0,0,0,1324,2446
66,L'Aquila,77,75,906,20,108,0,0,0,1109,93,662,29,534,0,0,0,1318,2427
66,L'Aquila,78,83,1022,29,141,0,0,0,1275,93,747,27,745,0,0,0,1612,2887
66,L'Aquila,79,77,950,16,138,0,0,0,1181,93,636,26,711,0,0,0,1466,2647
66,L'Aquila,80,58,832,18,132,0,0,0,1040,99,556,21,747,0,0,0,1423,2463
66,L'Aquila,81,70,815,8,153,0,0,0,1046,82,536,18,734,0,0,0,1370,2416
66,L'Aquila,82,67,681,17,142,0,0,0,907,89,404,14,732,0,0,0,1239,2146
66,L'Aquila,83,47,601,5,144,0,0,0,797,77,385,17,757,0,0,0,1236,2033
66,L'Aquila,84,43,574,7,148,0,0,0,772,76,293,12,790,0,0,0,1171,1943
66,L'Aquila,85,39,559,5,159,0,0,0,762,76,268,13,833,0,0,0,1190,1952
66,L'Aquila,86,29,453,4,128,0,0,0,614,74,212,5,768,0,0,0,1059,1673
66,L'Aquila,87,26,355,6,147,0,0,0,534,64,174,10,765,0,0,0,1013,1547
66,L'Aquila,88,29,326,2,181,0,0,0,538,83,138,6,752,0,0,0,979,1517
66,L'Aquila,89,22,251,3,145,0,0,0,421,61,110,4,634,0,0,0,809,1230
66,L'Aquila,90,13,172,0,132,0,0,0,317,57,76,7,601,0,0,0,741,1058
66,L'Aquila,91,5,146,2,131,0,0,0,284,50,57,4,540,0,0,0,651,935
66,L'Aquila,92,12,88,0,107,0,0,0,207,35,40,3,422,0,0,0,500,707
66,L'Aquila,93,3,72,1,67,0,0,0,143,32,24,4,315,0,0,0,375,518
66,L'Aquila,94,6,38,1,79,0,0,0,124,33,15,6,295,0,0,0,349,473
66,L'Aquila,95,5,29,0,41,0,0,0,75,11,17,2,241,0,0,0,271,346
66,L'Aquila,96,5,26,0,41,0,0,0,72,17,9,2,176,0,0,0,204,276
66,L'Aquila,97,0,14,0,27,0,0,0,41,11,5,0,125,0,0,0,141,182
66,L'Aquila,98,1,7,0,21,0,0,0,29,7,4,1,99,0,0,0,111,140
66,L'Aquila,99,0,7,0,7,0,0,0,14,4,2,1,34,0,0,0,41,55
66,L'Aquila,100,1,6,0,7,0,0,0,14,8,3,0,69,0,0,0,80,94
67,Teramo,0,1093,0,0,0,0,0,0,1093,1026,0,0,0,0,0,0,1026,2119
67,Teramo,1,1205,0,0,0,0,0,0,1205,1097,0,0,0,0,0,0,1097,2302
67,Teramo,2,1220,0,0,0,0,0,0,1220,1160,0,0,0,0,0,0,1160,2380
67,Teramo,3,1227,0,0,0,0,0,0,1227,1163,0,0,0,0,0,0,1163,2390
67,Teramo,4,1240,0,0,0,0,0,0,1240,1199,0,0,0,0,0,0,1199,2439
67,Teramo,5,1292,0,0,0,0,0,0,1292,1233,0,0,0,0,0,0,1233,2525
67,Teramo,6,1303,0,0,0,0,0,0,1303,1263,0,0,0,0,0,0,1263,2566
67,Teramo,7,1389,0,0,0,0,0,0,1389,1234,0,0,0,0,0,0,1234,2623
67,Teramo,8,1366,0,0,0,0,0,0,1366,1320,0,0,0,0,0,0,1320,2686
67,Teramo,9,1349,0,0,0,0,0,0,1349,1330,0,0,0,0,0,0,1330,2679
67,Teramo,10,1418,0,0,0,0,0,0,1418,1341,0,0,0,0,0,0,1341,2759
67,Teramo,11,1421,0,0,0,0,0,0,1421,1307,0,0,0,0,0,0,1307,2728
67,Teramo,12,1368,0,0,0,0,0,0,1368,1322,0,0,0,0,0,0,1322,2690
67,Teramo,13,1417,0,0,0,0,0,0,1417,1392,0,0,0,0,0,0,1392,2809
67,Teramo,14,1432,0,0,0,0,0,0,1432,1372,0,0,0,0,0,0,1372,2804
67,Teramo,15,1417,0,0,0,0,0,0,1417,1315,0,0,0,0,0,0,1315,2732
67,Teramo,16,1453,0,0,0,0,0,0,1453,1309,0,0,0,0,0,0,1309,2762
67,Teramo,17,1478,0,0,0,0,0,0,1478,1348,0,0,0,0,0,0,1348,2826
67,Teramo,18,1480,1,0,0,0,0,0,1481,1379,1,0,0,0,0,0,1380,2861
67,Teramo,19,1482,0,0,0,0,0,0,1482,1312,6,0,0,0,0,0,1318,2800
67,Teramo,20,1549,2,0,0,0,0,0,1551,1391,13,1,0,0,0,0,1405,2956
67,Teramo,21,1569,7,0,0,0,0,0,1576,1364,29,0,0,0,0,0,1393,2969
67,Teramo,22,1567,9,0,0,0,0,0,1576,1413,49,0,0,0,0,0,1462,3038
67,Teramo,23,1565,21,0,0,0,0,0,1586,1346,74,0,0,0,0,0,1420,3006
67,Teramo,24,1639,25,1,0,1,0,0,1666,1513,89,1,0,0,0,0,1603,3269
67,Teramo,25,1649,50,0,0,0,0,0,1699,1454,156,1,0,1,0,0,1612,3311
67,Teramo,26,1683,78,0,0,0,0,0,1761,1405,216,3,1,1,0,0,1626,3387
67,Teramo,27,1629,103,2,0,1,0,0,1735,1363,300,0,0,0,0,0,1663,3398
67,Teramo,28,1635,155,0,0,0,0,0,1790,1346,357,7,1,0,0,0,1711,3501
67,Teramo,29,1563,225,0,0,0,0,0,1788,1176,432,8,0,2,0,0,1618,3406
67,Teramo,30,1500,336,3,0,0,0,0,1839,1192,545,6,2,1,0,0,1746,3585
67,Teramo,31,1340,383,5,0,0,0,0,1728,1047,671,4,1,0,0,0,1723,3451
67,Teramo,32,1282,487,3,0,2,0,0,1774,954,812,18,2,1,0,0,1787,3561
67,Teramo,33,1261,570,5,1,0,0,0,1837,946,854,25,3,0,0,0,1828,3665
67,Teramo,34,1242,673,12,0,2,0,0,1929,866,925,25,1,1,0,0,1818,3747
67,Teramo,35,1180,734,10,0,0,0,0,1924,738,1060,21,3,0,0,0,1822,3746
67,Teramo,36,1061,865,15,1,0,0,0,1942,754,1098,31,9,0,0,0,1892,3834
67,Teramo,37,1018,862,16,0,4,0,0,1900,679,1138,35,9,1,0,0,1862,3762
67,Teramo,38,1009,1015,27,1,2,0,0,2054,667,1200,49,6,0,0,0,1922,3976
67,Teramo,39,921,1080,29,1,0,0,0,2031,604,1358,53,9,1,0,0,2025,4056
67,Teramo,40,900,1165,30,3,0,0,0,2098,614,1459,58,11,0,0,0,2142,4240
67,Teramo,41,873,1221,29,3,1,0,0,2127,543,1470,59,11,1,0,0,2084,4211
67,Teramo,42,822,1334,50,3,2,0,0,2211,516,1546,70,20,1,0,0,2153,4364
67,Teramo,43,802,1340,35,4,1,0,0,2182,559,1597,91,23,0,0,0,2270,4452
67,Teramo,44,783,1479,54,5,0,0,0,2321,497,1752,101,32,0,0,0,2382,4703
67,Teramo,45,727,1500,51,3,3,0,0,2284,460,1820,100,21,0,0,0,2401,4685
67,Teramo,46,766,1601,72,2,1,0,0,2442,486,1820,105,24,0,0,0,2435,4877
67,Teramo,47,679,1659,85,5,1,0,0,2429,485,1842,134,43,0,0,0,2504,4933
67,Teramo,48,628,1638,81,7,1,0,0,2355,385,1942,118,39,1,0,0,2485,4840
67,Teramo,49,643,1782,94,11,0,0,0,2530,408,2013,132,68,0,0,0,2621,5151
67,Teramo,50,604,1816,92,14,2,0,0,2528,353,1934,139,55,0,0,0,2481,5009
67,Teramo,51,559,1927,93,13,3,0,0,2595,377,1982,115,66,0,0,0,2540,5135
67,Teramo,52,513,1943,104,15,3,0,0,2578,317,2090,113,81,0,0,0,2601,5179
67,Teramo,53,412,1919,110,19,3,0,0,2463,313,2101,155,101,0,0,0,2670,5133
67,Teramo,54,440,1948,92,25,0,0,0,2505,303,2038,154,97,0,0,0,2592,5097
67,Teramo,55,354,1857,86,28,1,0,0,2326,269,1956,124,108,0,0,0,2457,4783
67,Teramo,56,321,1779,101,28,1,0,0,2230,231,1848,112,121,0,0,0,2312,4542
67,Teramo,57,292,1737,105,19,0,0,0,2153,230,1780,124,119,1,0,0,2254,4407
67,Teramo,58,263,1746,94,27,1,0,0,2131,224,1804,123,126,0,0,0,2277,4408
67,Teramo,59,278,1765,80,44,1,0,0,2168,198,1840,103,151,0,0,0,2292,4460
67,Teramo,60,241,1659,78,37,0,0,0,2015,208,1698,100,165,0,0,0,2171,4186
67,Teramo,61,243,1632,73,46,0,0,0,1994,166,1635,79,184,0,0,0,2064,4058
67,Teramo,62,202,1651,87,46,1,0,0,1987,162,1582,88,231,0,0,0,2063,4050
67,Teramo,63,191,1613,57,39,0,0,0,1900,155,1540,86,246,0,0,1,2028,3928
67,Teramo,64,175,1594,58,54,1,0,0,1882,154,1530,57,274,0,1,0,2016,3898
67,Teramo,65,172,1481,67,35,0,0,0,1755,121,1468,63,259,0,0,0,1911,3666
67,Teramo,66,148,1467,51,58,0,0,0,1724,135,1348,54,279,0,0,0,1816,3540
67,Teramo,67,140,1483,38,58,0,0,0,1719,96,1337,66,324,0,0,0,1823,3542
67,Teramo,68,121,1517,48,73,0,0,0,1759,113,1425,58,376,0,0,0,1972,3731
67,Teramo,69,123,1473,39,68,0,0,0,1703,99,1296,53,440,0,0,0,1888,3591
67,Teramo,70,132,1541,48,80,0,1,0,1802,105,1328,37,419,0,0,0,1889,3691
67,Teramo,71,118,1415,37,85,0,0,0,1655,95,1196,47,443,0,0,0,1781,3436
67,Teramo,72,118,1400,32,84,0,0,0,1634,61,1152,46,508,0,0,0,1767,3401
67,Teramo,73,72,1090,26,75,1,0,0,1264,57,960,24,456,0,0,0,1497,2761
67,Teramo,74,88,1108,26,80,0,0,0,1302,68,821,25,503,0,0,0,1417,2719
67,Teramo,75,74,1119,20,106,0,0,0,1319,52,801,27,577,0,0,0,1457,2776
67,Teramo,76,70,1040,16,89,1,0,0,1216,57,748,17,591,0,0,0,1413,2629
67,Teramo,77,73,1019,17,126,1,0,0,1236,49,713,15,641,0,0,0,1418,2654
67,Teramo,78,61,1111,10,116,0,0,0,1298,76,744,21,751,0,0,0,1592,2890
67,Teramo,79,62,1046,18,135,0,0,0,1261,59,660,11,803,0,0,0,1533,2794
67,Teramo,80,58,932,19,163,0,0,0,1172,64,613,16,819,0,0,0,1512,2684
67,Teramo,81,47,850,10,164,0,0,0,1071,57,509,16,840,0,0,0,1422,2493
67,Teramo,82,52,789,8,132,0,0,0,981,40,417,10,807,0,0,0,1274,2255
67,Teramo,83,42,717,6,174,0,0,0,939,55,409,15,847,0,0,0,1326,2265
67,Teramo,84,35,583,12,150,0,0,0,780,49,306,6,855,0,0,0,1216,1996
67,Teramo,85,39,547,5,150,2,0,0,743,54,283,8,815,0,0,0,1160,1903
67,Teramo,86,29,441,3,137,0,0,0,610,56,209,5,727,0,0,1,998,1608
67,Teramo,87,28,400,4,147,0,0,0,579,46,171,2,692,0,0,0,911,1490
67,Teramo,88,22,339,5,147,0,0,0,513,51,145,4,693,0,0,0,893,1406
67,Teramo,89,16,288,4,123,0,0,0,431,54,101,3,576,0,0,1,735,1166
67,Teramo,90,11,214,2,102,0,0,0,329,24,70,1,513,0,0,0,608,937
67,Teramo,91,15,137,2,93,0,0,0,247,25,45,2,481,0,0,0,553,800
67,Teramo,92,9,96,0,58,0,0,0,163,32,35,4,381,0,0,0,452,615
67,Teramo,93,5,70,1,63,0,0,0,139,24,27,2,307,0,0,0,360,499
67,Teramo,94,2,50,0,42,0,0,0,94,19,12,1,259,0,0,0,291,385
67,Teramo,95,3,38,1,31,0,0,0,73,13,11,0,192,0,0,0,216,289
67,Teramo,96,2,19,0,26,0,0,0,47,10,5,1,164,0,0,0,180,227
67,Teramo,97,1,16,0,20,0,0,0,37,9,2,0,103,0,0,0,114,151
67,Teramo,98,1,6,0,11,0,0,0,18,2,4,0,79,0,0,0,85,103
67,Teramo,99,0,4,0,2,0,0,0,6,4,2,0,40,0,0,0,46,52
67,Teramo,100,1,4,0,8,0,0,0,13,5,4,0,52,0,0,0,61,74
68,Pescara,0,1103,0,0,0,0,0,0,1103,1083,0,0,0,0,0,0,1083,2186
68,Pescara,1,1216,0,0,0,0,0,0,1216,1143,0,0,0,0,0,0,1143,2359
68,Pescara,2,1323,0,0,0,0,0,0,1323,1224,0,0,0,0,0,0,1224,2547
68,Pescara,3,1332,0,0,0,0,0,0,1332,1235,0,0,0,0,0,0,1235,2567
68,Pescara,4,1391,0,0,0,0,0,0,1391,1303,0,0,0,0,0,0,1303,2694
68,Pescara,5,1366,0,0,0,0,0,0,1366,1323,0,0,0,0,0,0,1323,2689
68,Pescara,6,1402,0,0,0,0,0,0,1402,1327,0,0,0,0,0,0,1327,2729
68,Pescara,7,1515,0,0,0,0,0,0,1515,1388,0,0,0,0,0,0,1388,2903
68,Pescara,8,1545,0,0,0,0,0,0,1545,1419,0,0,0,0,0,0,1419,2964
68,Pescara,9,1449,0,0,0,0,0,0,1449,1410,0,0,0,0,0,0,1410,2859
68,Pescara,10,1590,0,0,0,0,0,0,1590,1496,0,0,0,0,0,0,1496,3086
68,Pescara,11,1500,0,0,0,0,0,0,1500,1481,0,0,0,0,0,0,1481,2981
68,Pescara,12,1560,0,0,0,0,0,0,1560,1438,0,0,0,0,0,0,1438,2998
68,Pescara,13,1517,0,0,0,0,0,0,1517,1423,0,0,0,0,0,0,1423,2940
68,Pescara,14,1575,0,0,0,0,0,0,1575,1439,0,0,0,0,0,0,1439,3014
68,Pescara,15,1479,0,0,0,0,0,0,1479,1468,0,0,0,0,0,0,1468,2947
68,Pescara,16,1528,0,0,0,0,0,0,1528,1412,0,0,0,0,0,0,1412,2940
68,Pescara,17,1521,0,0,0,0,0,0,1521,1508,0,0,0,0,0,0,1508,3029
68,Pescara,18,1622,0,0,0,0,0,0,1622,1413,3,0,0,0,0,0,1416,3038
68,Pescara,19,1577,1,0,0,0,0,0,1578,1439,7,0,0,0,0,0,1446,3024
68,Pescara,20,1663,3,0,0,1,0,0,1667,1469,8,0,0,0,0,0,1477,3144
68,Pescara,21,1655,2,0,0,0,0,0,1657,1393,13,0,0,0,0,0,1406,3063
68,Pescara,22,1560,10,0,0,0,0,0,1570,1439,20,1,0,0,0,0,1460,3030
68,Pescara,23,1612,14,0,0,0,0,0,1626,1376,58,0,0,1,0,0,1435,3061
68,Pescara,24,1595,25,0,0,0,0,0,1620,1444,96,1,0,0,0,0,1541,3161
68,Pescara,25,1691,36,0,0,1,0,0,1728,1468,115,1,0,0,0,0,1584,3312
68,Pescara,26,1685,57,0,0,0,0,0,1742,1533,190,1,0,0,0,0,1724,3466
68,Pescara,27,1617,116,1,0,0,0,0,1734,1435,241,1,0,0,0,0,1677,3411
68,Pescara,28,1543,160,1,0,0,0,0,1704,1320,335,3,0,1,0,0,1659,3363
68,Pescara,29,1510,219,1,0,1,0,0,1731,1227,410,7,2,0,0,0,1646,3377
68,Pescara,30,1449,284,2,0,0,0,0,1735,1190,507,9,0,0,0,0,1706,3441
68,Pescara,31,1308,380,2,1,0,0,0,1691,1110,667,10,2,1,0,0,1790,3481
68,Pescara,32,1323,427,5,0,1,0,0,1756,999,749,21,1,1,0,0,1771,3527
68,Pescara,33,1230,549,4,0,0,0,0,1783,920,755,26,3,0,0,0,1704,3487
68,Pescara,34,1127,699,15,0,0,0,0,1841,860,957,40,2,1,0,0,1860,3701
68,Pescara,35,1059,706,19,0,0,0,0,1784,803,998,24,2,0,0,0,1827,3611
68,Pescara,36,975,773,22,2,1,0,0,1773,782,1148,54,6,0,0,0,1990,3763
68,Pescara,37,929,877,18,2,1,0,0,1827,683,1246,62,9,0,0,0,2000,3827
68,Pescara,38,933,975,26,1,1,0,0,1936,621,1240,60,15,0,0,0,1936,3872
68,Pescara,39,901,1078,51,5,0,0,0,2035,609,1344,103,8,1,0,0,2065,4100
68,Pescara,40,876,1168,52,2,1,0,0,2099,560,1503,93,7,1,0,0,2164,4263
68,Pescara,41,895,1191,49,4,0,0,0,2139,560,1522,96,15,1,0,0,2194,4333
68,Pescara,42,880,1308,49,4,0,0,0,2241,589,1652,113,21,1,0,0,2376,4617
68,Pescara,43,768,1397,74,7,2,0,0,2248,554,1713,130,22,0,0,0,2419,4667
68,Pescara,44,860,1603,86,7,1,0,0,2557,505,1764,126,25,0,0,0,2420,4977
68,Pescara,45,746,1655,86,5,0,0,0,2492,492,1878,171,34,1,0,0,2576,5068
68,Pescara,46,705,1711,97,3,0,0,0,2516,479,1976,176,33,1,0,0,2665,5181
68,Pescara,47,668,1704,111,9,1,0,0,2493,496,2042,162,37,1,0,0,2738,5231
68,Pescara,48,636,1798,102,13,1,0,0,2550,405,2019,151,41,0,0,0,2616,5166
68,Pescara,49,615,1887,120,11,1,0,0,2634,439,2060,220,63,2,0,0,2784,5418
68,Pescara,50,553,1820,146,13,1,0,0,2533,405,2049,192,60,0,0,0,2706,5239
68,Pescara,51,509,1807,130,14,0,0,0,2460,386,2070,170,67,2,0,0,2695,5155
68,Pescara,52,469,1972,105,18,1,0,0,2565,356,2114,199,87,0,0,0,2756,5321
68,Pescara,53,494,1936,171,33,1,0,0,2635,313,2068,202,80,2,0,0,2665,5300
68,Pescara,54,433,2050,159,28,0,0,0,2670,302,2113,195,109,0,0,0,2719,5389
68,Pescara,55,353,1988,143,27,1,0,0,2512,277,1977,186,111,0,0,0,2551,5063
68,Pescara,56,359,1793,147,27,0,0,0,2326,272,1960,168,123,0,0,0,2523,4849
68,Pescara,57,302,1765,125,28,1,0,0,2221,258,1865,167,138,0,0,0,2428,4649
68,Pescara,58,251,1705,125,33,0,0,0,2114,230,1767,172,157,1,0,0,2327,4441
68,Pescara,59,234,1694,121,36,0,0,0,2085,185,1769,165,160,1,0,0,2280,4365
68,Pescara,60,218,1646,99,24,0,0,0,1987,205,1667,146,164,1,0,0,2183,4170
68,Pescara,61,184,1661,107,46,0,0,0,1998,184,1719,128,174,0,0,0,2205,4203
68,Pescara,62,170,1602,95,29,0,0,0,1896,163,1609,102,221,0,0,0,2095,3991
68,Pescara,63,169,1595,87,43,0,0,0,1894,188,1650,127,207,0,0,0,2172,4066
68,Pescara,64,173,1510,78,52,1,0,0,1814,144,1512,103,269,1,0,0,2029,3843
68,Pescara,65,134,1449,64,44,0,0,0,1691,152,1432,111,237,1,0,0,1933,3624
68,Pescara,66,127,1405,60,43,0,0,0,1635,144,1357,121,306,1,0,0,1929,3564
68,Pescara,67,102,1446,64,51,0,0,0,1663,128,1510,101,315,0,0,0,2054,3717
68,Pescara,68,86,1485,59,56,0,0,0,1686,122,1499,79,342,0,0,0,2042,3728
68,Pescara,69,115,1506,59,62,1,0,0,1743,114,1428,89,384,0,0,0,2015,3758
68,Pescara,70,110,1530,51,78,0,0,0,1769,137,1380,68,494,0,0,0,2079,3848
68,Pescara,71,110,1482,54,83,0,0,0,1729,90,1365,82,474,0,0,0,2011,3740
68,Pescara,72,91,1483,38,82,0,0,0,1694,103,1295,56,494,0,0,0,1948,3642
68,Pescara,73,62,1083,29,67,0,0,0,1241,72,911,61,421,0,0,0,1465,2706
68,Pescara,74,77,1178,40,90,0,0,0,1385,79,984,47,507,0,0,0,1617,3002
68,Pescara,75,71,1096,28,79,0,0,0,1274,74,892,47,564,0,0,0,1577,2851
68,Pescara,76,58,1037,22,110,0,0,0,1227,79,867,45,551,0,0,0,1542,2769
68,Pescara,77,61,1000,20,106,0,0,0,1187,86,792,34,587,0,0,0,1499,2686
68,Pescara,78,59,1097,28,128,1,0,0,1313,85,873,36,727,0,0,0,1721,3034
68,Pescara,79,53,1076,38,149,0,0,0,1316,98,809,37,858,0,0,0,1802,3118
68,Pescara,80,44,944,21,169,0,0,0,1178,93,605,24,764,0,0,0,1486,2664
68,Pescara,81,48,922,18,147,0,0,0,1135,83,554,18,806,0,0,0,1461,2596
68,Pescara,82,30,824,10,149,0,0,0,1013,93,463,26,810,0,0,0,1392,2405
68,Pescara,83,31,771,12,144,0,0,0,958,78,425,17,813,0,0,0,1333,2291
68,Pescara,84,29,673,4,162,0,0,0,868,73,348,14,832,0,0,0,1267,2135
68,Pescara,85,34,542,11,150,0,0,0,737,69,305,17,814,0,0,0,1205,1942
68,Pescara,86,26,475,8,158,0,0,0,667,67,251,7,734,0,0,0,1059,1726
68,Pescara,87,12,401,4,138,0,0,0,555,63,210,8,758,0,0,0,1039,1594
68,Pescara,88,19,355,4,118,0,0,0,496,76,178,9,699,0,0,0,962,1458
68,Pescara,89,8,268,5,95,0,0,0,376,52,109,5,637,0,0,0,803,1179
68,Pescara,90,10,223,3,99,0,0,0,335,34,100,6,529,0,0,0,669,1004
68,Pescara,91,11,162,1,89,0,0,0,263,47,66,4,471,0,0,0,588,851
68,Pescara,92,5,109,1,80,0,0,0,195,34,54,5,373,0,0,0,466,661
68,Pescara,93,6,94,1,74,0,0,0,175,33,42,1,329,0,0,0,405,580
68,Pescara,94,3,59,1,59,0,0,0,122,21,19,1,257,0,0,0,298,420
68,Pescara,95,4,36,0,36,0,0,0,76,22,17,1,187,0,0,0,227,303
68,Pescara,96,1,24,0,23,0,0,0,48,12,10,0,154,0,0,0,176,224
68,Pescara,97,1,21,0,35,0,0,0,57,7,3,0,104,0,0,0,114,171
68,Pescara,98,3,10,0,13,0,0,0,26,8,7,0,75,0,0,0,90,116
68,Pescara,99,0,2,0,5,0,0,0,7,3,2,0,37,0,0,0,42,49
68,Pescara,100,4,6,0,9,0,0,0,19,3,4,0,70,0,0,0,77,96
69,Chieti,0,1301,0,0,0,0,0,0,1301,1228,0,0,0,0,0,0,1228,2529
69,Chieti,1,1387,0,0,0,0,0,0,1387,1324,0,0,0,0,0,0,1324,2711
69,Chieti,2,1449,0,0,0,0,0,0,1449,1418,0,0,0,0,0,0,1418,2867
69,Chieti,3,1490,0,0,0,0,0,0,1490,1421,0,0,0,0,0,0,1421,2911
69,Chieti,4,1530,0,0,0,0,0,0,1530,1427,0,0,0,0,0,0,1427,2957
69,Chieti,5,1573,0,0,0,0,0,0,1573,1446,0,0,0,0,0,0,1446,3019
69,Chieti,6,1674,0,0,0,0,0,0,1674,1548,0,0,0,0,0,0,1548,3222
69,Chieti,7,1693,0,0,0,0,0,0,1693,1557,0,0,0,0,0,0,1557,3250
69,Chieti,8,1752,0,0,0,0,0,0,1752,1679,0,0,0,0,0,0,1679,3431
69,Chieti,9,1775,0,0,0,0,0,0,1775,1596,0,0,0,0,0,0,1596,3371
69,Chieti,10,1739,0,0,0,0,0,0,1739,1701,0,0,0,0,0,0,1701,3440
69,Chieti,11,1734,0,0,0,0,0,0,1734,1704,0,0,0,0,0,0,1704,3438
69,Chieti,12,1752,0,0,0,0,0,0,1752,1634,0,0,0,0,0,0,1634,3386
69,Chieti,13,1742,0,0,0,0,0,0,1742,1613,0,0,0,0,0,0,1613,3355
69,Chieti,14,1692,0,0,0,0,0,0,1692,1589,0,0,0,0,0,0,1589,3281
69,Chieti,15,1779,0,0,0,0,0,0,1779,1640,0,0,0,0,0,0,1640,3419
69,Chieti,16,1724,0,0,0,0,0,0,1724,1609,0,0,0,0,0,0,1609,3333
69,Chieti,17,1766,0,0,0,0,0,0,1766,1658,0,0,0,0,0,0,1658,3424
69,Chieti,18,1908,0,0,0,0,0,0,1908,1642,1,0,0,0,0,0,1643,3551
69,Chieti,19,1856,2,0,0,0,0,0,1858,1733,11,0,0,0,0,0,1744,3602
69,Chieti,20,1852,5,0,0,0,0,0,1857,1732,14,0,0,0,0,0,1746,3603
69,Chieti,21,1968,0,0,0,0,0,0,1968,1712,24,0,0,0,0,0,1736,3704
69,Chieti,22,1991,10,0,0,0,0,0,2001,1790,41,0,0,0,0,0,1831,3832
69,Chieti,23,1922,18,0,0,0,0,0,1940,1672,85,0,0,0,0,0,1757,3697
69,Chieti,24,1891,29,0,0,1,0,0,1921,1676,109,2,0,0,0,0,1787,3708
69,Chieti,25,2005,45,0,0,0,0,0,2050,1758,161,0,0,0,0,0,1919,3969
69,Chieti,26,1993,79,0,0,0,0,0,2072,1747,227,3,0,0,0,0,1977,4049
69,Chieti,27,1964,98,0,0,0,0,0,2062,1553,332,7,0,1,0,0,1893,3955
69,Chieti,28,1943,157,0,0,0,0,0,2100,1643,440,9,1,0,0,0,2093,4193
69,Chieti,29,1824,291,2,0,1,0,0,2118,1532,580,16,0,0,0,0,2128,4246
69,Chieti,30,1777,366,8,0,0,0,0,2151,1365,723,16,1,0,0,0,2105,4256
69,Chieti,31,1606,458,1,1,0,0,0,2066,1163,839,16,4,1,0,0,2023,4089
69,Chieti,32,1584,583,6,1,0,0,0,2174,1083,934,15,5,1,0,0,2038,4212
69,Chieti,33,1470,763,10,0,0,0,0,2243,1127,1118,22,1,2,0,0,2270,4513
69,Chieti,34,1422,859,16,1,0,0,0,2298,961,1165,36,4,0,0,0,2166,4464
69,Chieti,35,1342,926,17,2,0,0,0,2287,886,1285,36,5,0,0,0,2212,4499
69,Chieti,36,1307,1094,38,2,0,0,0,2441,835,1452,51,4,1,0,0,2343,4784
69,Chieti,37,1224,1107,28,1,1,0,0,2361,796,1423,58,7,1,0,0,2285,4646
69,Chieti,38,1177,1236,24,2,1,0,0,2440,736,1581,80,16,1,0,0,2414,4854
69,Chieti,39,1142,1397,34,2,1,0,0,2576,671,1710,51,15,1,0,0,2448,5024
69,Chieti,40,1065,1541,48,2,2,0,0,2658,678,1803,85,11,0,0,0,2577,5235
69,Chieti,41,1078,1545,56,4,1,0,0,2684,646,1834,96,18,1,0,0,2595,5279
69,Chieti,42,1001,1678,74,1,0,0,0,2754,650,2029,114,19,0,0,0,2812,5566
69,Chieti,43,962,1741,78,11,0,0,0,2792,593,2146,137,24,0,0,0,2900,5692
69,Chieti,44,963,1884,92,4,0,0,0,2943,554,2167,131,40,0,0,0,2892,5835
69,Chieti,45,862,1931,101,10,0,0,0,2904,521,2233,119,38,0,0,0,2911,5815
69,Chieti,46,764,2012,86,14,1,0,0,2877,517,2226,158,45,0,0,0,2946,5823
69,Chieti,47,756,2080,100,8,0,0,0,2944,487,2453,155,54,1,0,0,3150,6094
69,Chieti,48,696,2022,105,8,0,0,0,2831,414,2408,174,59,0,0,0,3055,5886
69,Chieti,49,663,2218,134,12,1,0,0,3028,413,2439,173,47,0,0,0,3072,6100
69,Chieti,50,601,2298,116,11,0,0,0,3026,368,2522,186,69,0,0,0,3145,6171
69,Chieti,51,517,2364,134,15,1,0,0,3031,376,2610,198,83,0,0,0,3267,6298
69,Chieti,52,496,2375,137,24,0,0,0,3032,355,2468,181,115,0,0,0,3119,6151
69,Chieti,53,460,2451,137,29,0,0,0,3077,305,2604,151,119,0,0,0,3179,6256
69,Chieti,54,484,2375,141,31,1,0,0,3032,317,2537,180,106,0,1,0,3141,6173
69,Chieti,55,391,2216,142,34,1,0,0,2784,267,2332,162,133,0,0,0,2894,5678
69,Chieti,56,358,2161,121,34,1,0,0,2675,230,2320,158,163,0,0,0,2871,5546
69,Chieti,57,340,2113,132,33,0,0,0,2618,269,2386,144,177,1,0,0,2977,5595
69,Chieti,58,314,2159,117,30,1,0,0,2621,229,2315,157,182,0,0,0,2883,5504
69,Chieti,59,270,2087,122,39,0,0,0,2518,203,2250,142,206,0,0,0,2801,5319
69,Chieti,60,285,2060,118,50,0,0,0,2513,201,2203,130,216,0,0,0,2750,5263
69,Chieti,61,250,2056,93,44,0,0,0,2443,208,2137,112,250,0,0,0,2707,5150
69,Chieti,62,218,2108,116,45,0,0,0,2487,160,2108,102,274,0,0,0,2644,5131
69,Chieti,63,219,2049,100,60,0,0,0,2428,155,2170,97,307,0,0,0,2729,5157
69,Chieti,64,230,1986,82,69,0,0,0,2367,142,2042,79,354,0,0,0,2617,4984
69,Chieti,65,179,1983,83,43,1,0,0,2289,149,1903,93,361,0,0,0,2506,4795
69,Chieti,66,196,1972,73,76,0,0,0,2317,116,1912,78,418,0,0,0,2524,4841
69,Chieti,67,157,1975,66,75,0,0,0,2273,131,1861,70,455,0,0,0,2517,4790
69,Chieti,68,172,2144,71,79,0,0,0,2466,124,1896,79,486,0,0,0,2585,5051
69,Chieti,69,173,2238,70,94,0,0,0,2575,130,1883,54,582,0,0,0,2649,5224
69,Chieti,70,153,2047,46,92,0,0,0,2338,121,1939,72,645,0,0,0,2777,5115
69,Chieti,71,121,2011,67,115,0,0,0,2314,98,1621,55,653,0,0,0,2427,4741
69,Chieti,72,127,2000,43,112,1,0,0,2283,95,1564,47,730,0,0,0,2436,4719
69,Chieti,73,95,1386,29,83,1,0,0,1594,84,1120,36,578,0,0,0,1818,3412
69,Chieti,74,91,1545,23,127,0,0,0,1786,82,1102,40,736,0,0,0,1960,3746
69,Chieti,75,73,1307,33,114,1,0,0,1528,90,1024,29,678,0,0,0,1821,3349
69,Chieti,76,83,1299,28,128,0,0,0,1538,78,883,27,739,0,0,0,1727,3265
69,Chieti,77,82,1334,15,141,0,0,0,1572,64,882,31,783,0,0,0,1760,3332
69,Chieti,78,91,1422,16,198,0,0,0,1727,104,943,23,925,0,0,0,1995,3722
69,Chieti,79,77,1439,32,169,0,0,0,1717,87,894,26,1099,0,0,0,2106,3823
69,Chieti,80,67,1237,24,192,0,0,0,1520,85,692,18,985,0,0,0,1780,3300
69,Chieti,81,55,1155,15,183,0,0,0,1408,73,627,20,1061,0,0,0,1781,3189
69,Chieti,82,61,994,17,166,0,0,0,1238,81,565,15,1071,0,0,0,1732,2970
69,Chieti,83,54,966,16,197,0,0,0,1233,95,492,13,1103,0,0,0,1703,2936
69,Chieti,84,42,807,3,217,0,0,0,1069,64,423,10,1089,0,0,0,1586,2655
69,Chieti,85,31,760,4,231,0,0,0,1026,74,352,13,1123,0,0,0,1562,2588
69,Chieti,86,35,617,9,208,0,0,0,869,58,260,11,953,0,0,0,1282,2151
69,Chieti,87,28,545,6,195,0,0,0,774,86,200,12,962,0,0,0,1260,2034
69,Chieti,88,23,466,5,224,0,0,0,718,59,186,10,1036,0,0,0,1291,2009
69,Chieti,89,9,339,3,150,0,0,0,501,58,122,9,777,0,0,0,966,1467
69,Chieti,90,13,236,4,149,0,0,0,402,59,112,5,709,0,0,0,885,1287
69,Chieti,91,15,199,0,129,0,0,0,343,50,71,4,684,0,0,0,809,1152
69,Chieti,92,7,131,3,120,0,0,0,261,38,41,0,540,0,0,0,619,880
69,Chieti,93,8,83,1,111,0,0,0,203,40,32,2,423,0,0,0,497,700
69,Chieti,94,4,69,0,76,0,0,0,149,32,28,3,302,0,0,0,365,514
69,Chieti,95,4,47,0,69,0,0,0,120,14,11,1,278,0,0,0,304,424
69,Chieti,96,0,27,1,37,0,0,0,65,20,9,3,198,0,0,0,230,295
69,Chieti,97,2,25,1,41,0,0,0,69,15,4,1,176,0,0,0,196,265
69,Chieti,98,1,20,0,17,0,0,0,38,5,3,0,95,0,0,0,103,141
69,Chieti,99,0,0,0,17,0,0,0,17,9,0,0,53,0,0,0,62,79
69,Chieti,100,0,6,0,18,0,0,0,24,6,4,0,98,0,0,0,108,132
70,Campobasso,0,671,0,0,0,0,0,0,671,637,0,0,0,0,0,0,637,1308
70,Campobasso,1,803,0,0,0,0,0,0,803,715,0,0,0,0,0,0,715,1518
70,Campobasso,2,762,0,0,0,0,0,0,762,718,0,0,0,0,0,0,718,1480
70,Campobasso,3,787,0,0,0,0,0,0,787,749,0,0,0,0,0,0,749,1536
70,Campobasso,4,850,0,0,0,0,0,0,850,724,0,0,0,0,0,0,724,1574
70,Campobasso,5,814,0,0,0,0,0,0,814,787,0,0,0,0,0,0,787,1601
70,Campobasso,6,861,0,0,0,0,0,0,861,785,0,0,0,0,0,0,785,1646
70,Campobasso,7,857,0,0,0,0,0,0,857,852,0,0,0,0,0,0,852,1709
70,Campobasso,8,947,0,0,0,0,0,0,947,859,0,0,0,0,0,0,859,1806
70,Campobasso,9,860,0,0,0,0,0,0,860,810,0,0,0,0,0,0,810,1670
70,Campobasso,10,968,0,0,0,0,0,0,968,885,0,0,0,0,0,0,885,1853
70,Campobasso,11,945,0,0,0,0,0,0,945,894,0,0,0,0,0,0,894,1839
70,Campobasso,12,943,0,0,0,0,0,0,943,892,0,0,0,0,0,0,892,1835
70,Campobasso,13,1014,0,0,0,0,0,0,1014,882,0,0,0,0,0,0,882,1896
70,Campobasso,14,1041,0,0,0,0,0,0,1041,902,0,0,0,0,0,0,902,1943
70,Campobasso,15,1017,0,0,0,0,0,0,1017,969,0,0,0,0,0,0,969,1986
70,Campobasso,16,1011,0,0,0,0,0,0,1011,974,0,0,0,0,0,0,974,1985
70,Campobasso,17,1046,1,0,0,0,0,0,1047,985,0,0,0,0,0,0,985,2032
70,Campobasso,18,1096,0,0,0,0,0,0,1096,1052,3,0,0,0,0,0,1055,2151
70,Campobasso,19,1226,0,0,0,0,0,0,1226,1054,4,0,0,0,0,0,1058,2284
70,Campobasso,20,1312,3,0,0,0,0,0,1315,1034,18,0,0,0,0,0,1052,2367
70,Campobasso,21,1280,5,0,0,0,0,0,1285,1050,10,0,0,0,0,0,1060,2345
70,Campobasso,22,1208,9,0,0,0,0,0,1217,1078,24,0,0,0,0,0,1102,2319
70,Campobasso,23,1252,18,0,0,0,0,0,1270,1097,33,0,0,0,0,0,1130,2400
70,Campobasso,24,1268,24,1,0,0,0,0,1293,1060,69,0,0,0,0,0,1129,2422
70,Campobasso,25,1280,31,0,0,0,0,0,1311,1073,93,0,1,0,0,0,1167,2478
70,Campobasso,26,1324,50,3,0,0,0,0,1377,1089,128,0,0,0,0,0,1217,2594
70,Campobasso,27,1317,62,1,0,0,0,0,1380,973,179,2,0,0,0,0,1154,2534
70,Campobasso,28,1208,103,0,0,0,0,0,1311,929,264,7,0,0,0,0,1200,2511
70,Campobasso,29,1167,139,0,0,0,0,0,1306,902,278,7,1,0,0,0,1188,2494
70,Campobasso,30,1049,221,1,0,1,0,0,1272,819,382,7,1,0,0,0,1209,2481
70,Campobasso,31,1108,249,4,1,0,0,0,1362,688,450,12,3,0,0,0,1153,2515
70,Campobasso,32,961,302,1,0,0,0,0,1264,646,464,4,2,0,0,0,1116,2380
70,Campobasso,33,932,349,4,0,0,0,0,1285,597,620,10,2,1,0,0,1230,2515
70,Campobasso,34,818,448,14,0,0,0,0,1280,570,653,13,0,0,0,0,1236,2516
70,Campobasso,35,818,513,6,0,0,0,0,1337,510,699,20,3,0,0,0,1232,2569
70,Campobasso,36,769,558,9,0,0,0,0,1336,490,785,25,5,0,1,0,1306,2642
70,Campobasso,37,733,609,7,0,0,0,0,1349,430,818,33,6,0,0,0,1287,2636
70,Campobasso,38,678,637,16,0,0,0,0,1331,402,857,32,4,0,0,0,1295,2626
70,Campobasso,39,633,754,20,0,0,0,0,1407,378,974,44,6,0,0,0,1402,2809
70,Campobasso,40,624,793,27,1,1,0,0,1446,350,1014,34,9,0,0,0,1407,2853
70,Campobasso,41,576,848,23,3,0,0,0,1450,363,1071,34,16,0,0,0,1484,2934
70,Campobasso,42,539,980,35,3,1,0,0,1558,331,1006,44,18,0,0,0,1399,2957
70,Campobasso,43,590,999,38,4,0,0,0,1631,349,1195,66,12,0,0,0,1622,3253
70,Campobasso,44,515,1099,36,2,0,0,0,1652,303,1282,49,12,0,0,0,1646,3298
70,Campobasso,45,509,1023,35,7,0,0,0,1574,251,1263,78,18,0,0,0,1610,3184
70,Campobasso,46,450,1157,38,3,0,0,0,1648,290,1284,54,18,0,0,0,1646,3294
70,Campobasso,47,432,1131,51,8,1,0,0,1623,217,1258,64,27,0,0,0,1566,3189
70,Campobasso,48,373,1229,54,8,0,0,0,1664,229,1314,74,39,0,0,0,1656,3320
70,Campobasso,49,386,1279,64,12,0,0,0,1741,241,1388,87,49,0,0,0,1765,3506
70,Campobasso,50,384,1263,55,10,0,0,0,1712,237,1376,71,49,0,0,0,1733,3445
70,Campobasso,51,321,1319,57,10,1,0,0,1708,204,1472,81,50,0,0,0,1807,3515
70,Campobasso,52,300,1356,59,11,0,0,0,1726,204,1508,82,63,0,0,0,1857,3583
70,Campobasso,53,287,1417,70,8,1,0,0,1783,203,1456,69,76,0,0,0,1804,3587
70,Campobasso,54,318,1448,60,17,0,0,0,1843,184,1487,79,84,0,0,0,1834,3677
70,Campobasso,55,279,1359,63,18,0,0,0,1719,151,1376,69,90,0,0,0,1686,3405
70,Campobasso,56,213,1365,58,19,0,0,0,1655,151,1399,53,103,0,0,0,1706,3361
70,Campobasso,57,213,1407,53,33,0,0,0,1706,145,1324,72,111,0,0,0,1652,3358
70,Campobasso,58,214,1370,62,19,0,0,0,1665,154,1347,68,133,0,0,0,1702,3367
70,Campobasso,59,174,1271,64,26,0,0,0,1535,148,1329,55,136,0,0,0,1668,3203
70,Campobasso,60,164,1179,47,26,0,0,0,1416,131,1292,69,148,0,0,0,1640,3056
70,Campobasso,61,155,1242,44,26,0,0,0,1467,120,1201,52,165,0,0,0,1538,3005
70,Campobasso,62,150,1253,41,35,0,0,0,1479,104,1200,37,173,0,0,0,1514,2993
70,Campobasso,63,137,1241,41,50,1,0,0,1470,108,1157,50,195,0,0,0,1510,2980
70,Campobasso,64,140,1179,43,38,0,0,0,1400,104,1194,52,215,0,0,0,1565,2965
70,Campobasso,65,99,1147,36,29,0,0,0,1311,95,1037,36,188,0,0,0,1356,2667
70,Campobasso,66,110,1189,27,39,0,0,0,1365,101,1113,33,233,0,0,0,1480,2845
70,Campobasso,67,79,1124,34,46,0,0,0,1283,96,1002,33,225,0,0,0,1356,2639
70,Campobasso,68,78,1228,41,52,0,0,0,1399,88,1044,24,291,0,0,0,1447,2846
70,Campobasso,69,95,1252,28,57,0,0,0,1432,85,1041,23,350,0,0,0,1499,2931
70,Campobasso,70,84,1228,25,57,0,0,0,1394,96,993,33,351,0,0,0,1473,2867
70,Campobasso,71,91,1089,27,57,0,0,0,1264,86,898,20,386,0,0,0,1390,2654
70,Campobasso,72,82,1076,20,59,0,0,0,1237,85,820,23,351,0,0,0,1279,2516
70,Campobasso,73,49,786,25,56,0,0,0,916,57,639,10,343,0,0,0,1049,1965
70,Campobasso,74,31,793,10,68,0,0,0,902,52,578,10,368,0,0,0,1008,1910
70,Campobasso,75,49,718,12,68,0,0,0,847,59,535,12,365,0,0,0,971,1818
70,Campobasso,76,38,670,9,55,0,0,0,772,45,470,16,391,0,0,0,922,1694
70,Campobasso,77,37,690,8,103,0,0,0,838,52,531,13,450,0,0,0,1046,1884
70,Campobasso,78,56,775,8,92,0,0,0,931,76,552,13,563,0,0,0,1204,2135
70,Campobasso,79,52,789,10,115,0,0,0,966,85,552,11,631,0,0,0,1279,2245
70,Campobasso,80,33,689,4,100,0,0,0,826,49,405,6,576,0,0,0,1036,1862
70,Campobasso,81,30,591,6,149,0,0,0,776,67,413,8,599,0,0,0,1087,1863
70,Campobasso,82,35,543,4,119,0,0,0,701,76,377,14,609,0,0,0,1076,1777
70,Campobasso,83,26,498,7,135,0,0,0,666,49,305,6,693,0,0,0,1053,1719
70,Campobasso,84,34,504,2,142,0,0,0,682,74,307,6,611,0,0,0,998,1680
70,Campobasso,85,20,423,4,122,0,0,0,569,69,211,9,633,0,0,0,922,1491
70,Campobasso,86,19,350,0,121,0,0,0,490,53,179,5,573,0,0,0,810,1300
70,Campobasso,87,14,289,3,123,0,0,0,429,57,155,6,530,0,0,0,748,1177
70,Campobasso,88,15,246,4,116,0,0,0,381,62,125,5,612,0,0,0,804,1185
70,Campobasso,89,16,196,0,105,0,0,0,317,41,79,1,486,0,0,0,607,924
70,Campobasso,90,5,136,0,80,0,0,0,221,42,76,4,418,0,0,0,540,761
70,Campobasso,91,6,115,1,83,0,0,0,205,34,68,1,404,0,0,0,507,712
70,Campobasso,92,6,84,2,57,0,0,0,149,34,41,3,326,0,0,0,404,553
70,Campobasso,93,2,58,0,58,0,0,0,118,15,23,3,240,0,0,0,281,399
70,Campobasso,94,2,39,0,48,0,0,0,89,19,16,0,200,0,0,0,235,324
70,Campobasso,95,2,24,0,33,0,0,0,59,15,14,1,146,0,0,0,176,235
70,Campobasso,96,0,18,0,31,0,0,0,49,9,10,0,132,0,0,0,151,200
70,Campobasso,97,2,18,0,20,0,0,0,40,7,8,0,96,0,0,0,111,151
70,Campobasso,98,0,6,0,14,0,0,0,20,5,6,1,70,0,0,0,82,102
70,Campobasso,99,0,9,0,2,0,0,0,11,2,2,0,28,0,0,0,32,43
70,Campobasso,100,0,4,0,12,0,0,0,16,3,3,0,49,0,0,0,55,71
71,Foggia,0,2378,0,0,0,0,0,0,2378,2214,0,0,0,0,0,0,2214,4592
71,Foggia,1,2406,0,0,0,0,0,0,2406,2366,0,0,0,0,0,0,2366,4772
71,Foggia,2,2611,0,0,0,0,0,0,2611,2414,0,0,0,0,0,0,2414,5025
71,Foggia,3,2674,0,0,0,0,0,0,2674,2516,0,0,0,0,0,0,2516,5190
71,Foggia,4,2742,0,0,0,0,0,0,2742,2555,0,0,0,0,0,0,2555,5297
71,Foggia,5,2798,0,0,0,0,0,0,2798,2622,0,0,0,0,0,0,2622,5420
71,Foggia,6,2830,0,0,0,0,0,0,2830,2667,0,0,0,0,0,0,2667,5497
71,Foggia,7,2875,0,0,0,0,0,0,2875,2790,0,0,0,0,0,0,2790,5665
71,Foggia,8,3077,0,0,0,0,0,0,3077,2858,0,0,0,0,0,0,2858,5935
71,Foggia,9,3182,0,0,0,0,0,0,3182,3015,0,0,0,0,0,0,3015,6197
71,Foggia,10,3244,0,0,0,0,0,0,3244,2988,0,0,0,0,0,0,2988,6232
71,Foggia,11,3203,0,0,0,0,0,0,3203,2994,0,0,0,0,0,0,2994,6197
71,Foggia,12,3205,0,0,0,0,0,0,3205,3068,0,0,0,0,0,0,3068,6273
71,Foggia,13,3287,0,0,0,0,0,0,3287,3190,0,0,0,0,0,0,3190,6477
71,Foggia,14,3475,0,0,0,0,0,0,3475,3230,0,0,0,0,0,0,3230,6705
71,Foggia,15,3442,0,0,0,0,0,0,3442,3349,0,0,0,0,0,0,3349,6791
71,Foggia,16,3502,0,0,0,0,0,0,3502,3356,0,0,0,0,0,0,3356,6858
71,Foggia,17,3603,0,0,0,0,0,0,3603,3393,1,0,0,0,0,0,3394,6997
71,Foggia,18,3688,0,0,0,0,0,0,3688,3493,3,0,0,0,0,0,3496,7184
71,Foggia,19,3873,1,0,0,0,0,0,3874,3455,8,0,0,0,0,0,3463,7337
71,Foggia,20,3951,7,0,0,0,0,0,3958,3527,38,0,0,0,0,0,3565,7523
71,Foggia,21,3877,9,1,0,0,0,0,3887,3473,57,0,0,0,0,0,3530,7417
71,Foggia,22,3691,33,0,0,0,0,0,3724,3382,106,0,1,0,0,0,3489,7213
71,Foggia,23,3733,44,0,0,0,0,0,3777,3215,155,2,0,0,0,0,3372,7149
71,Foggia,24,3781,76,2,0,0,0,0,3859,3172,252,1,0,0,0,0,3425,7284
71,Foggia,25,3823,119,3,0,0,0,0,3945,3204,334,3,2,0,0,0,3543,7488
71,Foggia,26,3797,225,3,1,0,0,0,4026,3284,564,4,1,0,0,0,3853,7879
71,Foggia,27,3619,309,1,1,0,0,0,3930,2875,701,4,3,0,0,0,3583,7513
71,Foggia,28,3459,501,8,0,0,0,0,3968,2726,928,11,5,0,0,0,3670,7638
71,Foggia,29,3166,590,6,1,0,0,0,3763,2611,1124,12,2,1,0,0,3750,7513
71,Foggia,30,3078,775,4,0,0,0,0,3857,2263,1332,12,4,0,0,0,3611,7468
71,Foggia,31,2740,1071,4,0,0,0,0,3815,1983,1511,22,3,0,0,0,3519,7334
71,Foggia,32,2587,1126,9,0,0,0,0,3722,1708,1705,41,7,0,0,0,3461,7183
71,Foggia,33,2193,1327,16,0,1,0,0,3537,1507,1885,37,8,0,0,0,3437,6974
71,Foggia,34,2040,1470,17,1,1,0,0,3529,1481,2059,38,8,0,0,0,3586,7115
71,Foggia,35,1972,1702,17,1,0,0,0,3692,1238,2241,54,15,0,0,0,3548,7240
71,Foggia,36,1845,1959,29,0,1,0,0,3834,1223,2475,59,22,1,0,0,3780,7614
71,Foggia,37,1654,2113,31,5,0,0,0,3803,1109,2625,52,21,0,0,0,3807,7610
71,Foggia,38,1608,2304,37,7,0,0,0,3956,952,2717,80,25,0,0,0,3774,7730
71,Foggia,39,1568,2419,50,8,0,0,0,4045,963,2908,89,23,0,0,0,3983,8028
71,Foggia,40,1500,2542,53,6,1,0,0,4102,869,3059,129,36,0,0,0,4093,8195
71,Foggia,41,1390,2895,58,8,1,0,0,4352,892,3208,105,38,0,0,0,4243,8595
71,Foggia,42,1377,2933,88,8,0,0,0,4406,856,3343,95,35,0,0,0,4329,8735
71,Foggia,43,1309,3161,78,10,0,0,0,4558,795,3444,116,49,0,0,0,4404,8962
71,Foggia,44,1194,3240,99,18,2,0,0,4553,740,3696,147,76,0,0,0,4659,9212
71,Foggia,45,1131,3238,88,13,0,0,0,4470,764,3582,156,65,0,0,0,4567,9037
71,Foggia,46,991,3343,94,15,0,0,0,4443,694,3637,142,69,1,0,0,4543,8986
71,Foggia,47,953,3502,112,13,0,0,0,4580,671,3805,147,103,1,0,0,4727,9307
71,Foggia,48,926,3459,106,17,0,0,0,4508,637,3704,180,107,0,0,0,4628,9136
71,Foggia,49,890,3747,110,15,1,0,0,4763,633,3860,170,116,3,0,0,4782,9545
71,Foggia,50,793,3698,90,23,1,0,0,4605,588,3942,149,144,1,1,0,4825,9430
71,Foggia,51,721,3898,123,22,1,0,0,4765,601,4080,158,158,0,0,0,4997,9762
71,Foggia,52,709,3918,142,33,0,0,0,4802,593,3904,181,183,0,0,0,4861,9663
71,Foggia,53,623,3957,120,46,1,0,0,4747,551,4016,167,169,0,0,0,4903,9650
71,Foggia,54,597,4046,120,40,0,0,0,4803,579,4090,180,232,0,0,0,5081,9884
71,Foggia,55,518,3704,128,54,0,0,0,4404,513,3842,158,237,0,0,0,4750,9154
71,Foggia,56,492,3640,127,48,0,0,0,4307,445,3736,170,237,0,0,0,4588,8895
71,Foggia,57,431,3594,101,45,0,0,0,4171,438,3512,137,246,0,0,0,4333,8504
71,Foggia,58,406,3564,110,68,0,0,0,4148,420,3513,136,296,0,0,0,4365,8513
71,Foggia,59,386,3391,98,62,0,0,0,3937,427,3395,139,296,0,0,0,4257,8194
71,Foggia,60,341,3304,94,74,0,0,0,3813,345,3342,142,355,0,0,0,4184,7997
71,Foggia,61,319,3197,82,81,0,0,0,3679,377,3170,131,383,0,0,0,4061,7740
71,Foggia,62,293,3214,82,86,0,0,0,3675,350,3157,138,413,0,0,0,4058,7733
71,Foggia,63,261,3263,73,106,0,0,0,3703,322,3007,126,477,0,0,0,3932,7635
71,Foggia,64,275,3294,74,97,0,0,0,3740,296,2991,87,486,0,0,0,3860,7600
71,Foggia,65,216,2952,87,124,0,0,0,3379,288,2786,86,501,0,0,0,3661,7040
71,Foggia,66,201,2901,58,115,0,0,0,3275,287,2607,82,509,0,0,0,3485,6760
71,Foggia,67,162,2862,64,131,0,0,0,3219,250,2587,102,582,0,0,0,3521,6740
71,Foggia,68,205,2909,67,125,0,0,0,3306,279,2658,78,640,0,0,0,3655,6961
71,Foggia,69,158,3142,56,139,0,0,0,3495,275,2682,80,686,0,0,0,3723,7218
71,Foggia,70,174,3139,65,186,0,0,0,3564,276,2806,77,888,0,0,0,4047,7611
71,Foggia,71,168,2903,48,175,0,0,0,3294,283,2395,59,819,0,0,0,3556,6850
71,Foggia,72,128,2756,48,205,0,0,0,3137,238,2382,75,980,0,0,0,3675,6812
71,Foggia,73,120,2316,48,188,0,0,0,2672,220,1965,64,819,0,0,0,3068,5740
71,Foggia,74,94,2098,28,185,0,0,0,2405,177,1703,40,828,0,0,0,2748,5153
71,Foggia,75,74,1886,28,193,0,0,0,2181,201,1534,38,863,0,0,0,2636,4817
71,Foggia,76,99,2002,30,233,0,0,0,2364,183,1505,32,935,0,0,0,2655,5019
71,Foggia,77,83,1829,20,195,0,0,0,2127,174,1368,33,1016,0,0,0,2591,4718
71,Foggia,78,98,1907,17,265,0,0,0,2287,195,1436,37,1225,0,0,0,2893,5180
71,Foggia,79,83,1847,19,301,0,0,0,2250,233,1319,37,1274,0,0,0,2863,5113
71,Foggia,80,77,1674,20,295,0,0,0,2066,209,1172,18,1299,0,0,0,2698,4764
71,Foggia,81,55,1423,22,281,0,0,0,1781,179,1026,23,1302,0,0,0,2530,4311
71,Foggia,82,66,1272,21,293,0,0,0,1652,185,835,26,1374,0,0,0,2420,4072
71,Foggia,83,53,1218,10,282,0,0,0,1563,147,753,27,1348,0,0,0,2275,3838
71,Foggia,84,43,1007,9,348,0,0,0,1407,157,632,13,1384,0,0,0,2186,3593
71,Foggia,85,40,930,10,295,0,0,0,1275,128,548,13,1260,0,0,0,1949,3224
71,Foggia,86,33,738,7,321,0,0,0,1099,146,433,10,1173,0,0,0,1762,2861
71,Foggia,87,24,589,7,287,0,0,0,907,118,323,15,1079,0,0,0,1535,2442
71,Foggia,88,17,523,5,269,0,0,0,814,121,285,5,1123,0,0,0,1534,2348
71,Foggia,89,15,394,1,240,0,0,0,650,92,195,7,929,0,0,0,1223,1873
71,Foggia,90,16,279,4,242,0,0,0,541,104,171,6,856,0,0,0,1137,1678
71,Foggia,91,10,251,1,195,0,0,0,457,81,131,6,811,0,0,0,1029,1486
71,Foggia,92,7,163,1,179,0,0,0,350,68,96,4,630,0,0,0,798,1148
71,Foggia,93,7,136,1,130,0,0,0,274,75,53,3,489,0,0,0,620,894
71,Foggia,94,9,70,0,115,0,0,0,194,35,33,2,388,0,0,0,458,652
71,Foggia,95,4,50,1,97,0,0,0,152,40,24,0,314,0,0,0,378,530
71,Foggia,96,2,33,0,62,0,0,0,97,34,16,2,229,0,0,0,281,378
71,Foggia,97,4,24,0,51,0,0,0,79,17,13,1,184,0,0,0,215,294
71,Foggia,98,3,16,1,27,0,0,0,47,13,9,1,136,0,0,0,159,206
71,Foggia,99,1,3,0,17,0,0,0,21,5,2,1,64,0,0,0,72,93
71,Foggia,100,2,6,0,24,0,0,0,32,11,3,0,102,0,0,0,116,148
72,Bari,0,4839,0,0,0,0,0,0,4839,4512,0,0,0,0,0,0,4512,9351
72,Bari,1,4993,0,0,0,0,0,0,4993,4738,0,0,0,0,0,0,4738,9731
72,Bari,2,5140,0,0,0,0,0,0,5140,4757,0,0,0,0,0,0,4757,9897
72,Bari,3,5138,0,0,0,0,0,0,5138,4882,0,0,0,0,0,0,4882,10020
72,Bari,4,5330,0,0,0,0,0,0,5330,5031,0,0,0,0,0,0,5031,10361
72,Bari,5,5366,0,0,0,0,0,0,5366,5060,0,0,0,0,0,0,5060,10426
72,Bari,6,5585,0,0,0,0,0,0,5585,5252,0,0,0,0,0,0,5252,10837
72,Bari,7,5838,0,0,0,0,0,0,5838,5502,0,0,0,0,0,0,5502,11340
72,Bari,8,5818,0,0,0,0,0,0,5818,5749,0,0,0,0,0,0,5749,11567
72,Bari,9,5950,0,0,0,0,0,0,5950,5556,0,0,0,0,0,0,5556,11506
72,Bari,10,6008,0,0,0,0,0,0,6008,5686,0,0,0,0,0,0,5686,11694
72,Bari,11,6023,0,0,0,0,0,0,6023,5749,0,0,0,0,0,0,5749,11772
72,Bari,12,6149,0,0,0,0,0,0,6149,5797,0,0,0,0,0,0,5797,11946
72,Bari,13,6378,0,0,0,0,0,0,6378,5763,0,0,0,0,0,0,5763,12141
72,Bari,14,6307,0,0,0,0,0,0,6307,6177,0,0,0,0,0,0,6177,12484
72,Bari,15,6436,0,0,0,0,0,0,6436,6238,0,0,0,0,0,0,6238,12674
72,Bari,16,6401,0,0,0,0,0,0,6401,6133,0,0,0,0,0,0,6133,12534
72,Bari,17,6746,0,0,0,0,0,0,6746,6275,0,0,0,0,0,0,6275,13021
72,Bari,18,6961,1,0,0,0,0,0,6962,6436,7,0,0,0,0,0,6443,13405
72,Bari,19,6900,1,0,0,0,0,0,6901,6403,26,0,0,1,0,0,6430,13331
72,Bari,20,6861,8,0,0,0,0,0,6869,6410,62,0,0,0,0,0,6472,13341
72,Bari,21,7052,20,0,0,0,0,0,7072,6280,128,0,0,0,0,0,6408,13480
72,Bari,22,7166,38,0,0,0,0,0,7204,6514,176,0,1,0,0,0,6691,13895
72,Bari,23,7066,84,0,0,0,0,0,7150,6272,336,3,0,0,0,0,6611,13761
72,Bari,24,6969,114,0,0,0,0,0,7083,6141,473,4,1,0,0,0,6619,13702
72,Bari,25,7006,247,3,0,2,0,0,7258,6160,716,4,0,2,0,0,6882,14140
72,Bari,26,7102,381,3,0,1,0,0,7487,6137,1059,7,1,0,0,0,7204,14691
72,Bari,27,6967,592,4,0,2,0,0,7565,5640,1419,14,0,0,0,0,7073,14638
72,Bari,28,6549,877,3,0,3,0,0,7432,5147,1829,14,4,0,0,0,6994,14426
72,Bari,29,6071,1152,6,1,4,0,0,7234,4679,2374,21,4,1,0,0,7079,14313
72,Bari,30,5973,1704,17,0,5,0,0,7699,4344,2970,30,3,2,0,0,7349,15048
72,Bari,31,5375,1958,17,1,2,0,0,7353,3767,3343,50,4,0,0,0,7164,14517
72,Bari,32,4741,2401,30,1,5,0,0,7178,3266,3720,52,14,1,0,0,7053,14231
72,Bari,33,4394,2777,26,1,3,0,0,7201,2898,4060,66,12,1,0,0,7037,14238
72,Bari,34,4109,3306,37,0,2,0,0,7454,2693,4633,99,24,1,0,0,7450,14904
72,Bari,35,3771,3674,59,0,4,0,0,7508,2480,4847,109,16,0,0,0,7452,14960
72,Bari,36,3541,3977,58,5,5,0,0,7586,2367,5379,119,18,1,0,0,7884,15470
72,Bari,37,3251,4395,58,3,1,0,0,7708,2145,5480,143,37,2,0,0,7807,15515
72,Bari,38,3071,4631,96,3,0,0,0,7801,1994,5864,168,37,2,0,0,8065,15866
72,Bari,39,2940,5163,95,7,5,0,0,8210,1920,6119,222,37,1,0,0,8299,16509
72,Bari,40,2946,5586,133,16,2,0,0,8683,1801,6444,254,55,1,0,0,8555,17238
72,Bari,41,2800,5926,152,16,5,0,0,8899,1775,6796,262,49,2,0,0,8884,17783
72,Bari,42,2634,6256,182,15,5,0,0,9092,1861,7261,321,60,3,0,0,9506,18598
72,Bari,43,2597,6635,216,13,4,0,0,9465,1677,7717,360,100,1,0,0,9855,19320
72,Bari,44,2446,6934,218,26,1,0,0,9625,1626,8017,391,101,0,0,0,10135,19760
72,Bari,45,2175,7023,258,22,0,1,0,9479,1517,7801,392,102,3,0,0,9815,19294
72,Bari,46,2080,7029,248,30,1,0,0,9388,1414,7629,413,125,1,0,0,9582,18970
72,Bari,47,1925,7223,270,42,1,0,0,9461,1368,7854,411,156,2,0,0,9791,19252
72,Bari,48,1796,7470,295,42,4,1,0,9608,1207,7877,426,149,0,0,0,9659,19267
72,Bari,49,1677,7424,266,46,2,0,0,9415,1253,8151,497,194,0,0,0,10095,19510
72,Bari,50,1508,7676,335,54,6,0,0,9579,1252,8142,447,228,3,0,0,10072,19651
72,Bari,51,1435,7944,326,55,1,0,0,9761,1196,8260,453,285,0,0,0,10194,19955
72,Bari,52,1281,8228,363,66,1,1,0,9940,1117,8557,467,256,1,0,0,10398,20338
72,Bari,53,1255,8196,356,73,0,1,0,9881,1123,8580,508,338,0,0,0,10549,20430
72,Bari,54,1153,8391,371,90,2,0,0,10007,1074,8509,466,390,5,0,0,10444,20451
72,Bari,55,978,7683,339,98,0,0,0,9098,951,7978,452,392,0,0,0,9773,18871
72,Bari,56,905,7645,303,111,4,0,0,8968,944,7768,422,469,1,0,0,9604,18572
72,Bari,57,796,7745,290,96,3,0,0,8930,891,7686,441,472,0,0,0,9490,18420
72,Bari,58,747,7460,320,130,1,0,0,8658,845,7291,411,565,1,0,1,9114,17772
72,Bari,59,679,7201,294,103,2,0,0,8279,782,7403,416,591,0,0,0,9192,17471
72,Bari,60,572,6831,266,141,1,0,0,7811,728,6934,363,595,0,0,0,8620,16431
72,Bari,61,590,6997,276,167,1,0,0,8031,731,6844,358,682,0,0,0,8615,16646
72,Bari,62,524,6746,247,154,1,0,0,7672,720,6648,315,776,0,0,0,8459,16131
72,Bari,63,447,6553,238,152,2,0,0,7392,630,6359,305,827,0,1,0,8122,15514
72,Bari,64,460,6577,190,219,0,0,0,7446,647,6293,266,917,0,0,0,8123,15569
72,Bari,65,380,6239,192,203,0,0,0,7014,577,5833,279,975,0,0,0,7664,14678
72,Bari,66,370,6091,164,199,1,0,0,6825,550,5686,253,944,0,0,0,7433,14258
72,Bari,67,365,6071,160,264,1,0,0,6861,590,5403,227,1083,1,0,0,7304,14165
72,Bari,68,312,6435,175,252,0,0,0,7174,577,5763,251,1246,0,0,0,7837,15011
72,Bari,69,327,6237,155,292,0,0,0,7011,641,5411,262,1373,0,0,1,7688,14699
72,Bari,70,296,6567,142,336,0,0,0,7341,601,5641,233,1644,0,0,0,8119,15460
72,Bari,71,261,5969,138,349,0,0,0,6717,569,5136,185,1717,1,0,1,7609,14326
72,Bari,72,253,5847,128,420,1,0,0,6649,515,4902,198,1828,0,0,0,7443,14092
72,Bari,73,206,5026,99,398,0,0,0,5729,515,3964,146,1782,0,0,0,6407,12136
72,Bari,74,206,4202,71,356,1,0,0,4836,448,3415,109,1717,0,0,0,5689,10525
72,Bari,75,180,4106,72,367,0,0,1,4726,415,3192,116,1762,0,0,0,5485,10211
72,Bari,76,162,4069,63,417,0,0,0,4711,459,3184,120,1998,0,0,2,5763,10474
72,Bari,77,145,3781,65,463,0,0,0,4454,412,2809,91,2082,0,0,0,5394,9848
72,Bari,78,193,3986,54,536,0,0,0,4769,442,2672,104,2424,0,0,0,5642,10411
72,Bari,79,167,3579,51,524,0,0,0,4321,392,2474,94,2354,0,0,0,5314,9635
72,Bari,80,115,3319,47,513,0,0,0,3994,367,2161,67,2560,0,0,0,5155,9149
72,Bari,81,118,2998,39,565,0,0,0,3720,380,1928,57,2619,0,0,0,4984,8704
72,Bari,82,90,2524,28,562,0,0,0,3204,358,1535,55,2533,0,0,1,4482,7686
72,Bari,83,78,2417,25,549,0,0,0,3069,343,1393,53,2616,0,0,0,4405,7474
72,Bari,84,108,2098,16,604,0,0,0,2826,356,1119,50,2574,0,0,1,4100,6926
72,Bari,85,80,1906,13,583,0,0,0,2582,311,894,52,2550,0,0,0,3807,6389
72,Bari,86,62,1536,14,551,0,0,0,2163,281,757,34,2371,0,0,1,3444,5607
72,Bari,87,77,1299,14,571,0,0,1,1962,264,586,37,2289,1,0,0,3177,5139
72,Bari,88,65,1117,10,595,1,0,0,1788,229,447,27,2178,0,0,0,2881,4669
72,Bari,89,40,809,5,463,0,0,0,1317,235,313,9,1777,0,0,0,2334,3651
72,Bari,90,34,621,2,403,0,0,0,1060,176,239,9,1696,0,0,1,2121,3181
72,Bari,91,30,458,3,368,0,0,0,859,165,148,17,1481,0,0,0,1811,2670
72,Bari,92,21,354,3,275,0,0,0,653,137,100,15,1174,0,0,0,1426,2079
72,Bari,93,20,243,1,238,0,0,0,502,112,64,9,960,0,0,0,1145,1647
72,Bari,94,14,142,0,182,0,0,0,338,79,45,9,705,0,0,1,839,1177
72,Bari,95,6,104,1,141,0,0,0,252,80,27,3,619,0,0,0,729,981
72,Bari,96,6,77,0,115,0,0,0,198,54,19,1,429,0,0,0,503,701
72,Bari,97,5,36,0,72,0,0,0,113,37,18,2,336,0,0,0,393,506
72,Bari,98,4,27,0,50,0,0,0,81,26,9,0,230,0,0,0,265,346
72,Bari,99,2,6,0,19,0,0,0,27,13,3,1,96,0,0,0,113,140
72,Bari,100,9,25,1,47,0,0,0,82,46,10,1,207,0,0,0,264,346
73,Taranto,0,1973,0,0,0,0,0,0,1973,1938,0,0,0,0,0,0,1938,3911
73,Taranto,1,2206,0,0,0,0,0,0,2206,2040,0,0,0,0,0,0,2040,4246
73,Taranto,2,2166,0,0,0,0,0,0,2166,2144,0,0,0,0,0,0,2144,4310
73,Taranto,3,2265,0,0,0,0,0,0,2265,2179,0,0,0,0,0,0,2179,4444
73,Taranto,4,2463,0,0,0,0,0,0,2463,2345,0,0,0,0,0,0,2345,4808
73,Taranto,5,2439,0,0,0,0,0,0,2439,2319,0,0,0,0,0,0,2319,4758
73,Taranto,6,2659,0,0,0,0,0,0,2659,2419,0,0,0,0,0,0,2419,5078
73,Taranto,7,2666,0,0,0,0,0,0,2666,2591,0,0,0,0,0,0,2591,5257
73,Taranto,8,2829,0,0,0,0,0,0,2829,2556,0,0,0,0,0,0,2556,5385
73,Taranto,9,2777,0,0,0,0,0,0,2777,2609,0,0,0,0,0,0,2609,5386
73,Taranto,10,2775,0,0,0,0,0,0,2775,2634,0,0,0,0,0,0,2634,5409
73,Taranto,11,2808,0,0,0,0,0,0,2808,2712,0,0,0,0,0,0,2712,5520
73,Taranto,12,2803,0,0,0,0,0,0,2803,2759,0,0,0,0,0,0,2759,5562
73,Taranto,13,2881,0,0,0,0,0,0,2881,2779,0,0,0,0,0,0,2779,5660
73,Taranto,14,2890,0,0,0,0,0,0,2890,2892,0,0,0,0,0,0,2892,5782
73,Taranto,15,2932,0,0,0,0,0,0,2932,2963,0,0,0,0,0,0,2963,5895
73,Taranto,16,2993,0,0,0,0,0,0,2993,2842,0,0,0,0,0,0,2842,5835
73,Taranto,17,3102,1,0,0,0,0,0,3103,2870,1,0,0,0,0,0,2871,5974
73,Taranto,18,3153,1,0,0,0,0,0,3154,2899,4,0,0,0,0,0,2903,6057
73,Taranto,19,3299,0,0,0,0,0,0,3299,2845,7,0,0,0,0,0,2852,6151
73,Taranto,20,3263,2,0,0,0,0,0,3265,2855,18,0,0,0,0,0,2873,6138
73,Taranto,21,3171,5,0,0,0,0,0,3176,2921,32,0,0,0,0,0,2953,6129
73,Taranto,22,3171,17,0,0,2,0,0,3190,2883,56,0,0,0,0,0,2939,6129
73,Taranto,23,3162,25,1,0,0,0,0,3188,2908,101,0,0,0,0,0,3009,6197
73,Taranto,24,3140,29,1,0,0,0,0,3170,2847,143,0,0,0,0,0,2990,6160
73,Taranto,25,3210,83,0,0,0,0,0,3293,2835,255,0,0,0,0,0,3090,6383
73,Taranto,26,3283,103,0,0,1,0,0,3387,2769,416,5,1,0,0,0,3191,6578
73,Taranto,27,3057,175,0,0,0,0,0,3232,2619,557,2,0,2,0,0,3180,6412
73,Taranto,28,2922,284,1,0,1,0,0,3208,2488,746,8,1,1,0,0,3244,6452
73,Taranto,29,2756,389,2,1,0,0,0,3148,2294,889,12,5,0,0,0,3200,6348
73,Taranto,30,2709,579,1,2,2,0,0,3293,1987,1203,11,3,0,0,0,3204,6497
73,Taranto,31,2405,766,3,1,2,0,0,3177,1772,1360,19,5,0,0,0,3156,6333
73,Taranto,32,2298,960,6,1,1,0,0,3266,1679,1582,21,6,0,0,0,3288,6554
73,Taranto,33,2057,1112,13,0,1,0,0,3183,1493,1732,33,4,0,0,0,3262,6445
73,Taranto,34,2011,1283,15,1,0,0,0,3310,1380,1942,44,5,0,0,0,3371,6681
73,Taranto,35,1893,1496,7,1,3,0,0,3400,1247,2033,52,8,0,0,0,3340,6740
73,Taranto,36,1772,1619,20,3,0,1,0,3415,1144,2114,63,10,1,0,0,3332,6747
73,Taranto,37,1625,1808,22,0,2,0,0,3457,1098,2458,66,11,0,0,0,3633,7090
73,Taranto,38,1559,2093,37,2,1,0,0,3692,1003,2520,72,15,0,0,0,3610,7302
73,Taranto,39,1521,2306,52,5,3,0,0,3887,946,2849,98,18,1,0,0,3912,7799
73,Taranto,40,1452,2402,71,5,1,0,0,3931,936,2992,101,21,1,0,0,4051,7982
73,Taranto,41,1455,2770,65,9,1,0,0,4300,904,3102,126,27,0,0,0,4159,8459
73,Taranto,42,1374,2875,86,11,2,0,0,4348,869,3223,159,33,0,0,0,4284,8632
73,Taranto,43,1321,3040,87,12,2,0,0,4462,913,3428,145,44,0,0,0,4530,8992
73,Taranto,44,1272,3070,103,7,1,0,0,4453,794,3548,163,42,0,0,0,4547,9000
73,Taranto,45,1063,3172,103,8,0,0,0,4346,750,3356,191,56,3,0,0,4356,8702
73,Taranto,46,1028,3081,97,16,1,0,0,4223,673,3462,187,71,1,0,0,4394,8617
73,Taranto,47,932,3211,123,13,1,0,0,4280,642,3466,189,76,0,0,0,4373,8653
73,Taranto,48,854,3099,114,20,0,0,0,4087,613,3411,187,67,2,0,0,4280,8367
73,Taranto,49,845,3275,149,24,1,0,0,4294,599,3593,226,102,0,0,0,4520,8814
73,Taranto,50,706,3239,153,35,2,0,0,4135,572,3762,195,120,1,0,0,4650,8785
73,Taranto,51,707,3336,143,32,1,0,0,4219,564,3578,203,125,2,0,0,4472,8691
73,Taranto,52,652,3400,144,37,1,0,0,4234,529,3734,219,144,0,0,0,4626,8860
73,Taranto,53,588,3571,145,42,5,0,0,4351,529,3785,198,161,2,0,0,4675,9026
73,Taranto,54,511,3564,149,43,0,0,0,4267,547,3763,196,165,0,0,0,4671,8938
73,Taranto,55,461,3341,144,39,0,0,0,3985,432,3486,201,194,0,0,0,4313,8298
73,Taranto,56,440,3244,127,37,0,0,0,3848,420,3483,189,228,0,0,0,4320,8168
73,Taranto,57,408,3390,117,46,0,0,0,3961,383,3626,170,265,0,0,0,4444,8405
73,Taranto,58,325,3387,142,55,0,0,0,3909,386,3362,160,289,0,0,0,4197,8106
73,Taranto,59,344,3278,128,57,1,0,0,3808,341,3311,168,317,0,0,0,4137,7945
73,Taranto,60,296,3114,118,77,0,0,0,3605,373,3178,120,336,0,0,0,4007,7612
73,Taranto,61,304,3139,121,82,2,0,0,3648,370,3264,132,376,0,0,0,4142,7790
73,Taranto,62,248,3171,78,75,0,0,0,3572,303,3033,150,412,0,0,0,3898,7470
73,Taranto,63,234,3157,92,79,0,0,0,3562,317,3157,129,462,0,0,0,4065,7627
73,Taranto,64,229,2950,104,79,2,0,0,3364,279,2943,127,448,1,0,0,3798,7162
73,Taranto,65,200,3035,77,92,1,0,0,3405,251,2808,105,499,0,0,0,3663,7068
73,Taranto,66,167,2807,70,113,3,0,0,3160,254,2730,85,529,0,0,0,3598,6758
73,Taranto,67,175,3012,72,128,0,0,0,3387,289,2697,90,609,0,0,1,3686,7073
73,Taranto,68,164,3069,59,141,0,0,0,3433,279,2732,89,684,1,0,0,3785,7218
73,Taranto,69,142,3089,67,146,0,0,0,3444,277,2584,80,732,0,0,0,3673,7117
73,Taranto,70,149,3167,64,178,0,0,0,3558,315,2627,72,870,0,0,0,3884,7442
73,Taranto,71,146,3019,53,186,0,0,0,3404,278,2485,72,901,0,0,0,3736,7140
73,Taranto,72,115,2787,52,185,1,0,0,3140,280,2400,62,993,0,0,0,3735,6875
73,Taranto,73,92,2468,45,179,0,0,0,2784,253,1914,61,898,0,0,0,3126,5910
73,Taranto,74,95,2174,26,181,0,0,0,2476,197,1707,48,962,0,0,0,2914,5390
73,Taranto,75,94,2042,32,185,0,0,0,2353,180,1568,61,959,0,0,0,2768,5121
73,Taranto,76,85,1985,23,215,0,0,0,2308,213,1541,50,996,0,0,0,2800,5108
73,Taranto,77,77,1919,35,215,0,0,0,2246,201,1352,29,1048,0,0,0,2630,4876
73,Taranto,78,67,2012,27,283,0,0,0,2389,243,1424,40,1258,0,0,0,2965,5354
73,Taranto,79,63,1844,10,255,0,0,0,2172,226,1296,28,1346,0,0,0,2896,5068
73,Taranto,80,52,1643,21,256,0,0,0,1972,204,1049,32,1337,0,0,0,2622,4594
73,Taranto,81,58,1476,15,284,0,0,0,1833,178,943,23,1375,0,0,0,2519,4352
73,Taranto,82,40,1233,11,278,0,0,0,1562,163,753,15,1243,0,0,0,2174,3736
73,Taranto,83,59,1170,7,264,0,0,0,1500,186,610,15,1323,0,0,0,2134,3634
73,Taranto,84,35,1011,5,302,0,0,0,1353,186,497,12,1370,0,0,0,2065,3418
73,Taranto,85,40,818,5,283,0,0,0,1146,168,416,8,1177,0,0,0,1769,2915
73,Taranto,86,27,702,1,254,0,0,0,984,158,309,6,1136,0,0,0,1609,2593
73,Taranto,87,28,580,4,248,0,0,0,860,132,248,9,1128,0,0,0,1517,2377
73,Taranto,88,22,505,1,256,0,0,0,784,132,201,9,1126,0,0,0,1468,2252
73,Taranto,89,21,360,3,194,0,0,0,578,111,143,3,902,0,0,0,1159,1737
73,Taranto,90,11,276,3,173,0,0,0,463,94,88,2,769,0,0,0,953,1416
73,Taranto,91,19,212,2,142,0,0,0,375,85,56,3,668,0,0,0,812,1187
73,Taranto,92,5,141,2,108,0,0,0,256,81,44,4,516,0,0,0,645,901
73,Taranto,93,7,114,1,88,0,0,0,210,57,32,5,424,0,0,0,518,728
73,Taranto,94,5,84,0,91,0,0,0,180,45,18,1,302,0,0,0,366,546
73,Taranto,95,3,46,1,70,0,0,0,120,23,11,3,242,0,0,0,279,399
73,Taranto,96,3,27,1,59,0,0,0,90,17,9,0,197,0,0,0,223,313
73,Taranto,97,1,19,0,32,0,0,0,52,13,4,1,125,0,0,0,143,195
73,Taranto,98,0,10,0,19,0,0,0,29,8,2,0,77,0,0,0,87,116
73,Taranto,99,1,6,0,11,0,0,0,18,2,0,0,57,0,0,0,59,77
73,Taranto,100,3,8,0,11,0,0,0,22,9,4,0,74,0,0,0,87,109
74,Brindisi,0,1341,0,0,0,0,0,0,1341,1274,0,0,0,0,0,0,1274,2615
74,Brindisi,1,1344,0,0,0,0,0,0,1344,1366,0,0,0,0,0,0,1366,2710
74,Brindisi,2,1466,0,0,0,0,0,0,1466,1375,0,0,0,0,0,0,1375,2841
74,Brindisi,3,1474,0,0,0,0,0,0,1474,1428,0,0,0,0,0,0,1428,2902
74,Brindisi,4,1572,0,0,0,0,0,0,1572,1478,0,0,0,0,0,0,1478,3050
74,Brindisi,5,1654,0,0,0,0,0,0,1654,1584,0,0,0,0,0,0,1584,3238
74,Brindisi,6,1637,0,0,0,0,0,0,1637,1572,0,0,0,0,0,0,1572,3209
74,Brindisi,7,1765,0,0,0,0,0,0,1765,1596,0,0,0,0,0,0,1596,3361
74,Brindisi,8,1736,0,0,0,0,0,0,1736,1673,0,0,0,0,0,0,1673,3409
74,Brindisi,9,1913,0,0,0,0,0,0,1913,1730,0,0,0,0,0,0,1730,3643
74,Brindisi,10,1818,0,0,0,0,0,0,1818,1745,0,0,0,0,0,0,1745,3563
74,Brindisi,11,1896,0,0,0,0,0,0,1896,1689,0,0,0,0,0,0,1689,3585
74,Brindisi,12,1854,0,0,0,0,0,0,1854,1743,0,0,0,0,0,0,1743,3597
74,Brindisi,13,1854,0,0,0,0,0,0,1854,1758,0,0,0,0,0,0,1758,3612
74,Brindisi,14,1925,0,0,0,0,0,0,1925,1830,0,0,0,0,0,0,1830,3755
74,Brindisi,15,1919,0,0,0,0,0,0,1919,1764,0,0,0,0,0,0,1764,3683
74,Brindisi,16,1985,0,0,0,0,0,0,1985,1864,0,0,0,0,0,0,1864,3849
74,Brindisi,17,2022,0,0,0,0,0,0,2022,1925,1,0,0,0,0,0,1926,3948
74,Brindisi,18,2033,0,0,0,0,0,0,2033,2026,1,0,0,0,0,0,2027,4060
74,Brindisi,19,2196,1,0,0,0,0,0,2197,1988,8,0,0,0,0,0,1996,4193
74,Brindisi,20,2171,0,0,0,0,0,0,2171,1942,20,0,1,0,0,0,1963,4134
74,Brindisi,21,2096,3,0,0,0,0,0,2099,1896,43,0,0,0,0,0,1939,4038
74,Brindisi,22,2172,11,0,0,0,0,0,2183,1972,51,0,0,0,0,0,2023,4206
74,Brindisi,23,2111,17,1,0,0,0,0,2129,1944,89,0,0,1,0,0,2034,4163
74,Brindisi,24,2198,41,0,0,1,0,0,2240,1917,123,1,1,0,0,0,2042,4282
74,Brindisi,25,2288,72,0,1,0,0,0,2361,1981,190,3,0,0,0,0,2174,4535
74,Brindisi,26,2354,98,2,0,0,0,0,2454,2004,293,1,0,0,0,0,2298,4752
74,Brindisi,27,2176,127,1,0,0,0,0,2304,1813,407,2,0,0,0,0,2222,4526
74,Brindisi,28,2161,237,2,1,0,0,0,2401,1721,478,6,0,0,0,0,2205,4606
74,Brindisi,29,2033,293,0,1,0,0,0,2327,1617,621,6,1,0,0,0,2245,4572
74,Brindisi,30,1890,403,1,0,0,0,0,2294,1451,831,13,0,0,0,0,2295,4589
74,Brindisi,31,1799,552,7,0,1,0,0,2359,1414,879,21,2,0,0,0,2316,4675
74,Brindisi,32,1585,618,11,2,3,0,0,2219,1172,986,20,0,0,0,0,2178,4397
74,Brindisi,33,1578,765,10,0,0,0,0,2353,1105,1177,25,6,0,0,0,2313,4666
74,Brindisi,34,1452,822,11,0,0,0,0,2285,1012,1259,29,5,0,0,0,2305,4590
74,Brindisi,35,1283,986,20,1,0,0,0,2290,906,1360,30,2,1,0,0,2299,4589
74,Brindisi,36,1206,1133,11,2,1,0,0,2353,812,1570,42,5,0,0,0,2429,4782
74,Brindisi,37,1150,1146,23,0,0,0,0,2319,775,1541,48,14,0,0,0,2378,4697
74,Brindisi,38,1069,1354,24,1,1,0,0,2449,724,1630,55,7,0,0,0,2416,4865
74,Brindisi,39,1085,1492,35,5,2,0,0,2619,704,1797,54,9,0,0,0,2564,5183
74,Brindisi,40,975,1614,41,2,1,0,0,2633,711,1850,85,19,0,0,0,2665,5298
74,Brindisi,41,997,1688,50,6,0,0,0,2741,665,2044,80,22,0,0,0,2811,5552
74,Brindisi,42,957,1849,51,5,1,0,0,2863,691,2111,102,22,0,0,0,2926,5789
74,Brindisi,43,894,1942,70,12,0,0,0,2918,642,2260,96,33,0,0,0,3031,5949
74,Brindisi,44,900,2016,71,11,0,0,0,2998,607,2343,122,34,0,0,0,3106,6104
74,Brindisi,45,767,1979,71,10,2,0,0,2829,589,2242,114,35,0,0,0,2980,5809
74,Brindisi,46,697,2034,85,8,0,0,0,2824,532,2258,108,33,0,0,0,2931,5755
74,Brindisi,47,675,2038,97,11,1,0,0,2822,499,2305,121,62,0,0,0,2987,5809
74,Brindisi,48,593,2161,85,12,0,0,0,2851,505,2364,125,55,0,0,0,3049,5900
74,Brindisi,49,580,2179,102,13,2,0,0,2876,446,2456,141,60,0,0,0,3103,5979
74,Brindisi,50,554,2363,100,14,2,0,0,3033,432,2502,143,81,0,0,0,3158,6191
74,Brindisi,51,463,2399,98,14,2,0,0,2976,482,2470,151,100,0,0,0,3203,6179
74,Brindisi,52,497,2418,96,19,3,0,0,3033,424,2397,121,99,0,0,0,3041,6074
74,Brindisi,53,422,2432,110,30,0,0,0,2994,393,2588,131,116,0,0,0,3228,6222
74,Brindisi,54,401,2529,111,38,0,0,0,3079,425,2584,126,121,0,0,1,3257,6336
74,Brindisi,55,327,2397,95,35,1,0,1,2856,437,2491,147,144,1,0,0,3220,6076
74,Brindisi,56,291,2380,88,38,0,0,0,2797,379,2257,116,170,0,0,0,2922,5719
74,Brindisi,57,301,2345,83,33,0,0,0,2762,343,2454,111,172,0,0,0,3080,5842
74,Brindisi,58,231,2242,88,30,0,0,0,2591,315,2369,117,185,0,0,0,2986,5577
74,Brindisi,59,207,2300,81,56,0,0,0,2644,313,2173,112,205,0,0,0,2803,5447
74,Brindisi,60,200,2127,77,53,0,0,0,2457,277,2116,105,230,0,0,0,2728,5185
74,Brindisi,61,177,2155,95,39,0,0,0,2466,278,2114,112,245,0,0,0,2749,5215
74,Brindisi,62,180,2198,78,37,0,0,0,2493,273,2146,89,234,0,0,0,2742,5235
74,Brindisi,63,149,2057,72,58,0,0,0,2336,279,2043,95,295,1,0,0,2713,5049
74,Brindisi,64,168,2022,53,58,0,0,0,2301,226,1803,67,302,0,0,0,2398,4699
74,Brindisi,65,159,1871,56,76,1,0,0,2163,222,1795,67,350,1,0,0,2435,4598
74,Brindisi,66,133,1939,48,85,0,0,0,2205,264,1810,73,379,1,0,0,2527,4732
74,Brindisi,67,127,1911,63,71,0,0,0,2172,236,1879,56,425,0,0,0,2596,4768
74,Brindisi,68,118,2054,34,94,0,0,0,2300,239,1827,60,472,0,0,0,2598,4898
74,Brindisi,69,113,2080,41,98,1,0,0,2333,242,1838,59,547,0,0,0,2686,5019
74,Brindisi,70,102,2111,49,121,0,0,0,2383,262,1790,71,602,0,0,0,2725,5108
74,Brindisi,71,104,1933,36,126,0,0,0,2199,219,1707,52,603,0,0,0,2581,4780
74,Brindisi,72,97,1850,47,151,0,0,0,2145,204,1579,64,692,0,0,0,2539,4684
74,Brindisi,73,59,1535,32,115,0,0,0,1741,197,1247,42,580,0,0,0,2066,3807
74,Brindisi,74,68,1348,23,127,0,0,0,1566,208,1139,42,658,0,0,0,2047,3613
74,Brindisi,75,40,1423,28,122,0,0,0,1613,195,1068,34,722,0,0,0,2019,3632
74,Brindisi,76,76,1395,29,137,0,0,0,1637,181,1060,29,759,0,0,0,2029,3666
74,Brindisi,77,55,1232,19,163,1,0,0,1470,170,907,29,720,0,0,0,1826,3296
74,Brindisi,78,55,1299,19,179,0,0,0,1552,181,894,33,864,0,0,0,1972,3524
74,Brindisi,79,54,1272,9,176,0,0,0,1511,199,888,31,937,0,0,0,2055,3566
74,Brindisi,80,42,1142,20,183,0,0,0,1387,185,674,25,925,0,0,0,1809,3196
74,Brindisi,81,35,1013,7,199,0,0,0,1254,168,596,21,905,0,0,0,1690,2944
74,Brindisi,82,35,889,5,189,0,0,0,1118,136,497,19,900,0,0,0,1552,2670
74,Brindisi,83,34,769,9,188,0,0,0,1000,126,414,10,865,0,0,0,1415,2415
74,Brindisi,84,30,679,8,189,0,0,0,906,171,347,10,929,0,0,0,1457,2363
74,Brindisi,85,19,563,6,194,0,0,0,782,130,279,16,867,0,0,0,1292,2074
74,Brindisi,86,26,461,5,187,0,0,0,679,98,219,15,808,0,0,0,1140,1819
74,Brindisi,87,20,447,3,172,0,0,0,642,120,202,8,784,0,0,0,1114,1756
74,Brindisi,88,14,355,5,201,0,0,0,575,101,120,4,747,0,0,0,972,1547
74,Brindisi,89,13,264,2,127,0,0,0,406,88,82,7,674,0,0,0,851,1257
74,Brindisi,90,11,163,2,140,0,0,0,316,81,77,3,562,0,0,0,723,1039
74,Brindisi,91,21,157,0,121,0,0,0,299,59,49,3,531,0,0,0,642,941
74,Brindisi,92,8,113,1,96,0,0,0,218,60,31,4,419,0,0,0,514,732
74,Brindisi,93,4,64,0,81,0,0,0,149,40,25,1,314,0,0,0,380,529
74,Brindisi,94,7,43,0,59,0,0,0,109,36,12,1,237,0,0,0,286,395
74,Brindisi,95,3,34,0,55,0,0,0,92,31,7,0,192,0,0,0,230,322
74,Brindisi,96,3,27,0,45,0,0,0,75,23,5,1,153,0,0,0,182,257
74,Brindisi,97,2,16,0,26,0,0,0,44,14,7,1,88,0,0,0,110,154
74,Brindisi,98,3,7,0,15,0,0,0,25,11,2,0,56,0,0,0,69,94
74,Brindisi,99,1,6,1,5,0,0,0,13,7,1,2,34,0,0,0,44,57
74,Brindisi,100,0,7,0,5,0,0,0,12,8,0,0,43,0,0,0,51,63
75,Lecce,0,2788,0,0,0,0,0,0,2788,2518,0,0,0,0,0,0,2518,5306
75,Lecce,1,2718,0,0,0,0,0,0,2718,2712,0,0,0,0,0,0,2712,5430
75,Lecce,2,2880,0,0,0,0,0,0,2880,2765,0,0,0,0,0,0,2765,5645
75,Lecce,3,2899,0,0,0,0,0,0,2899,2860,0,0,0,0,0,0,2860,5759
75,Lecce,4,3145,0,0,0,0,0,0,3145,2818,0,0,0,0,0,0,2818,5963
75,Lecce,5,3271,0,0,0,0,0,0,3271,3031,0,0,0,0,0,0,3031,6302
75,Lecce,6,3422,0,0,0,0,0,0,3422,3183,0,0,0,0,0,0,3183,6605
75,Lecce,7,3416,0,0,0,0,0,0,3416,3233,0,0,0,0,0,0,3233,6649
75,Lecce,8,3626,0,0,0,0,0,0,3626,3312,0,0,0,0,0,0,3312,6938
75,Lecce,9,3503,0,0,0,0,0,0,3503,3346,0,0,0,0,0,0,3346,6849
75,Lecce,10,3691,0,0,0,0,0,0,3691,3462,0,0,0,0,0,0,3462,7153
75,Lecce,11,3791,0,0,0,0,0,0,3791,3457,0,0,0,0,0,0,3457,7248
75,Lecce,12,3609,0,0,0,0,0,0,3609,3505,0,0,0,0,0,0,3505,7114
75,Lecce,13,3751,0,0,0,0,0,0,3751,3566,0,0,0,0,0,0,3566,7317
75,Lecce,14,3882,0,0,0,0,0,0,3882,3808,0,0,0,0,0,0,3808,7690
75,Lecce,15,3998,0,0,0,0,0,0,3998,3707,0,0,0,0,0,0,3707,7705
75,Lecce,16,3906,0,0,0,0,0,0,3906,3745,0,0,0,0,0,0,3745,7651
75,Lecce,17,4166,0,0,1,0,0,0,4167,3900,0,0,0,0,0,0,3900,8067
75,Lecce,18,4295,0,0,0,0,0,0,4295,3906,4,0,0,0,0,0,3910,8205
75,Lecce,19,4256,1,0,0,0,0,0,4257,3779,16,0,0,0,0,0,3795,8052
75,Lecce,20,4433,7,0,0,0,0,0,4440,3857,17,0,0,0,0,0,3874,8314
75,Lecce,21,4272,7,0,0,0,0,0,4279,3823,49,0,0,0,0,0,3872,8151
75,Lecce,22,4208,18,0,0,0,0,0,4226,3850,78,1,0,0,0,0,3929,8155
75,Lecce,23,4340,29,1,0,1,0,0,4371,3869,93,0,0,0,0,0,3962,8333
75,Lecce,24,4229,53,1,0,0,0,0,4283,3888,181,0,2,0,0,0,4071,8354
75,Lecce,25,4410,95,0,0,0,0,0,4505,3995,310,2,0,0,0,0,4307,8812
75,Lecce,26,4622,169,1,0,1,0,0,4793,3953,471,4,0,0,0,0,4428,9221
75,Lecce,27,4348,229,1,0,1,0,0,4579,3751,621,14,0,0,0,0,4386,8965
75,Lecce,28,4148,361,4,2,0,0,0,4515,3391,833,5,3,2,0,0,4234,8749
75,Lecce,29,3849,455,5,0,1,0,0,4310,3155,1097,15,2,0,0,0,4269,8579
75,Lecce,30,3738,708,4,1,1,0,0,4452,2976,1399,14,1,0,0,0,4390,8842
75,Lecce,31,3371,879,7,1,3,0,0,4261,2637,1590,19,5,0,0,0,4251,8512
75,Lecce,32,3263,1097,11,0,0,0,0,4371,2276,1794,35,4,1,0,0,4110,8481
75,Lecce,33,2946,1307,19,0,1,0,0,4273,2175,2206,47,2,0,0,0,4430,8703
75,Lecce,34,2889,1565,21,1,1,0,0,4477,2141,2397,66,4,0,0,0,4608,9085
75,Lecce,35,2692,1722,24,0,1,0,0,4439,1969,2590,66,9,0,0,0,4634,9073
75,Lecce,36,2534,2030,30,2,1,0,0,4597,1774,2850,66,16,0,0,0,4706,9303
75,Lecce,37,2399,2206,38,2,2,0,0,4647,1703,3140,102,21,0,0,0,4966,9613
75,Lecce,38,2273,2594,51,3,0,0,0,4921,1665,3343,87,21,0,0,0,5116,10037
75,Lecce,39,2246,2952,61,9,3,0,0,5271,1529,3772,115,23,0,0,0,5439,10710
75,Lecce,40,2123,3189,78,3,1,0,0,5394,1536,3886,152,31,1,0,0,5606,11000
75,Lecce,41,2099,3333,82,6,2,0,0,5522,1409,4201,134,45,1,0,0,5790,11312
75,Lecce,42,2031,3775,89,10,2,0,0,5907,1425,4401,188,48,1,0,0,6063,11970
75,Lecce,43,1896,3993,127,15,1,0,0,6032,1314,4418,193,68,0,0,0,5993,12025
75,Lecce,44,1670,4236,124,13,1,0,0,6044,1301,4700,209,50,1,0,0,6261,12305
75,Lecce,45,1521,4084,155,13,0,0,0,5773,1200,4596,242,71,1,0,0,6110,11883
75,Lecce,46,1417,4057,131,15,1,0,0,5621,1023,4528,233,73,0,0,0,5857,11478
75,Lecce,47,1362,4315,164,17,2,0,0,5860,1057,4679,211,105,1,0,0,6053,11913
75,Lecce,48,1212,4377,165,21,1,0,0,5776,1057,4758,243,124,0,0,0,6182,11958
75,Lecce,49,1150,4511,181,31,1,0,0,5874,1016,4961,241,125,1,0,0,6344,12218
75,Lecce,50,1076,4518,202,33,1,0,0,5830,999,5074,262,119,1,0,0,6455,12285
75,Lecce,51,1016,4719,218,48,0,0,0,6001,964,5133,265,137,1,0,0,6500,12501
75,Lecce,52,936,4884,193,48,1,0,0,6062,996,5201,278,179,1,0,0,6655,12717
75,Lecce,53,799,4814,197,48,0,0,0,5858,919,5181,275,203,2,0,0,6580,12438
75,Lecce,54,748,5081,231,60,1,0,0,6121,922,5219,278,232,0,0,0,6651,12772
75,Lecce,55,658,4781,179,58,0,0,0,5676,839,4886,234,234,0,0,0,6193,11869
75,Lecce,56,577,4632,191,64,0,0,0,5464,808,4736,215,283,0,0,0,6042,11506
75,Lecce,57,548,4549,171,66,2,0,0,5336,742,4675,211,321,0,0,0,5949,11285
75,Lecce,58,474,4565,189,76,2,0,0,5306,691,4615,240,357,0,0,0,5903,11209
75,Lecce,59,415,4401,176,98,1,0,0,5091,699,4428,176,363,0,0,0,5666,10757
75,Lecce,60,383,3984,152,90,2,0,0,4611,660,4187,187,405,0,0,0,5439,10050
75,Lecce,61,401,4226,163,94,1,0,0,4885,598,4290,201,461,0,0,0,5550,10435
75,Lecce,62,325,4199,133,109,2,0,0,4768,619,4103,161,535,0,0,0,5418,10186
75,Lecce,63,319,4324,130,117,1,0,0,4891,598,4213,170,537,0,0,0,5518,10409
75,Lecce,64,302,4078,118,109,1,0,0,4608,570,3915,122,619,0,0,0,5226,9834
75,Lecce,65,288,4120,106,137,0,0,0,4651,506,4007,173,677,0,0,0,5363,10014
75,Lecce,66,223,3805,89,122,0,0,0,4239,454,3559,133,688,0,0,0,4834,9073
75,Lecce,67,256,4217,108,154,0,0,0,4735,474,3848,145,847,0,0,0,5314,10049
75,Lecce,68,212,4321,112,158,0,0,0,4803,521,3755,151,928,0,0,0,5355,10158
75,Lecce,69,216,4039,90,196,2,0,0,4543,521,3591,129,1010,0,0,0,5251,9794
75,Lecce,70,201,4307,86,237,0,0,0,4831,518,3894,116,1159,0,0,0,5687,10518
75,Lecce,71,181,4166,91,257,0,0,0,4695,480,3527,103,1265,0,0,0,5375,10070
75,Lecce,72,155,3924,89,282,0,0,0,4450,485,3316,113,1373,0,0,0,5287,9737
75,Lecce,73,144,3270,48,236,0,0,0,3698,433,2578,95,1186,0,0,0,4292,7990
75,Lecce,74,117,2881,59,236,0,0,0,3293,403,2239,70,1136,0,0,0,3848,7141
75,Lecce,75,129,2973,56,278,1,0,0,3437,412,2391,61,1367,0,0,0,4231,7668
75,Lecce,76,120,2903,48,311,0,0,0,3382,424,2249,55,1452,0,0,0,4180,7562
75,Lecce,77,119,2674,34,315,0,0,0,3142,429,1964,62,1502,0,0,0,3957,7099
75,Lecce,78,122,2687,36,342,1,0,0,3188,412,1988,54,1704,0,0,0,4158,7346
75,Lecce,79,108,2757,39,405,0,0,0,3309,434,1927,53,1998,0,0,0,4412,7721
75,Lecce,80,77,2444,35,400,0,0,0,2956,414,1690,36,2025,0,0,0,4165,7121
75,Lecce,81,83,2040,14,372,0,0,0,2509,380,1380,33,1815,0,0,0,3608,6117
75,Lecce,82,88,1871,15,381,1,0,0,2356,319,1160,31,1864,0,0,0,3374,5730
75,Lecce,83,61,1757,26,419,0,0,0,2263,324,998,39,1976,0,0,0,3337,5600
75,Lecce,84,65,1534,13,377,0,0,0,1989,308,851,20,1944,0,0,0,3123,5112
75,Lecce,85,53,1290,8,369,0,0,0,1720,290,672,19,1929,0,0,0,2910,4630
75,Lecce,86,51,1097,6,403,0,0,0,1557,279,567,21,1876,0,0,0,2743,4300
75,Lecce,87,43,939,6,407,0,0,0,1395,250,436,10,1797,0,0,0,2493,3888
75,Lecce,88,43,812,0,424,0,0,0,1279,230,387,19,1824,0,0,0,2460,3739
75,Lecce,89,31,586,9,352,0,0,0,978,225,253,12,1479,0,0,0,1969,2947
75,Lecce,90,20,447,4,319,0,0,0,790,176,166,12,1356,0,0,0,1710,2500
75,Lecce,91,19,319,2,281,0,0,0,621,138,102,11,1133,0,0,0,1384,2005
75,Lecce,92,11,202,2,228,0,0,0,443,143,71,4,844,0,0,0,1062,1505
75,Lecce,93,5,140,0,159,0,0,0,304,88,41,3,701,0,0,0,833,1137
75,Lecce,94,3,114,0,119,0,0,0,236,65,32,4,564,0,0,0,665,901
75,Lecce,95,10,58,1,89,0,0,0,158,61,20,2,430,0,0,0,513,671
75,Lecce,96,0,51,1,65,0,0,0,117,41,10,0,313,0,0,0,364,481
75,Lecce,97,2,19,1,47,0,0,0,69,31,4,0,209,0,0,0,244,313
75,Lecce,98,1,16,1,31,0,0,0,49,23,4,2,163,0,0,0,192,241
75,Lecce,99,3,6,0,13,0,0,0,22,13,2,0,86,0,0,0,101,123
75,Lecce,100,1,7,0,20,0,0,0,28,23,3,1,123,0,0,0,150,178
76,Potenza,0,1183,0,0,0,0,0,0,1183,1124,0,0,0,0,0,0,1124,2307
76,Potenza,1,1334,0,0,0,0,0,0,1334,1203,0,0,0,0,0,0,1203,2537
76,Potenza,2,1302,0,0,0,0,0,0,1302,1212,0,0,0,0,0,0,1212,2514
76,Potenza,3,1322,0,0,0,0,0,0,1322,1282,0,0,0,0,0,0,1282,2604
76,Potenza,4,1328,0,0,0,0,0,0,1328,1248,0,0,0,0,0,0,1248,2576
76,Potenza,5,1308,0,0,0,0,0,0,1308,1232,0,0,0,0,0,0,1232,2540
76,Potenza,6,1505,0,0,0,0,0,0,1505,1331,0,0,0,0,0,0,1331,2836
76,Potenza,7,1445,0,0,0,0,0,0,1445,1342,0,0,0,0,0,0,1342,2787
76,Potenza,8,1485,0,0,0,0,0,0,1485,1391,0,0,0,0,0,0,1391,2876
76,Potenza,9,1603,0,0,0,0,0,0,1603,1452,0,0,0,0,0,0,1452,3055
76,Potenza,10,1613,0,0,0,0,0,0,1613,1489,0,0,0,0,0,0,1489,3102
76,Potenza,11,1617,0,0,0,0,0,0,1617,1500,0,0,0,0,0,0,1500,3117
76,Potenza,12,1615,0,0,0,0,0,0,1615,1559,0,0,0,0,0,0,1559,3174
76,Potenza,13,1624,0,0,0,0,0,0,1624,1531,0,0,0,0,0,0,1531,3155
76,Potenza,14,1689,0,0,0,0,0,0,1689,1644,0,0,0,0,0,0,1644,3333
76,Potenza,15,1753,0,0,0,0,0,0,1753,1599,0,0,0,0,0,0,1599,3352
76,Potenza,16,1821,0,0,0,0,0,0,1821,1672,0,0,0,0,0,0,1672,3493
76,Potenza,17,1872,0,0,0,0,0,0,1872,1693,0,0,0,0,0,0,1693,3565
76,Potenza,18,1925,0,0,0,0,0,0,1925,1741,1,0,0,0,0,0,1742,3667
76,Potenza,19,1976,0,2,0,0,0,0,1978,1771,5,0,0,0,0,0,1776,3754
76,Potenza,20,2056,2,0,0,0,0,0,2058,1717,12,0,0,0,0,0,1729,3787
76,Potenza,21,1999,3,1,0,0,0,0,2003,1696,27,0,0,0,0,0,1723,3726
76,Potenza,22,2008,14,0,0,0,0,0,2022,1708,42,0,0,0,0,0,1750,3772
76,Potenza,23,2039,14,0,0,0,0,0,2053,1796,63,0,0,0,0,0,1859,3912
76,Potenza,24,2065,38,0,0,0,0,0,2103,1811,109,3,0,0,0,0,1923,4026
76,Potenza,25,2121,38,1,0,0,0,0,2160,1778,149,0,0,0,0,0,1927,4087
76,Potenza,26,2212,80,1,0,0,0,0,2293,1921,256,0,1,0,0,0,2178,4471
76,Potenza,27,2037,143,1,0,0,0,0,2181,1727,379,2,1,0,0,0,2109,4290
76,Potenza,28,2112,189,0,0,1,0,0,2302,1603,499,4,1,0,0,0,2107,4409
76,Potenza,29,2015,265,3,0,0,0,0,2283,1491,609,8,2,0,0,0,2110,4393
76,Potenza,30,1824,392,3,1,0,0,0,2220,1344,739,7,2,0,0,0,2092,4312
76,Potenza,31,1743,462,5,0,0,0,0,2210,1217,838,13,0,0,0,0,2068,4278
76,Potenza,32,1601,601,4,0,0,0,0,2206,1062,969,10,5,0,0,0,2046,4252
76,Potenza,33,1583,735,3,1,1,0,0,2323,975,1047,17,0,0,0,0,2039,4362
76,Potenza,34,1434,848,8,0,0,0,0,2290,933,1170,26,7,0,0,0,2136,4426
76,Potenza,35,1283,883,6,1,0,0,0,2173,794,1290,23,5,0,0,0,2112,4285
76,Potenza,36,1184,1003,15,0,1,0,0,2203,774,1378,33,11,0,0,0,2196,4399
76,Potenza,37,1078,1071,10,3,0,0,0,2162,613,1428,37,9,0,0,0,2087,4249
76,Potenza,38,1015,1156,25,3,0,0,0,2199,604,1442,42,7,0,0,0,2095,4294
76,Potenza,39,977,1231,22,3,0,0,0,2233,538,1529,50,12,0,0,0,2129,4362
76,Potenza,40,962,1385,29,0,0,0,0,2376,489,1664,60,16,0,0,0,2229,4605
76,Potenza,41,913,1416,42,2,0,0,0,2373,485,1807,64,12,0,0,0,2368,4741
76,Potenza,42,905,1607,34,5,0,0,0,2551,528,1893,70,27,0,0,0,2518,5069
76,Potenza,43,837,1670,32,3,0,0,0,2542,501,2050,69,20,0,0,0,2640,5182
76,Potenza,44,818,1813,49,1,1,0,0,2682,480,2025,63,34,0,0,0,2602,5284
76,Potenza,45,721,1816,50,8,2,0,0,2597,443,2062,87,41,0,0,0,2633,5230
76,Potenza,46,705,1840,59,9,0,0,0,2613,470,2154,107,44,0,0,0,2775,5388
76,Potenza,47,660,1973,51,12,0,0,0,2696,424,2231,91,40,0,0,0,2786,5482
76,Potenza,48,575,2056,66,15,1,0,0,2713,407,2295,98,62,0,0,0,2862,5575
76,Potenza,49,620,2288,62,16,0,0,0,2986,395,2331,93,73,0,0,0,2892,5878
76,Potenza,50,600,2193,69,17,0,0,0,2879,390,2325,111,90,0,0,0,2916,5795
76,Potenza,51,538,2351,71,23,0,0,0,2983,370,2520,103,105,0,0,0,3098,6081
76,Potenza,52,510,2211,56,25,0,0,0,2802,356,2452,87,112,0,0,0,3007,5809
76,Potenza,53,532,2321,67,22,0,0,0,2942,361,2432,99,113,0,0,0,3005,5947
76,Potenza,54,464,2439,82,32,0,0,0,3017,362,2541,109,117,0,0,0,3129,6146
76,Potenza,55,413,2344,86,37,0,0,0,2880,342,2385,86,145,0,0,0,2958,5838
76,Potenza,56,424,2465,84,30,0,0,0,3003,311,2399,95,169,0,0,0,2974,5977
76,Potenza,57,352,2358,76,44,0,0,0,2830,290,2304,95,196,0,0,0,2885,5715
76,Potenza,58,315,2339,63,37,0,0,0,2754,290,2310,105,205,0,0,0,2910,5664
76,Potenza,59,332,2157,58,35,0,0,0,2582,278,2138,69,240,0,0,0,2725,5307
76,Potenza,60,275,2172,65,35,1,0,0,2548,277,2020,74,220,0,0,0,2591,5139
76,Potenza,61,282,1997,64,44,0,0,0,2387,236,2062,66,288,0,0,0,2652,5039
76,Potenza,62,227,2130,60,46,0,0,0,2463,231,2053,66,287,0,0,0,2637,5100
76,Potenza,63,228,2114,63,62,0,0,0,2467,196,1883,60,282,0,0,0,2421,4888
76,Potenza,64,199,2042,53,64,0,0,0,2358,212,1918,66,340,0,0,0,2536,4894
76,Potenza,65,198,1973,45,60,0,0,0,2276,200,1716,51,359,0,0,0,2326,4602
76,Potenza,66,153,1884,44,68,0,0,0,2149,205,1682,41,374,0,0,0,2302,4451
76,Potenza,67,152,1822,48,83,0,0,0,2105,142,1653,29,416,0,0,0,2240,4345
76,Potenza,68,128,1957,36,95,0,0,0,2216,160,1553,33,463,0,0,0,2209,4425
76,Potenza,69,141,1980,33,88,0,0,0,2242,156,1543,48,508,0,0,0,2255,4497
76,Potenza,70,129,1863,33,98,0,0,0,2123,168,1544,33,663,0,0,0,2408,4531
76,Potenza,71,130,1652,28,103,0,0,0,1913,156,1404,31,614,0,0,0,2205,4118
76,Potenza,72,105,1513,28,116,0,0,0,1762,135,1285,24,598,0,0,0,2042,3804
76,Potenza,73,73,1108,20,84,0,0,0,1285,124,891,19,542,0,0,0,1576,2861
76,Potenza,74,71,1098,11,98,0,0,0,1278,105,817,12,532,0,0,0,1466,2744
76,Potenza,75,66,1088,13,116,0,0,0,1283,94,819,17,521,0,0,0,1451,2734
76,Potenza,76,49,1044,10,128,0,0,0,1231,90,773,19,652,0,0,0,1534,2765
76,Potenza,77,63,1040,11,137,0,0,0,1251,91,784,13,672,0,0,0,1560,2811
76,Potenza,78,77,1234,17,159,0,0,0,1487,103,810,20,831,0,0,0,1764,3251
76,Potenza,79,64,1234,12,171,0,0,0,1481,111,817,13,955,0,0,0,1896,3377
76,Potenza,80,40,1145,12,191,0,0,0,1388,113,697,10,956,0,0,0,1776,3164
76,Potenza,81,61,1006,10,214,0,0,0,1291,121,660,17,1009,0,0,0,1807,3098
76,Potenza,82,58,934,11,222,0,0,0,1225,97,527,7,1017,0,0,0,1648,2873
76,Potenza,83,41,848,6,208,0,0,0,1103,117,500,9,1012,0,0,0,1638,2741
76,Potenza,84,47,749,2,218,0,0,0,1016,106,446,6,1094,0,0,0,1652,2668
76,Potenza,85,43,679,3,239,0,0,0,964,84,338,10,1053,0,0,0,1485,2449
76,Potenza,86,23,551,2,198,0,0,0,774,94,266,7,929,0,0,0,1296,2070
76,Potenza,87,29,435,1,224,0,0,0,689,83,228,7,894,0,0,0,1212,1901
76,Potenza,88,31,414,2,212,0,0,0,659,74,179,2,903,0,0,0,1158,1817
76,Potenza,89,20,314,4,196,0,0,0,534,78,130,4,757,0,0,0,969,1503
76,Potenza,90,17,227,4,160,0,0,0,408,62,87,2,619,0,0,0,770,1178
76,Potenza,91,13,186,1,135,0,0,0,335,41,72,5,556,0,0,0,674,1009
76,Potenza,92,7,110,0,114,0,0,0,231,48,36,1,492,0,0,0,577,808
76,Potenza,93,6,69,0,88,0,0,0,163,31,33,1,374,0,0,0,439,602
76,Potenza,94,7,42,0,74,0,0,0,123,29,22,1,265,0,0,0,317,440
76,Potenza,95,3,46,0,81,0,0,0,130,15,13,0,222,0,0,0,250,380
76,Potenza,96,2,32,0,44,0,0,0,78,16,9,1,167,0,0,0,193,271
76,Potenza,97,3,10,1,37,0,0,0,51,10,5,1,144,0,0,0,160,211
76,Potenza,98,4,12,0,22,0,0,0,38,4,2,0,76,0,0,0,82,120
76,Potenza,99,0,3,0,7,0,0,0,10,3,1,1,36,0,0,0,41,51
76,Potenza,100,0,2,0,11,0,0,0,13,9,3,0,56,0,0,0,68,81
77,Matera,0,667,0,0,0,0,0,0,667,715,0,0,0,0,0,0,715,1382
77,Matera,1,727,0,0,0,0,0,0,727,662,0,0,0,0,0,0,662,1389
77,Matera,2,752,0,0,0,0,0,0,752,743,0,0,0,0,0,0,743,1495
77,Matera,3,756,0,0,0,0,0,0,756,699,0,0,0,0,0,0,699,1455
77,Matera,4,726,0,0,0,0,0,0,726,774,0,0,0,0,0,0,774,1500
77,Matera,5,802,0,0,0,0,0,0,802,728,0,0,0,0,0,0,728,1530
77,Matera,6,822,0,0,0,0,0,0,822,793,0,0,0,0,0,0,793,1615
77,Matera,7,816,0,0,0,0,0,0,816,812,0,0,0,0,0,0,812,1628
77,Matera,8,852,0,0,0,0,0,0,852,830,0,0,0,0,0,0,830,1682
77,Matera,9,856,0,0,0,0,0,0,856,827,0,0,0,0,0,0,827,1683
77,Matera,10,933,0,0,0,0,0,0,933,856,0,0,0,0,0,0,856,1789
77,Matera,11,905,0,0,0,0,0,0,905,821,0,0,0,0,0,0,821,1726
77,Matera,12,997,0,0,0,0,0,0,997,830,0,0,0,0,0,0,830,1827
77,Matera,13,933,0,0,0,0,0,0,933,871,0,0,0,0,0,0,871,1804
77,Matera,14,943,0,0,0,0,0,0,943,1006,0,0,0,0,0,0,1006,1949
77,Matera,15,1036,0,0,0,0,0,0,1036,937,0,0,0,0,0,0,937,1973
77,Matera,16,1013,0,0,0,0,0,0,1013,985,0,0,0,0,0,0,985,1998
77,Matera,17,1049,0,0,0,0,0,0,1049,927,0,0,0,0,0,0,927,1976
77,Matera,18,1176,0,0,0,0,0,0,1176,963,1,0,0,0,0,0,964,2140
77,Matera,19,1097,0,1,0,0,0,0,1098,983,4,0,0,0,0,0,987,2085
77,Matera,20,1127,1,0,0,0,0,0,1128,945,13,0,0,0,0,0,958,2086
77,Matera,21,1118,2,0,0,0,0,0,1120,1020,21,0,0,0,0,0,1041,2161
77,Matera,22,1125,7,0,0,0,0,0,1132,1007,33,0,1,0,0,0,1041,2173
77,Matera,23,1112,7,0,0,0,0,0,1119,961,45,0,0,0,0,0,1006,2125
77,Matera,24,1072,23,0,0,0,0,0,1095,999,71,0,0,0,0,0,1070,2165
77,Matera,25,1150,26,0,0,0,0,0,1176,999,95,2,0,0,0,0,1096,2272
77,Matera,26,1199,48,1,0,0,0,0,1248,981,135,2,0,0,0,0,1118,2366
77,Matera,27,1174,56,0,1,0,0,0,1231,976,173,3,0,0,0,0,1152,2383
77,Matera,28,1217,107,2,0,0,0,0,1326,915,304,10,0,0,0,0,1229,2555
77,Matera,29,1080,148,1,0,0,0,0,1229,790,323,1,2,0,0,0,1116,2345
77,Matera,30,1012,208,1,0,0,0,0,1221,751,416,11,0,0,0,0,1178,2399
77,Matera,31,966,293,5,0,0,0,0,1264,648,436,8,3,0,0,0,1095,2359
77,Matera,32,903,283,4,0,0,0,0,1190,557,500,16,0,0,0,0,1073,2263
77,Matera,33,816,359,7,0,0,0,0,1182,510,621,23,1,0,0,0,1155,2337
77,Matera,34,793,435,2,1,0,0,0,1231,470,662,20,2,0,0,0,1154,2385
77,Matera,35,726,504,8,0,1,0,0,1239,409,753,22,1,0,0,0,1185,2424
77,Matera,36,621,568,19,1,0,0,0,1209,399,754,24,4,0,0,0,1181,2390
77,Matera,37,631,636,18,1,0,0,0,1286,353,825,27,9,0,0,0,1214,2500
77,Matera,38,562,685,18,1,0,0,0,1266,341,834,24,3,0,0,0,1202,2468
77,Matera,39,539,738,18,1,0,0,0,1296,286,902,32,8,0,0,0,1228,2524
77,Matera,40,561,824,23,0,0,0,0,1408,280,976,39,8,0,0,0,1303,2711
77,Matera,41,477,811,24,0,0,0,0,1312,303,1038,65,8,0,0,0,1414,2726
77,Matera,42,524,953,29,0,0,0,0,1506,277,1035,70,15,0,0,0,1397,2903
77,Matera,43,467,941,47,2,0,0,0,1457,260,1112,55,16,0,0,0,1443,2900
77,Matera,44,461,1028,33,6,1,0,0,1529,248,1152,64,11,0,0,0,1475,3004
77,Matera,45,411,1041,49,4,0,0,0,1505,242,1068,80,15,0,0,0,1405,2910
77,Matera,46,343,1073,43,4,2,0,0,1465,212,1186,65,21,0,0,0,1484,2949
77,Matera,47,407,1011,45,3,0,0,0,1466,203,1184,63,32,0,0,0,1482,2948
77,Matera,48,322,1082,45,11,0,0,0,1460,212,1187,71,29,0,0,0,1499,2959
77,Matera,49,296,1075,54,5,0,0,0,1430,198,1161,64,51,0,0,0,1474,2904
77,Matera,50,278,1137,44,8,1,0,0,1468,202,1254,59,38,1,0,0,1554,3022
77,Matera,51,285,1151,49,8,1,0,0,1494,183,1231,78,52,1,0,0,1545,3039
77,Matera,52,240,1170,46,11,0,0,0,1467,193,1272,64,48,0,0,0,1577,3044
77,Matera,53,236,1166,61,13,0,0,0,1476,171,1291,52,49,0,0,0,1563,3039
77,Matera,54,205,1282,52,13,0,0,0,1552,184,1309,64,53,0,0,0,1610,3162
77,Matera,55,190,1207,67,19,0,0,0,1483,168,1183,51,79,0,0,0,1481,2964
77,Matera,56,166,1175,63,14,0,0,0,1418,150,1221,48,80,0,0,0,1499,2917
77,Matera,57,173,1125,54,17,0,0,0,1369,132,1266,57,89,0,0,0,1544,2913
77,Matera,58,127,1141,45,20,0,0,0,1333,142,1169,54,119,0,0,0,1484,2817
77,Matera,59,145,1168,44,23,0,0,0,1380,147,1174,38,95,0,0,0,1454,2834
77,Matera,60,118,1147,32,20,0,0,0,1317,114,1122,39,135,0,0,0,1410,2727
77,Matera,61,113,1050,35,20,0,0,0,1218,129,1104,49,136,0,0,0,1418,2636
77,Matera,62,117,1151,42,30,0,0,0,1340,126,1093,36,137,0,0,0,1392,2732
77,Matera,63,118,1100,18,29,0,0,0,1265,98,1066,35,147,0,0,0,1346,2611
77,Matera,64,74,1119,28,33,0,0,0,1254,102,1039,25,168,0,0,0,1334,2588
77,Matera,65,69,987,30,38,0,0,0,1124,88,899,14,187,0,0,0,1188,2312
77,Matera,66,65,1003,30,33,0,0,0,1131,93,904,34,198,0,0,0,1229,2360
77,Matera,67,64,972,21,38,0,0,0,1095,82,910,35,215,0,0,0,1242,2337
77,Matera,68,78,1023,35,37,0,0,0,1173,85,935,22,249,0,0,0,1291,2464
77,Matera,69,63,1045,19,55,0,0,0,1182,67,939,20,255,0,0,0,1281,2463
77,Matera,70,65,1129,18,56,0,0,0,1268,84,916,15,307,0,0,0,1322,2590
77,Matera,71,54,971,20,63,0,0,0,1108,82,765,19,317,0,0,0,1183,2291
77,Matera,72,44,878,14,54,0,0,0,990,63,644,16,308,0,0,0,1031,2021
77,Matera,73,32,696,13,39,0,0,0,780,58,552,10,283,0,0,0,903,1683
77,Matera,74,37,706,16,42,0,0,0,801,54,512,8,299,0,0,0,873,1674
77,Matera,75,28,673,7,49,0,0,0,757,58,450,10,351,0,0,0,869,1626
77,Matera,76,34,625,5,50,0,0,0,714,66,431,6,370,0,0,0,873,1587
77,Matera,77,25,567,4,56,0,0,0,652,54,399,7,358,0,0,0,818,1470
77,Matera,78,29,673,7,83,0,0,0,792,60,408,3,486,0,0,0,957,1749
77,Matera,79,28,646,4,105,0,0,0,783,58,398,5,514,0,0,0,975,1758
77,Matera,80,25,546,3,74,0,0,0,648,56,381,3,502,0,0,0,942,1590
77,Matera,81,32,552,3,96,0,0,0,683,54,305,7,546,0,0,0,912,1595
77,Matera,82,31,461,5,91,0,0,0,588,50,293,3,513,0,0,0,859,1447
77,Matera,83,18,409,3,100,0,0,0,530,40,250,3,517,0,0,0,810,1340
77,Matera,84,15,414,6,121,0,0,0,556,41,186,1,514,0,0,0,742,1298
77,Matera,85,10,337,1,95,0,0,0,443,45,160,6,515,0,0,0,726,1169
77,Matera,86,11,305,1,112,0,0,0,429,49,118,1,435,0,0,0,603,1032
77,Matera,87,9,250,0,110,0,0,0,369,25,91,1,412,0,0,0,529,898
77,Matera,88,9,195,3,94,0,0,0,301,40,78,2,423,0,0,0,543,844
77,Matera,89,6,159,0,80,0,0,0,245,32,42,0,346,0,0,0,420,665
77,Matera,90,10,132,1,71,0,0,0,214,24,28,1,303,0,0,0,356,570
77,Matera,91,6,108,1,54,0,0,0,169,23,22,0,249,0,0,0,294,463
77,Matera,92,2,62,1,58,0,0,0,123,14,18,0,216,0,0,0,248,371
77,Matera,93,3,47,0,39,0,0,0,89,11,15,1,150,0,0,0,177,266
77,Matera,94,2,35,1,48,0,0,0,86,12,7,0,107,0,0,0,126,212
77,Matera,95,2,22,0,22,0,0,0,46,9,5,0,106,0,0,0,120,166
77,Matera,96,2,13,0,23,0,0,0,38,6,0,0,86,0,0,0,92,130
77,Matera,97,0,4,0,18,0,0,0,22,1,3,0,64,0,0,0,68,90
77,Matera,98,0,2,0,7,0,0,0,9,0,1,1,37,0,0,0,39,48
77,Matera,99,0,2,0,5,0,0,0,7,2,2,0,22,0,0,0,26,33
77,Matera,100,0,1,0,4,0,0,0,5,3,1,0,23,0,0,0,27,32
78,Cosenza,0,2708,0,0,0,0,0,0,2708,2542,0,0,0,0,0,0,2542,5250
78,Cosenza,1,2686,0,0,0,0,0,0,2686,2729,0,0,0,0,0,0,2729,5415
78,Cosenza,2,2913,0,0,0,0,0,0,2913,2729,0,0,0,0,0,0,2729,5642
78,Cosenza,3,2853,0,0,0,0,0,0,2853,2805,0,0,0,0,0,0,2805,5658
78,Cosenza,4,2918,0,0,0,0,0,0,2918,2785,0,0,0,0,0,0,2785,5703
78,Cosenza,5,2847,0,0,0,0,0,0,2847,2877,0,0,0,0,0,0,2877,5724
78,Cosenza,6,2949,0,0,0,0,0,0,2949,2752,0,0,0,0,0,0,2752,5701
78,Cosenza,7,3102,0,0,0,0,0,0,3102,2879,0,0,0,0,0,0,2879,5981
78,Cosenza,8,3006,0,0,0,0,0,0,3006,2912,0,0,0,0,0,0,2912,5918
78,Cosenza,9,3280,0,0,0,0,0,0,3280,3066,0,0,0,0,0,0,3066,6346
78,Cosenza,10,3077,0,0,0,0,0,0,3077,3068,0,0,0,0,0,0,3068,6145
78,Cosenza,11,3173,0,0,0,0,0,0,3173,3008,0,0,0,0,0,0,3008,6181
78,Cosenza,12,3356,0,0,0,0,0,0,3356,3060,0,0,0,0,0,0,3060,6416
78,Cosenza,13,3304,0,0,0,0,0,0,3304,3035,0,0,0,0,0,0,3035,6339
78,Cosenza,14,3390,0,0,0,0,0,0,3390,3166,0,0,0,0,0,0,3166,6556
78,Cosenza,15,3346,0,0,0,0,0,0,3346,3230,0,0,0,0,0,0,3230,6576
78,Cosenza,16,3464,0,0,0,0,0,0,3464,3163,0,0,0,0,0,0,3163,6627
78,Cosenza,17,3408,0,0,0,0,0,0,3408,3266,0,0,0,0,0,0,3266,6674
78,Cosenza,18,3574,1,0,0,0,0,0,3575,3269,2,0,0,0,0,0,3271,6846
78,Cosenza,19,3612,3,0,0,0,0,0,3615,3296,11,1,0,0,0,0,3308,6923
78,Cosenza,20,3623,7,0,0,0,0,0,3630,3347,25,0,0,0,0,0,3372,7002
78,Cosenza,21,3656,11,0,0,0,0,0,3667,3316,54,1,0,0,0,0,3371,7038
78,Cosenza,22,3861,20,0,0,0,0,0,3881,3340,99,0,0,0,0,0,3439,7320
78,Cosenza,23,3790,32,1,0,0,0,0,3823,3332,164,1,0,0,0,0,3497,7320
78,Cosenza,24,3981,68,1,0,0,0,0,4050,3458,270,2,0,0,0,0,3730,7780
78,Cosenza,25,4090,115,2,1,0,0,0,4208,3468,399,1,1,0,0,0,3869,8077
78,Cosenza,26,4074,176,1,0,0,0,0,4251,3524,574,2,0,1,0,0,4101,8352
78,Cosenza,27,4000,316,1,0,0,0,0,4317,3267,765,6,3,0,0,0,4041,8358
78,Cosenza,28,3963,404,4,0,1,0,0,4372,3187,1006,9,3,0,0,0,4205,8577
78,Cosenza,29,3825,604,3,0,0,0,0,4432,3026,1372,16,0,0,0,0,4414,8846
78,Cosenza,30,3634,862,3,1,0,0,0,4500,2766,1607,21,2,0,0,0,4396,8896
78,Cosenza,31,3421,1022,4,1,0,0,0,4448,2493,1826,30,2,0,0,0,4351,8799
78,Cosenza,32,3151,1174,8,2,1,0,0,4336,2179,2120,20,11,0,0,0,4330,8666
78,Cosenza,33,3001,1512,16,1,1,0,0,4531,2074,2239,32,9,0,0,0,4354,8885
78,Cosenza,34,2832,1776,13,1,1,0,0,4623,1877,2420,49,13,0,0,0,4359,8982
78,Cosenza,35,2616,1913,26,0,0,0,0,4555,1607,2661,49,11,0,0,0,4328,8883
78,Cosenza,36,2367,2098,24,0,0,0,0,4489,1526,2904,53,21,1,0,0,4505,8994
78,Cosenza,37,2291,2250,23,2,1,0,0,4567,1433,3033,67,13,0,0,0,4546,9113
78,Cosenza,38,2028,2557,40,4,0,0,0,4629,1303,3136,90,19,0,0,0,4548,9177
78,Cosenza,39,1943,2699,42,5,0,0,0,4689,1274,3257,97,22,0,0,0,4650,9339
78,Cosenza,40,1829,2886,59,8,0,0,0,4782,1158,3491,116,30,0,0,0,4795,9577
78,Cosenza,41,1814,3001,58,3,0,0,0,4876,1091,3635,115,42,0,0,0,4883,9759
78,Cosenza,42,1793,3206,54,11,0,0,0,5064,1090,3807,121,57,0,0,0,5075,10139
78,Cosenza,43,1661,3444,63,9,2,0,0,5179,997,3849,158,54,1,0,0,5059,10238
78,Cosenza,44,1465,3496,82,9,0,1,0,5053,963,4036,149,47,1,0,0,5196,10249
78,Cosenza,45,1448,3477,99,17,0,0,0,5041,914,4068,165,87,0,0,0,5234,10275
78,Cosenza,46,1345,3679,99,25,1,0,0,5149,894,4183,182,85,0,0,0,5344,10493
78,Cosenza,47,1339,3629,93,19,0,0,0,5080,812,4291,204,103,2,0,0,5412,10492
78,Cosenza,48,1146,3798,125,19,0,0,0,5088,852,4162,219,138,0,0,0,5371,10459
78,Cosenza,49,1172,3937,154,29,0,0,0,5292,850,4611,193,144,0,0,0,5798,11090
78,Cosenza,50,1190,3986,115,24,0,0,0,5315,802,4415,205,165,1,0,0,5588,10903
78,Cosenza,51,1017,4192,144,42,1,0,0,5396,730,4543,227,164,0,0,0,5664,11060
78,Cosenza,52,922,4221,126,37,0,0,0,5306,728,4439,193,196,0,0,0,5556,10862
78,Cosenza,53,879,4234,139,46,0,0,0,5298,716,4514,209,234,0,0,0,5673,10971
78,Cosenza,54,847,4448,159,64,4,0,0,5522,717,4730,205,273,0,0,0,5925,11447
78,Cosenza,55,792,4276,142,65,0,1,0,5276,636,4388,177,308,0,0,0,5509,10785
78,Cosenza,56,727,4301,111,69,0,0,0,5208,610,4433,168,317,0,0,0,5528,10736
78,Cosenza,57,694,4308,135,74,0,0,0,5211,599,4349,162,367,0,0,0,5477,10688
78,Cosenza,58,621,4277,135,76,0,0,0,5109,544,4280,189,411,0,0,0,5424,10533
78,Cosenza,59,598,4243,125,77,0,0,0,5043,528,4115,142,442,0,0,0,5227,10270
78,Cosenza,60,561,3882,111,82,0,0,0,4636,483,3827,163,479,0,0,0,4952,9588
78,Cosenza,61,470,4116,122,92,0,0,0,4800,480,3792,154,530,0,0,0,4956,9756
78,Cosenza,62,444,3908,101,93,0,0,0,4546,440,3819,145,552,0,0,0,4956,9502
78,Cosenza,63,414,3924,102,98,0,0,0,4538,430,3754,125,642,0,0,0,4951,9489
78,Cosenza,64,375,3985,101,116,0,0,0,4577,403,3520,117,678,0,0,0,4718,9295
78,Cosenza,65,288,3673,99,135,1,0,0,4196,347,3341,115,699,0,0,0,4502,8698
78,Cosenza,66,305,3515,85,136,0,0,0,4041,346,3144,113,748,0,0,0,4351,8392
78,Cosenza,67,288,3624,74,140,0,0,0,4126,335,3133,120,835,0,0,0,4423,8549
78,Cosenza,68,270,3648,78,156,0,0,0,4152,320,3060,98,892,0,0,0,4370,8522
78,Cosenza,69,255,3669,106,194,0,0,0,4224,297,3005,107,1036,0,0,0,4445,8669
78,Cosenza,70,236,3635,63,166,0,0,0,4100,319,2958,90,1120,0,0,0,4487,8587
78,Cosenza,71,220,3474,66,195,0,0,0,3955,296,2742,93,1206,0,0,0,4337,8292
78,Cosenza,72,225,3112,52,223,0,0,0,3612,259,2412,68,1168,0,0,0,3907,7519
78,Cosenza,73,132,2296,38,191,0,0,0,2657,177,1693,44,960,0,0,0,2874,5531
78,Cosenza,74,155,2383,50,203,1,0,0,2792,200,1710,46,1073,0,0,0,3029,5821
78,Cosenza,75,128,2249,39,192,0,0,0,2608,219,1576,38,1161,0,0,0,2994,5602
78,Cosenza,76,116,2168,31,207,0,0,0,2522,193,1485,37,1198,0,0,0,2913,5435
78,Cosenza,77,118,2117,29,236,0,0,0,2500,174,1339,38,1224,0,0,0,2775,5275
78,Cosenza,78,124,2313,32,311,0,0,0,2780,177,1466,41,1589,0,0,0,3273,6053
78,Cosenza,79,106,2251,30,324,0,0,0,2711,203,1339,40,1659,0,0,0,3241,5952
78,Cosenza,80,111,1955,19,349,0,0,0,2434,197,1218,32,1669,0,0,0,3116,5550
78,Cosenza,81,82,1842,18,347,0,0,0,2289,197,1055,25,1645,0,0,0,2922,5211
78,Cosenza,82,89,1667,14,340,0,0,0,2110,196,919,24,1671,0,0,0,2810,4920
78,Cosenza,83,82,1546,14,373,0,0,0,2015,181,791,23,1750,0,0,0,2745,4760
78,Cosenza,84,77,1334,14,373,0,0,0,1798,163,663,27,1663,0,0,0,2516,4314
78,Cosenza,85,74,1118,9,416,0,0,0,1617,189,554,18,1650,0,0,0,2411,4028
78,Cosenza,86,49,994,6,356,0,0,0,1405,162,447,14,1602,0,0,0,2225,3630
78,Cosenza,87,37,813,4,337,0,0,0,1191,144,371,16,1421,0,0,0,1952,3143
78,Cosenza,88,33,669,9,344,0,0,0,1055,133,327,13,1373,0,0,0,1846,2901
78,Cosenza,89,36,520,2,284,0,0,0,842,113,207,10,1167,0,0,0,1497,2339
78,Cosenza,90,28,379,5,227,0,0,0,639,103,156,5,978,0,0,0,1242,1881
78,Cosenza,91,16,283,1,222,0,0,0,522,97,110,2,831,0,0,0,1040,1562
78,Cosenza,92,16,214,1,178,0,0,0,409,76,77,5,753,0,0,0,911,1320
78,Cosenza,93,13,156,0,133,0,0,0,302,61,63,8,557,0,0,0,689,991
78,Cosenza,94,7,114,2,125,0,0,0,248,59,43,4,460,0,0,0,566,814
78,Cosenza,95,12,64,1,83,0,0,0,160,44,30,3,372,0,0,0,449,609
78,Cosenza,96,5,61,0,59,0,0,0,125,26,18,1,226,0,0,0,271,396
78,Cosenza,97,7,25,0,39,0,0,0,71,19,10,2,196,0,0,0,227,298
78,Cosenza,98,2,23,1,31,0,0,0,57,21,12,0,118,0,0,0,151,208
78,Cosenza,99,0,10,0,16,0,0,0,26,13,13,1,64,0,0,0,91,117
78,Cosenza,100,6,22,0,29,0,0,0,57,19,12,0,95,0,0,0,126,183
79,Catanzaro,0,1356,0,0,0,0,0,0,1356,1301,0,0,0,0,0,0,1301,2657
79,Catanzaro,1,1504,0,0,0,0,0,0,1504,1372,0,0,0,0,0,0,1372,2876
79,Catanzaro,2,1567,0,0,0,0,0,0,1567,1471,0,0,0,0,0,0,1471,3038
79,Catanzaro,3,1502,0,0,0,0,0,0,1502,1438,0,0,0,0,0,0,1438,2940
79,Catanzaro,4,1565,0,0,0,0,0,0,1565,1438,0,0,0,0,0,0,1438,3003
79,Catanzaro,5,1504,0,0,0,0,0,0,1504,1460,0,0,0,0,0,0,1460,2964
79,Catanzaro,6,1641,0,0,0,0,0,0,1641,1521,0,0,0,0,0,0,1521,3162
79,Catanzaro,7,1620,0,0,0,0,0,0,1620,1488,0,0,0,0,0,0,1488,3108
79,Catanzaro,8,1565,0,0,0,0,0,0,1565,1537,0,0,0,0,0,0,1537,3102
79,Catanzaro,9,1574,0,0,0,0,0,0,1574,1506,0,0,0,0,0,0,1506,3080
79,Catanzaro,10,1576,0,0,0,0,0,0,1576,1618,0,0,0,0,0,0,1618,3194
79,Catanzaro,11,1695,0,0,0,0,0,0,1695,1553,0,0,0,0,0,0,1553,3248
79,Catanzaro,12,1779,0,0,0,0,0,0,1779,1559,0,0,0,0,0,0,1559,3338
79,Catanzaro,13,1603,0,0,0,0,0,0,1603,1554,0,0,0,0,0,0,1554,3157
79,Catanzaro,14,1771,0,0,0,0,0,0,1771,1636,0,0,0,0,0,0,1636,3407
79,Catanzaro,15,1751,0,0,0,0,0,0,1751,1670,0,0,0,0,0,0,1670,3421
79,Catanzaro,16,1775,0,0,0,0,0,0,1775,1600,0,0,0,0,0,0,1600,3375
79,Catanzaro,17,1809,1,0,0,0,0,0,1810,1776,0,0,0,0,0,0,1776,3586
79,Catanzaro,18,1909,0,0,0,0,0,0,1909,1807,0,0,0,0,0,0,1807,3716
79,Catanzaro,19,1844,4,0,0,0,0,0,1848,1834,8,0,0,0,0,0,1842,3690
79,Catanzaro,20,2022,4,0,0,0,0,0,2026,1815,23,0,0,0,0,0,1838,3864
79,Catanzaro,21,1988,10,1,0,0,0,0,1999,1764,53,1,0,0,0,0,1818,3817
79,Catanzaro,22,1966,15,1,0,0,0,0,1982,1765,62,1,0,0,0,0,1828,3810
79,Catanzaro,23,1983,27,0,0,1,0,0,2011,1874,101,0,0,0,0,0,1975,3986
79,Catanzaro,24,1999,35,0,0,0,0,0,2034,1763,147,1,0,0,0,0,1911,3945
79,Catanzaro,25,2034,76,1,0,0,0,0,2111,1767,263,2,0,0,0,0,2032,4143
79,Catanzaro,26,2103,116,3,0,0,0,0,2222,1818,376,3,0,0,0,0,2197,4419
79,Catanzaro,27,2031,188,3,0,0,0,0,2222,1729,445,6,0,0,0,0,2180,4402
79,Catanzaro,28,2078,259,1,0,0,0,0,2338,1578,580,6,0,0,0,0,2164,4502
79,Catanzaro,29,1903,364,2,0,1,0,0,2270,1361,730,6,1,0,0,0,2098,4368
79,Catanzaro,30,1903,467,7,0,0,0,0,2377,1321,895,12,1,0,0,0,2229,4606
79,Catanzaro,31,1649,608,3,0,0,0,0,2260,1147,996,16,2,0,0,0,2161,4421
79,Catanzaro,32,1526,732,5,0,0,0,0,2263,1026,1065,18,3,0,0,0,2112,4375
79,Catanzaro,33,1450,813,8,1,0,0,0,2272,961,1154,19,5,0,0,0,2139,4411
79,Catanzaro,34,1352,934,8,1,0,0,0,2295,886,1309,30,3,0,0,0,2228,4523
79,Catanzaro,35,1237,1012,11,0,1,0,0,2261,769,1479,37,4,0,0,0,2289,4550
79,Catanzaro,36,1103,1117,27,3,0,0,0,2250,758,1496,31,11,0,0,0,2296,4546
79,Catanzaro,37,1052,1234,12,2,0,0,0,2300,675,1494,46,10,0,0,0,2225,4525
79,Catanzaro,38,997,1243,27,2,0,0,0,2269,588,1630,45,8,0,0,0,2271,4540
79,Catanzaro,39,945,1295,32,3,0,0,0,2275,607,1663,53,12,1,0,0,2336,4611
79,Catanzaro,40,924,1527,38,4,0,0,0,2493,545,1713,50,16,0,0,0,2324,4817
79,Catanzaro,41,835,1512,45,4,0,0,0,2396,565,1834,65,17,0,0,0,2481,4877
79,Catanzaro,42,796,1632,41,3,1,0,0,2473,542,1939,70,28,0,0,0,2579,5052
79,Catanzaro,43,787,1615,40,5,0,0,0,2447,492,1890,76,27,0,0,0,2485,4932
79,Catanzaro,44,764,1706,48,6,0,0,0,2524,458,1966,87,33,0,0,0,2544,5068
79,Catanzaro,45,715,1656,67,8,2,0,0,2448,405,1982,99,40,1,0,0,2527,4975
79,Catanzaro,46,658,1726,63,9,0,0,0,2456,398,2048,104,48,1,0,0,2599,5055
79,Catanzaro,47,594,1803,50,13,1,0,0,2461,421,2200,112,50,2,0,0,2785,5246
79,Catanzaro,48,577,1953,67,9,0,0,0,2606,446,2166,95,52,0,0,0,2759,5365
79,Catanzaro,49,568,1973,60,12,0,0,0,2613,408,2203,105,52,0,0,0,2768,5381
79,Catanzaro,50,488,2041,66,12,1,0,0,2608,383,2180,124,90,0,0,0,2777,5385
79,Catanzaro,51,504,2042,85,12,0,0,0,2643,379,2281,107,106,1,1,0,2875,5518
79,Catanzaro,52,497,2027,84,16,1,0,0,2625,372,2353,117,109,1,0,0,2952,5577
79,Catanzaro,53,405,2101,85,23,2,0,0,2616,339,2271,105,106,0,0,0,2821,5437
79,Catanzaro,54,465,2191,99,33,0,0,0,2788,365,2423,106,156,0,0,0,3050,5838
79,Catanzaro,55,355,2174,70,28,0,0,0,2627,302,2369,99,148,1,0,0,2919,5546
79,Catanzaro,56,355,2104,75,29,0,0,0,2563,312,2317,110,152,0,0,0,2891,5454
79,Catanzaro,57,325,2101,86,29,0,0,0,2541,295,2187,87,183,0,0,0,2752,5293
79,Catanzaro,58,338,2226,77,31,0,0,0,2672,260,2177,88,219,2,0,0,2746,5418
79,Catanzaro,59,275,2081,69,36,0,0,0,2461,275,2108,86,245,0,0,0,2714,5175
79,Catanzaro,60,259,1992,76,44,0,0,0,2371,237,1949,82,255,0,0,0,2523,4894
79,Catanzaro,61,229,2086,62,51,0,0,0,2428,219,2005,85,248,0,0,0,2557,4985
79,Catanzaro,62,231,2051,53,52,0,0,0,2387,211,1890,83,276,0,0,0,2460,4847
79,Catanzaro,63,204,2038,74,46,0,0,0,2362,171,1830,80,319,0,0,0,2400,4762
79,Catanzaro,64,192,2026,54,56,0,0,0,2328,200,1861,65,336,0,0,0,2462,4790
79,Catanzaro,65,177,2019,57,70,0,0,0,2323,192,1663,65,335,0,0,0,2255,4578
79,Catanzaro,66,128,1857,52,63,0,0,0,2100,166,1506,53,377,0,0,0,2102,4202
79,Catanzaro,67,129,1829,49,73,0,0,0,2080,173,1572,48,459,0,0,0,2252,4332
79,Catanzaro,68,150,1802,41,79,0,0,0,2072,195,1556,65,477,0,0,0,2293,4365
79,Catanzaro,69,112,1832,48,72,0,0,0,2064,151,1447,54,522,0,0,0,2174,4238
79,Catanzaro,70,144,1759,35,105,0,0,0,2043,153,1437,41,604,0,0,0,2235,4278
79,Catanzaro,71,119,1765,40,101,0,0,0,2025,145,1324,34,606,0,0,0,2109,4134
79,Catanzaro,72,111,1580,31,114,0,0,0,1836,151,1202,39,659,0,0,0,2051,3887
79,Catanzaro,73,71,1216,26,78,0,0,0,1391,112,856,36,511,0,0,0,1515,2906
79,Catanzaro,74,75,1217,14,94,0,0,0,1400,115,805,25,558,0,0,0,1503,2903
79,Catanzaro,75,56,1172,29,101,0,0,0,1358,104,803,25,625,0,0,0,1557,2915
79,Catanzaro,76,60,1121,28,101,0,0,0,1310,90,760,25,693,0,0,0,1568,2878
79,Catanzaro,77,61,967,18,96,0,0,0,1142,103,664,20,648,0,0,0,1435,2577
79,Catanzaro,78,55,1099,8,148,0,0,0,1310,114,703,30,808,0,0,0,1655,2965
79,Catanzaro,79,53,995,12,139,0,0,0,1199,109,613,22,784,0,0,0,1528,2727
79,Catanzaro,80,48,916,14,129,0,0,0,1107,94,559,14,772,0,0,0,1439,2546
79,Catanzaro,81,39,905,11,151,0,0,0,1106,103,478,13,819,0,0,0,1413,2519
79,Catanzaro,82,26,741,7,159,0,0,0,933,82,455,15,826,0,0,0,1378,2311
79,Catanzaro,83,40,650,9,170,0,0,0,869,88,428,18,848,0,0,0,1382,2251
79,Catanzaro,84,28,655,5,195,0,0,0,883,95,317,12,874,0,0,0,1298,2181
79,Catanzaro,85,43,627,2,184,0,0,0,856,76,283,9,856,0,0,0,1224,2080
79,Catanzaro,86,22,457,4,191,0,0,0,674,79,248,6,800,0,0,0,1133,1807
79,Catanzaro,87,17,411,2,178,0,0,0,608,62,179,8,796,0,0,0,1045,1653
79,Catanzaro,88,12,339,3,150,0,0,0,504,71,116,15,734,0,0,0,936,1440
79,Catanzaro,89,15,218,1,122,0,0,0,356,49,114,4,620,0,0,0,787,1143
79,Catanzaro,90,6,205,5,120,0,0,0,336,53,94,4,511,0,0,0,662,998
79,Catanzaro,91,12,141,2,108,0,0,0,263,51,51,3,461,0,0,0,566,829
79,Catanzaro,92,10,106,0,97,0,0,0,213,41,47,1,374,0,0,0,463,676
79,Catanzaro,93,4,83,1,88,0,0,0,176,38,25,1,319,0,0,0,383,559
79,Catanzaro,94,4,59,0,46,0,0,0,109,28,26,1,228,0,0,0,283,392
79,Catanzaro,95,3,42,0,49,0,0,0,94,17,14,1,173,0,0,0,205,299
79,Catanzaro,96,1,31,1,28,0,0,0,61,16,4,2,120,0,0,0,142,203
79,Catanzaro,97,3,21,0,22,0,0,0,46,7,6,0,114,0,0,0,127,173
79,Catanzaro,98,0,11,0,16,0,0,0,27,7,3,2,83,0,0,0,95,122
79,Catanzaro,99,0,3,0,8,0,0,0,11,5,2,0,39,0,0,0,46,57
79,Catanzaro,100,3,9,1,10,0,0,0,23,6,3,2,45,0,0,0,56,79
80,Reggio di Calabria,0,2291,0,0,0,0,0,0,2291,2177,0,0,0,0,0,0,2177,4468
80,Reggio di Calabria,1,2414,0,0,0,0,0,0,2414,2224,0,0,0,0,0,0,2224,4638
80,Reggio di Calabria,2,2364,0,0,0,0,0,0,2364,2177,0,0,0,0,0,0,2177,4541
80,Reggio di Calabria,3,2515,0,0,0,0,0,0,2515,2290,0,0,0,0,0,0,2290,4805
80,Reggio di Calabria,4,2511,0,0,0,0,0,0,2511,2296,0,0,0,0,0,0,2296,4807
80,Reggio di Calabria,5,2540,0,0,0,0,0,0,2540,2359,0,0,0,0,0,0,2359,4899
80,Reggio di Calabria,6,2518,0,0,0,0,0,0,2518,2385,0,0,0,0,0,0,2385,4903
80,Reggio di Calabria,7,2590,0,0,0,0,0,0,2590,2456,0,0,0,0,0,0,2456,5046
80,Reggio di Calabria,8,2773,0,0,0,0,0,0,2773,2538,0,0,0,0,0,0,2538,5311
80,Reggio di Calabria,9,2767,0,0,0,0,0,0,2767,2499,0,0,0,0,0,0,2499,5266
80,Reggio di Calabria,10,2694,0,0,0,0,0,0,2694,2581,0,0,0,0,0,0,2581,5275
80,Reggio di Calabria,11,2786,0,0,0,0,0,0,2786,2614,0,0,0,0,0,0,2614,5400
80,Reggio di Calabria,12,2822,0,0,0,0,0,0,2822,2634,0,0,0,0,0,0,2634,5456
80,Reggio di Calabria,13,2775,0,0,0,0,0,0,2775,2656,0,0,0,0,0,0,2656,5431
80,Reggio di Calabria,14,2841,0,0,0,0,0,0,2841,2584,0,0,0,0,0,0,2584,5425
80,Reggio di Calabria,15,2850,0,0,0,0,0,0,2850,2623,0,0,0,0,0,0,2623,5473
80,Reggio di Calabria,16,2799,0,0,0,0,0,0,2799,2655,0,0,0,0,0,0,2655,5454
80,Reggio di Calabria,17,2943,0,0,0,0,0,0,2943,2779,1,0,1,0,0,0,2781,5724
80,Reggio di Calabria,18,3137,0,0,0,0,0,0,3137,2881,4,0,0,0,0,0,2885,6022
80,Reggio di Calabria,19,3235,4,0,1,0,0,0,3240,2835,26,0,0,0,0,0,2861,6101
80,Reggio di Calabria,20,3087,9,0,0,0,0,0,3096,2920,62,0,0,0,0,0,2982,6078
80,Reggio di Calabria,21,3086,8,0,1,0,0,0,3095,2767,97,0,0,0,0,0,2864,5959
80,Reggio di Calabria,22,3146,26,0,0,0,0,0,3172,2789,194,1,0,1,0,0,2985,6157
80,Reggio di Calabria,23,3131,55,0,0,0,0,0,3186,2887,264,2,0,0,0,0,3153,6339
80,Reggio di Calabria,24,3273,95,1,1,1,0,0,3371,2673,347,1,2,0,0,0,3023,6394
80,Reggio di Calabria,25,3219,149,3,2,0,0,0,3373,2746,559,4,1,0,0,0,3310,6683
80,Reggio di Calabria,26,3146,248,4,0,0,0,0,3398,2585,772,3,1,1,0,0,3362,6760
80,Reggio di Calabria,27,3076,367,8,0,1,0,0,3452,2390,897,12,2,0,0,0,3301,6753
80,Reggio di Calabria,28,2933,578,7,0,1,0,0,3519,2236,1094,13,4,0,0,0,3347,6866
80,Reggio di Calabria,29,2844,695,10,2,0,0,0,3551,1981,1412,20,2,0,0,0,3415,6966
80,Reggio di Calabria,30,2659,930,9,1,0,0,0,3599,1865,1648,20,4,0,0,0,3537,7136
80,Reggio di Calabria,31,2450,1043,18,1,0,0,0,3512,1680,1863,19,4,0,0,0,3566,7078
80,Reggio di Calabria,32,2269,1272,20,0,1,0,0,3562,1457,1919,30,10,0,0,0,3416,6978
80,Reggio di Calabria,33,2000,1419,13,1,0,0,0,3433,1365,2025,36,7,0,0,0,3433,6866
80,Reggio di Calabria,34,1857,1631,19,3,0,0,0,3510,1162,2150,48,14,0,0,0,3374,6884
80,Reggio di Calabria,35,1683,1735,23,2,0,0,0,3443,1099,2275,52,14,0,0,0,3440,6883
80,Reggio di Calabria,36,1666,1843,29,1,1,0,0,3540,1014,2436,49,9,0,0,0,3508,7048
80,Reggio di Calabria,37,1522,1999,35,3,0,0,0,3559,926,2469,61,20,0,0,0,3476,7035
80,Reggio di Calabria,38,1469,2123,31,4,1,0,0,3628,937,2533,70,16,0,0,0,3556,7184
80,Reggio di Calabria,39,1394,2183,44,3,1,0,0,3625,823,2742,86,15,0,0,0,3666,7291
80,Reggio di Calabria,40,1274,2264,46,7,0,0,0,3591,799,2662,82,29,0,0,0,3572,7163
80,Reggio di Calabria,41,1144,2366,51,8,1,0,0,3570,840,2902,93,27,0,0,0,3862,7432
80,Reggio di Calabria,42,1207,2659,55,4,0,0,0,3925,765,3049,112,33,1,0,0,3960,7885
80,Reggio di Calabria,43,1121,2597,65,4,1,0,0,3788,719,3144,120,54,1,0,0,4038,7826
80,Reggio di Calabria,44,1113,2659,79,8,0,0,0,3859,724,3140,100,42,0,0,0,4006,7865
80,Reggio di Calabria,45,1086,2704,78,14,0,0,0,3882,660,3080,125,69,0,0,0,3934,7816
80,Reggio di Calabria,46,919,2626,77,11,0,0,0,3633,672,3145,134,76,0,0,0,4027,7660
80,Reggio di Calabria,47,893,2826,72,14,0,0,0,3805,628,3209,139,88,0,0,0,4064,7869
80,Reggio di Calabria,48,822,2735,91,15,0,0,0,3663,611,3127,130,94,0,0,0,3962,7625
80,Reggio di Calabria,49,840,2958,85,14,0,0,0,3897,620,3356,133,116,0,0,0,4225,8122
80,Reggio di Calabria,50,801,3003,107,24,1,0,0,3936,631,3322,142,109,0,0,0,4204,8140
80,Reggio di Calabria,51,759,3019,100,28,0,0,0,3906,591,3320,140,161,0,0,0,4212,8118
80,Reggio di Calabria,52,687,3037,88,32,0,0,0,3844,507,3426,137,177,0,0,0,4247,8091
80,Reggio di Calabria,53,684,3099,111,38,0,0,0,3932,484,3368,154,203,0,0,0,4209,8141
80,Reggio di Calabria,54,651,3164,103,31,0,0,0,3949,548,3388,137,238,0,0,0,4311,8260
80,Reggio di Calabria,55,565,3048,86,32,1,0,0,3732,453,3186,156,256,0,0,0,4051,7783
80,Reggio di Calabria,56,581,3116,108,32,0,0,0,3837,451,3185,128,256,0,0,0,4020,7857
80,Reggio di Calabria,57,515,3046,82,30,0,0,0,3673,429,3226,143,324,1,0,0,4123,7796
80,Reggio di Calabria,58,509,2969,86,47,2,0,0,3613,435,3052,128,384,0,0,0,3999,7612
80,Reggio di Calabria,59,472,3031,98,46,0,0,0,3647,402,2974,113,377,0,0,0,3866,7513
80,Reggio di Calabria,60,413,2792,75,50,0,0,0,3330,351,2752,120,360,0,0,0,3583,6913
80,Reggio di Calabria,61,388,2957,92,73,0,0,0,3510,354,2769,120,449,0,0,0,3692,7202
80,Reggio di Calabria,62,356,2840,71,66,0,0,0,3333,293,2677,96,448,0,0,0,3514,6847
80,Reggio di Calabria,63,350,2843,69,69,0,0,0,3331,297,2637,93,460,0,0,0,3487,6818
80,Reggio di Calabria,64,333,2831,66,75,0,0,0,3305,276,2602,78,579,0,0,0,3535,6840
80,Reggio di Calabria,65,306,2603,70,81,1,0,0,3061,285,2362,83,517,0,0,0,3247,6308
80,Reggio di Calabria,66,258,2492,74,83,0,0,0,2907,243,2167,65,588,0,0,0,3063,5970
80,Reggio di Calabria,67,267,2553,56,106,0,0,0,2982,241,2176,82,701,0,0,0,3200,6182
80,Reggio di Calabria,68,214,2698,40,112,1,0,0,3065,263,2173,78,762,0,0,0,3276,6341
80,Reggio di Calabria,69,224,2606,65,130,0,0,0,3025,273,2035,61,809,0,0,0,3178,6203
80,Reggio di Calabria,70,223,2682,42,147,0,0,0,3094,228,2129,51,930,0,0,0,3338,6432
80,Reggio di Calabria,71,218,2600,46,141,0,0,0,3005,215,2057,62,983,0,0,0,3317,6322
80,Reggio di Calabria,72,192,2330,36,153,0,0,0,2711,205,1691,46,1034,0,0,0,2976,5687
80,Reggio di Calabria,73,132,1839,39,126,0,0,0,2136,200,1371,45,806,0,0,0,2422,4558
80,Reggio di Calabria,74,139,1772,27,159,0,0,0,2097,159,1218,39,859,0,0,0,2275,4372
80,Reggio di Calabria,75,117,1743,25,160,0,0,0,2045,192,1177,32,952,0,0,0,2353,4398
80,Reggio di Calabria,76,112,1725,16,179,0,0,0,2032,172,1039,28,1022,0,0,0,2261,4293
80,Reggio di Calabria,77,133,1588,24,194,0,0,0,1939,164,1026,29,1117,0,0,0,2336,4275
80,Reggio di Calabria,78,119,1699,25,212,0,0,0,2055,183,998,31,1236,0,0,0,2448,4503
80,Reggio di Calabria,79,119,1562,27,247,0,0,0,1955,181,959,20,1231,0,0,0,2391,4346
80,Reggio di Calabria,80,85,1385,17,253,0,0,0,1740,159,853,34,1288,0,0,0,2334,4074
80,Reggio di Calabria,81,87,1263,9,214,0,0,0,1573,151,623,19,1222,0,0,0,2015,3588
80,Reggio di Calabria,82,79,1125,10,231,0,0,0,1445,150,606,10,1349,0,0,0,2115,3560
80,Reggio di Calabria,83,64,1100,7,264,0,0,0,1435,180,549,13,1259,0,0,0,2001,3436
80,Reggio di Calabria,84,49,912,9,282,0,0,0,1252,151,444,16,1347,0,0,0,1958,3210
80,Reggio di Calabria,85,56,900,6,280,0,0,0,1242,157,376,20,1323,0,0,0,1876,3118
80,Reggio di Calabria,86,40,706,6,228,0,0,0,980,150,281,11,1257,0,0,0,1699,2679
80,Reggio di Calabria,87,41,631,3,237,0,0,0,912,148,247,12,1116,0,0,0,1523,2435
80,Reggio di Calabria,88,33,503,5,234,0,0,0,775,109,177,4,1054,0,0,0,1344,2119
80,Reggio di Calabria,89,24,398,2,228,0,0,0,652,125,138,9,906,0,0,0,1178,1830
80,Reggio di Calabria,90,24,275,4,206,0,0,0,509,82,108,6,783,0,0,0,979,1488
80,Reggio di Calabria,91,18,209,3,154,0,0,0,384,87,72,5,694,0,0,0,858,1242
80,Reggio di Calabria,92,20,169,1,151,0,0,0,341,79,58,5,551,0,0,0,693,1034
80,Reggio di Calabria,93,12,104,2,112,0,0,0,230,57,36,4,491,0,0,0,588,818
80,Reggio di Calabria,94,5,90,0,84,0,0,0,179,54,25,2,434,0,0,0,515,694
80,Reggio di Calabria,95,5,54,0,74,0,0,0,133,34,14,4,303,0,0,0,355,488
80,Reggio di Calabria,96,4,37,1,54,0,0,0,96,34,20,4,206,0,0,0,264,360
80,Reggio di Calabria,97,4,20,1,30,0,0,0,55,15,11,0,148,0,0,0,174,229
80,Reggio di Calabria,98,6,16,0,27,0,0,0,49,18,8,2,119,0,0,0,147,196
80,Reggio di Calabria,99,3,2,0,13,0,0,0,18,6,3,0,54,0,0,0,63,81
80,Reggio di Calabria,100,1,11,0,22,0,0,0,34,18,5,0,106,0,0,0,129,163
81,Trapani,0,1655,0,0,0,0,0,0,1655,1548,0,0,0,0,0,0,1548,3203
81,Trapani,1,1687,0,0,0,0,0,0,1687,1592,0,0,0,0,0,0,1592,3279
81,Trapani,2,1724,0,0,0,0,0,0,1724,1638,0,0,0,0,0,0,1638,3362
81,Trapani,3,1712,0,0,0,0,0,0,1712,1650,0,0,0,0,0,0,1650,3362
81,Trapani,4,1767,0,0,0,0,0,0,1767,1706,0,0,0,0,0,0,1706,3473
81,Trapani,5,1739,0,0,0,0,0,0,1739,1706,0,0,0,0,0,0,1706,3445
81,Trapani,6,1731,0,0,0,0,0,0,1731,1827,0,0,0,0,0,0,1827,3558
81,Trapani,7,1781,0,0,0,0,0,0,1781,1788,0,0,0,0,0,0,1788,3569
81,Trapani,8,1902,0,0,0,0,0,0,1902,1797,0,0,0,0,0,0,1797,3699
81,Trapani,9,2012,0,0,0,0,0,0,2012,1915,0,0,0,0,0,0,1915,3927
81,Trapani,10,1978,0,0,0,0,0,0,1978,1975,0,0,0,0,0,0,1975,3953
81,Trapani,11,2037,0,0,0,0,0,0,2037,1986,0,0,0,0,0,0,1986,4023
81,Trapani,12,2078,0,0,0,0,0,0,2078,1966,0,0,0,0,0,0,1966,4044
81,Trapani,13,2140,0,0,0,0,0,0,2140,2046,0,0,0,0,0,0,2046,4186
81,Trapani,14,2266,0,0,0,0,0,0,2266,2131,0,0,0,0,0,0,2131,4397
81,Trapani,15,2295,0,0,0,0,0,0,2295,2151,0,0,0,0,0,0,2151,4446
81,Trapani,16,2301,0,0,0,0,0,0,2301,2154,0,0,0,0,0,0,2154,4455
81,Trapani,17,2328,0,0,0,0,0,0,2328,2176,0,0,0,0,0,0,2176,4504
81,Trapani,18,2552,0,0,0,0,0,0,2552,2221,1,0,0,0,0,0,2222,4774
81,Trapani,19,2691,0,0,0,0,0,0,2691,2284,14,0,0,0,0,0,2298,4989
81,Trapani,20,2625,2,0,0,0,0,0,2627,2301,24,0,0,0,0,0,2325,4952
81,Trapani,21,2706,5,0,0,1,0,0,2712,2219,52,0,0,0,0,0,2271,4983
81,Trapani,22,2694,9,0,0,0,0,0,2703,2270,81,0,0,0,0,0,2351,5054
81,Trapani,23,2648,20,0,0,0,0,0,2668,2267,87,0,0,0,0,0,2354,5022
81,Trapani,24,2705,45,1,0,0,0,0,2751,2235,217,2,1,0,0,0,2455,5206
81,Trapani,25,2571,73,0,0,0,0,0,2644,2131,280,4,2,0,0,0,2417,5061
81,Trapani,26,2566,131,2,0,0,0,0,2699,2119,413,3,0,0,0,0,2535,5234
81,Trapani,27,2490,206,1,0,0,0,0,2697,1829,485,2,1,0,0,0,2317,5014
81,Trapani,28,2353,249,0,1,0,0,0,2603,1744,689,3,1,0,0,0,2437,5040
81,Trapani,29,2310,413,2,0,0,0,0,2725,1655,875,6,3,0,0,0,2539,5264
81,Trapani,30,1992,527,3,0,1,0,0,2523,1453,1001,11,2,1,0,0,2468,4991
81,Trapani,31,1821,579,4,1,1,0,0,2406,1200,1103,16,7,0,0,0,2326,4732
81,Trapani,32,1784,737,6,0,1,0,0,2528,1034,1248,15,0,0,0,0,2297,4825
81,Trapani,33,1606,939,7,0,0,0,0,2552,953,1365,26,5,0,0,0,2349,4901
81,Trapani,34,1435,1079,15,2,0,0,0,2531,909,1524,28,11,0,0,0,2472,5003
81,Trapani,35,1388,1182,13,0,1,0,0,2584,796,1537,40,4,0,0,0,2377,4961
81,Trapani,36,1289,1326,17,2,0,0,0,2634,701,1755,46,10,1,0,0,2513,5147
81,Trapani,37,1197,1362,20,0,0,0,0,2579,631,1800,48,15,0,0,0,2494,5073
81,Trapani,38,1114,1530,23,4,0,0,0,2671,599,2004,51,14,0,0,0,2668,5339
81,Trapani,39,1016,1625,38,4,0,0,0,2683,531,2122,46,13,2,0,0,2714,5397
81,Trapani,40,1019,1771,40,5,0,0,0,2835,487,2122,64,17,1,0,0,2691,5526
81,Trapani,41,927,1815,31,1,1,0,0,2775,495,2287,72,19,0,0,0,2873,5648
81,Trapani,42,881,2046,53,3,0,0,0,2983,466,2337,85,19,0,0,0,2907,5890
81,Trapani,43,910,2244,63,4,0,0,0,3221,453,2490,97,24,1,0,0,3065,6286
81,Trapani,44,824,2333,68,6,2,0,0,3233,461,2633,97,34,0,0,0,3225,6458
81,Trapani,45,749,2348,62,11,1,0,0,3171,418,2651,103,46,0,0,0,3218,6389
81,Trapani,46,662,2315,63,12,2,0,0,3054,363,2639,108,53,0,0,0,3163,6217
81,Trapani,47,638,2418,65,13,1,0,0,3135,378,2809,114,47,0,0,0,3348,6483
81,Trapani,48,609,2472,82,12,2,0,0,3177,386,2812,132,66,1,0,0,3397,6574
81,Trapani,49,599,2719,95,12,0,0,0,3425,385,2877,140,91,0,0,0,3493,6918
81,Trapani,50,496,2640,80,17,0,0,0,3233,320,2818,128,73,0,0,0,3339,6572
81,Trapani,51,489,2666,93,21,2,0,0,3271,293,2794,126,95,0,0,0,3308,6579
81,Trapani,52,414,2656,68,21,1,0,0,3160,340,2702,124,105,0,0,0,3271,6431
81,Trapani,53,379,2490,93,21,2,0,0,2985,325,2693,140,116,0,0,0,3274,6259
81,Trapani,54,379,2750,95,31,1,0,0,3256,308,2831,121,140,1,0,0,3401,6657
81,Trapani,55,323,2649,78,39,1,0,0,3090,297,2705,123,151,0,0,0,3276,6366
81,Trapani,56,333,2587,103,30,0,0,0,3053,290,2681,112,195,0,0,0,3278,6331
81,Trapani,57,303,2460,86,34,0,0,0,2883,269,2574,114,191,0,0,0,3148,6031
81,Trapani,58,288,2540,83,37,0,0,0,2948,256,2513,94,232,0,0,0,3095,6043
81,Trapani,59,233,2366,68,37,0,0,0,2704,214,2337,87,243,0,0,0,2881,5585
81,Trapani,60,223,2405,74,41,0,0,0,2743,203,2249,89,281,0,0,0,2822,5565
81,Trapani,61,206,2278,71,47,1,0,0,2603,219,2248,91,269,0,0,0,2827,5430
81,Trapani,62,201,2317,74,55,1,0,0,2648,230,2220,82,321,0,0,0,2853,5501
81,Trapani,63,200,2354,71,56,0,0,0,2681,213,2167,78,329,0,0,0,2787,5468
81,Trapani,64,191,2292,61,71,1,0,0,2616,205,2137,67,367,0,0,0,2776,5392
81,Trapani,65,161,2018,57,67,0,0,0,2303,186,1842,83,360,0,0,0,2471,4774
81,Trapani,66,162,2038,74,79,0,0,0,2353,169,1908,74,419,0,0,0,2570,4923
81,Trapani,67,162,2166,64,63,0,0,0,2455,163,1888,58,438,0,0,0,2547,5002
81,Trapani,68,146,2131,42,105,0,0,0,2424,192,1850,72,517,0,0,0,2631,5055
81,Trapani,69,136,2179,48,101,0,0,0,2464,172,1979,52,623,0,0,0,2826,5290
81,Trapani,70,122,2244,50,108,0,0,0,2524,184,1891,46,665,0,0,0,2786,5310
81,Trapani,71,110,2177,38,110,0,0,0,2435,147,1754,46,734,0,0,0,2681,5116
81,Trapani,72,100,1972,37,140,0,0,0,2249,154,1649,36,785,0,0,0,2624,4873
81,Trapani,73,85,1680,39,112,0,0,0,1916,118,1290,33,667,0,0,0,2108,4024
81,Trapani,74,79,1649,24,127,1,0,0,1880,126,1203,41,765,0,0,0,2135,4015
81,Trapani,75,79,1646,35,168,0,0,0,1928,124,1212,29,826,0,0,0,2191,4119
81,Trapani,76,68,1550,26,163,0,0,0,1807,113,1088,29,928,0,0,0,2158,3965
81,Trapani,77,65,1367,20,159,0,0,0,1611,113,946,23,863,0,0,0,1945,3556
81,Trapani,78,69,1657,15,178,0,0,0,1919,131,982,34,1156,0,0,0,2303,4222
81,Trapani,79,52,1489,18,218,0,0,0,1777,120,893,23,1156,0,0,0,2192,3969
81,Trapani,80,43,1261,9,191,0,0,0,1504,125,695,17,1103,0,0,0,1940,3444
81,Trapani,81,49,1112,10,193,0,0,0,1364,130,606,22,1078,0,0,0,1836,3200
81,Trapani,82,41,1024,10,200,0,0,0,1275,112,511,11,1070,0,0,0,1704,2979
81,Trapani,83,40,887,9,200,0,0,0,1136,107,430,13,1085,0,0,0,1635,2771
81,Trapani,84,40,871,3,211,0,0,0,1125,83,338,17,1055,0,0,0,1493,2618
81,Trapani,85,30,724,2,192,0,0,0,948,100,272,8,1083,0,0,0,1463,2411
81,Trapani,86,20,579,6,178,0,0,0,783,82,201,12,931,0,0,0,1226,2009
81,Trapani,87,25,476,3,168,0,0,0,672,82,163,10,897,0,0,0,1152,1824
81,Trapani,88,20,458,3,194,0,0,0,675,75,161,6,971,0,0,0,1213,1888
81,Trapani,89,13,317,0,165,0,0,0,495,78,88,10,803,0,0,0,979,1474
81,Trapani,90,10,261,2,151,0,0,0,424,51,54,6,719,0,0,0,830,1254
81,Trapani,91,12,178,3,100,0,0,0,293,62,46,4,543,0,0,0,655,948
81,Trapani,92,9,119,0,88,0,0,0,216,48,35,5,510,0,0,0,598,814
81,Trapani,93,11,86,1,90,0,0,0,188,41,18,0,362,0,0,0,421,609
81,Trapani,94,3,61,0,56,0,0,0,120,33,23,2,314,0,0,0,372,492
81,Trapani,95,5,46,0,51,0,0,0,102,21,10,2,233,0,0,0,266,368
81,Trapani,96,3,25,0,32,0,0,0,60,15,6,1,187,0,0,0,209,269
81,Trapani,97,4,11,1,24,0,0,0,40,6,2,0,103,0,0,0,111,151
81,Trapani,98,2,10,0,16,0,0,0,28,6,3,1,96,0,0,0,106,134
81,Trapani,99,0,3,0,7,0,0,0,10,3,0,0,48,0,0,0,51,61
81,Trapani,100,1,8,0,13,0,0,0,22,7,4,0,82,0,0,0,93,115
82,Palermo,0,5508,0,0,0,0,0,0,5508,5156,0,0,0,0,0,0,5156,10664
82,Palermo,1,5600,0,0,0,0,0,0,5600,5284,0,0,0,0,0,0,5284,10884
82,Palermo,2,5482,0,0,0,0,0,0,5482,5263,0,0,0,0,0,0,5263,10745
82,Palermo,3,5808,0,0,0,0,0,0,5808,5537,0,0,0,0,0,0,5537,11345
82,Palermo,4,6018,0,0,0,0,0,0,6018,5626,0,0,0,0,0,0,5626,11644
82,Palermo,5,5839,0,0,0,0,0,0,5839,5570,0,0,0,0,0,0,5570,11409
82,Palermo,6,6206,0,0,0,0,0,0,6206,5857,0,0,0,0,0,0,5857,12063
82,Palermo,7,6146,0,0,0,0,0,0,6146,5901,0,0,0,0,0,0,5901,12047
82,Palermo,8,6143,0,0,0,0,0,0,6143,5953,0,0,0,0,0,0,5953,12096
82,Palermo,9,6359,0,0,0,0,0,0,6359,6197,0,0,0,0,0,0,6197,12556
82,Palermo,10,6526,0,0,0,0,0,0,6526,6206,0,0,0,0,0,0,6206,12732
82,Palermo,11,6376,0,0,0,0,0,0,6376,6239,0,0,0,0,0,0,6239,12615
82,Palermo,12,6614,0,0,0,0,0,0,6614,6252,0,0,0,0,0,0,6252,12866
82,Palermo,13,6720,0,0,0,0,0,0,6720,6273,0,0,0,0,0,0,6273,12993
82,Palermo,14,6912,0,0,0,0,0,0,6912,6502,0,0,0,0,0,0,6502,13414
82,Palermo,15,6606,0,0,0,0,0,0,6606,6376,0,0,0,0,0,0,6376,12982
82,Palermo,16,6788,0,0,0,0,0,0,6788,6452,0,0,0,0,0,0,6452,13240
82,Palermo,17,6916,0,0,0,0,0,0,6916,6330,0,0,0,0,0,0,6330,13246
82,Palermo,18,7150,1,0,0,0,0,0,7151,6515,20,0,0,0,0,0,6535,13686
82,Palermo,19,7316,10,0,0,0,0,0,7326,6538,46,0,0,0,0,0,6584,13910
82,Palermo,20,7112,11,0,0,0,0,0,7123,6414,133,0,0,0,0,0,6547,13670
82,Palermo,21,7228,45,0,0,0,0,0,7273,6543,215,1,0,1,0,0,6760,14033
82,Palermo,22,7084,82,1,0,1,0,0,7168,6555,345,2,0,0,0,0,6902,14070
82,Palermo,23,6994,178,1,0,0,0,0,7173,6292,562,2,1,0,0,0,6857,14030
82,Palermo,24,7123,254,0,0,0,0,0,7377,6255,851,4,0,3,0,0,7113,14490
82,Palermo,25,7099,457,1,2,1,0,0,7560,6248,1149,8,2,2,0,0,7409,14969
82,Palermo,26,7322,694,0,0,0,0,0,8016,6210,1647,3,0,0,0,0,7860,15876
82,Palermo,27,6766,983,3,0,3,0,0,7755,5404,2052,12,3,1,0,0,7472,15227
82,Palermo,28,6468,1257,8,0,1,0,0,7734,4978,2460,21,1,1,0,0,7461,15195
82,Palermo,29,6042,1716,12,2,2,0,0,7774,4515,2958,29,6,4,0,0,7512,15286
82,Palermo,30,5597,2124,17,2,3,0,0,7743,4084,3405,20,7,2,0,0,7518,15261
82,Palermo,31,4940,2465,12,1,1,0,0,7419,3495,3733,51,8,5,0,0,7292,14711
82,Palermo,32,4501,2841,22,2,2,0,0,7368,3141,4176,59,10,1,0,0,7387,14755
82,Palermo,33,4384,3444,28,7,2,0,0,7865,2893,4514,64,7,1,0,0,7479,15344
82,Palermo,34,3957,3631,37,3,4,0,0,7632,2620,4917,94,10,1,0,0,7642,15274
82,Palermo,35,3417,3972,46,7,6,0,0,7448,2302,5266,101,19,0,0,0,7688,15136
82,Palermo,36,3250,4470,53,3,8,0,0,7784,2208,5494,124,22,8,0,0,7856,15640
82,Palermo,37,2938,4557,66,3,3,0,0,7567,2087,5622,149,27,4,0,0,7889,15456
82,Palermo,38,2838,5116,91,4,3,0,0,8052,1913,6227,152,45,2,0,0,8339,16391
82,Palermo,39,2710,5275,99,16,8,0,0,8108,1848,6333,209,54,4,0,0,8448,16556
82,Palermo,40,2551,5620,107,13,5,1,0,8297,1746,6483,219,46,3,0,0,8497,16794
82,Palermo,41,2432,5671,142,5,7,0,0,8257,1704,6803,225,71,3,0,0,8806,17063
82,Palermo,42,2333,6155,147,15,1,0,0,8651,1670,7085,269,60,2,0,0,9086,17737
82,Palermo,43,2330,6522,183,25,3,0,0,9063,1694,7209,288,80,5,0,0,9276,18339
82,Palermo,44,2320,6734,185,15,1,0,0,9255,1597,7496,350,117,5,0,0,9565,18820
82,Palermo,45,2012,6788,202,28,5,1,0,9036,1521,7299,361,115,2,0,0,9298,18334
82,Palermo,46,1933,6798,220,23,4,0,0,8978,1479,7482,387,155,1,0,0,9504,18482
82,Palermo,47,1784,7023,259,43,7,0,0,9116,1512,7607,390,163,5,0,0,9677,18793
82,Palermo,48,1667,6917,266,33,0,0,0,8883,1362,7451,401,193,3,0,0,9410,18293
82,Palermo,49,1616,7286,287,62,5,0,0,9256,1370,7864,394,234,5,0,0,9867,19123
82,Palermo,50,1491,7327,266,52,7,0,0,9143,1433,7641,481,243,0,0,1,9799,18942
82,Palermo,51,1446,7345,312,71,4,0,0,9178,1346,7605,457,269,0,1,0,9678,18856
82,Palermo,52,1308,7415,291,65,4,0,0,9083,1294,7775,484,319,3,0,0,9875,18958
82,Palermo,53,1303,7490,302,62,4,0,0,9161,1269,7784,465,396,0,1,0,9915,19076
82,Palermo,54,1246,7616,344,89,3,0,0,9298,1211,7919,521,411,0,0,0,10062,19360
82,Palermo,55,1044,7306,320,105,2,0,0,8777,1198,7548,478,448,0,0,0,9672,18449
82,Palermo,56,969,7276,291,130,4,0,0,8670,1147,7464,439,540,0,0,0,9590,18260
82,Palermo,57,908,7156,288,125,3,0,0,8480,1080,7266,420,495,1,0,0,9262,17742
82,Palermo,58,865,6967,258,120,4,0,0,8214,1064,7102,388,563,2,0,0,9119,17333
82,Palermo,59,810,6787,263,144,1,0,0,8005,1002,6681,401,711,0,0,0,8795,16800
82,Palermo,60,775,6589,264,175,1,0,0,7804,887,6476,396,738,1,0,0,8498,16302
82,Palermo,61,723,6599,254,174,3,0,0,7753,921,6436,341,830,1,0,0,8529,16282
82,Palermo,62,638,6487,231,161,2,1,0,7520,913,6186,318,926,2,0,0,8345,15865
82,Palermo,63,596,6306,251,177,1,1,0,7332,821,5947,307,976,0,0,0,8051,15383
82,Palermo,64,533,6297,216,225,1,0,0,7272,856,5941,310,1180,0,0,0,8287,15559
82,Palermo,65,489,5883,175,222,3,0,0,6772,795,5424,293,1044,0,0,0,7556,14328
82,Palermo,66,459,5913,176,257,0,0,0,6805,739,5417,282,1259,0,0,0,7697,14502
82,Palermo,67,451,5768,166,253,1,0,0,6639,751,5048,280,1326,0,0,0,7405,14044
82,Palermo,68,473,6007,171,281,1,0,0,6933,740,5156,294,1465,1,0,0,7656,14589
82,Palermo,69,400,5701,147,299,2,0,0,6549,689,5001,244,1721,0,0,0,7655,14204
82,Palermo,70,443,5881,168,352,0,0,0,6844,785,4904,211,1875,0,0,1,7776,14620
82,Palermo,71,370,5686,137,355,0,0,0,6548,738,4622,207,2030,0,0,0,7597,14145
82,Palermo,72,318,5227,137,355,0,0,0,6037,658,4135,192,2070,1,0,0,7056,13093
82,Palermo,73,260,4458,105,350,2,0,0,5175,584,3399,145,1838,0,0,0,5966,11141
82,Palermo,74,241,4164,87,362,1,0,0,4855,532,3161,148,2100,0,0,0,5941,10796
82,Palermo,75,216,3640,72,396,0,0,0,4324,509,2708,134,1920,0,0,0,5271,9595
82,Palermo,76,198,3604,67,427,0,0,0,4296,525,2542,120,2157,0,0,0,5344,9640
82,Palermo,77,192,3461,56,472,1,0,0,4182,533,2287,109,2365,0,0,0,5294,9476
82,Palermo,78,213,3485,48,536,0,0,0,4282,561,2494,100,2716,0,0,0,5871,10153
82,Palermo,79,202,3349,63,535,0,0,0,4149,514,2100,94,2697,0,0,0,5405,9554
82,Palermo,80,184,3051,59,543,0,0,0,3837,486,1844,95,2780,0,0,0,5205,9042
82,Palermo,81,157,2572,34,495,0,0,0,3258,441,1539,79,2599,0,0,0,4658,7916
82,Palermo,82,124,2378,32,503,0,0,0,3037,428,1244,71,2617,0,0,0,4360,7397
82,Palermo,83,115,2093,31,524,0,0,0,2763,395,1050,55,2788,0,0,0,4288,7051
82,Palermo,84,132,1785,17,570,1,0,0,2505,370,933,63,2827,0,0,0,4193,6698
82,Palermo,85,93,1730,13,599,0,0,0,2435,385,721,43,2613,0,0,0,3762,6197
82,Palermo,86,82,1402,13,505,0,0,0,2002,331,582,36,2398,0,0,0,3347,5349
82,Palermo,87,77,1117,7,527,0,0,0,1728,326,444,31,2302,0,0,0,3103,4831
82,Palermo,88,72,1017,6,488,0,0,0,1583,317,344,29,2283,0,0,0,2973,4556
82,Palermo,89,45,687,10,411,0,0,0,1153,252,215,12,1786,0,0,0,2265,3418
82,Palermo,90,43,578,9,364,0,0,0,994,231,186,16,1573,0,0,0,2006,3000
82,Palermo,91,26,413,10,313,0,0,0,762,174,100,16,1270,0,0,0,1560,2322
82,Palermo,92,26,302,7,291,0,0,0,626,153,69,17,1168,0,0,0,1407,2033
82,Palermo,93,24,218,2,226,0,0,0,470,122,54,11,869,0,0,0,1056,1526
82,Palermo,94,22,142,2,190,0,0,0,356,102,32,7,774,0,0,0,915,1271
82,Palermo,95,9,86,0,129,0,0,0,224,72,28,3,553,0,0,0,656,880
82,Palermo,96,6,50,0,116,0,0,0,172,63,20,3,427,0,0,0,513,685
82,Palermo,97,2,42,1,55,0,0,0,100,30,8,5,253,0,0,0,296,396
82,Palermo,98,2,17,0,43,0,0,0,62,30,9,2,206,0,0,0,247,309
82,Palermo,99,0,11,1,23,0,0,0,35,13,1,0,79,0,0,0,93,128
82,Palermo,100,3,12,1,24,0,0,0,40,32,5,1,173,0,0,0,211,251
83,Messina,0,2388,0,0,0,0,0,0,2388,2118,0,0,0,0,0,0,2118,4506
83,Messina,1,2427,0,0,0,0,0,0,2427,2303,0,0,0,0,0,0,2303,4730
83,Messina,2,2382,0,0,0,0,0,0,2382,2221,0,0,0,0,0,0,2221,4603
83,Messina,3,2422,0,0,0,0,0,0,2422,2310,0,0,0,0,0,0,2310,4732
83,Messina,4,2546,0,0,0,0,0,0,2546,2468,0,0,0,0,0,0,2468,5014
83,Messina,5,2497,0,0,0,0,0,0,2497,2465,0,0,0,0,0,0,2465,4962
83,Messina,6,2664,0,0,0,0,0,0,2664,2499,0,0,0,0,0,0,2499,5163
83,Messina,7,2651,0,0,0,0,0,0,2651,2544,0,0,0,0,0,0,2544,5195
83,Messina,8,2747,0,0,0,0,0,0,2747,2706,0,0,0,0,0,0,2706,5453
83,Messina,9,2744,0,0,0,0,0,0,2744,2638,0,0,0,0,0,0,2638,5382
83,Messina,10,2850,0,0,0,0,0,0,2850,2763,0,0,0,0,0,0,2763,5613
83,Messina,11,2880,0,0,0,0,0,0,2880,2761,0,0,0,0,0,0,2761,5641
83,Messina,12,2951,0,0,0,0,0,0,2951,2704,0,0,0,0,0,0,2704,5655
83,Messina,13,2924,0,0,0,0,0,0,2924,2670,0,0,0,0,0,0,2670,5594
83,Messina,14,2927,0,0,0,0,0,0,2927,2822,0,0,0,0,0,0,2822,5749
83,Messina,15,2945,0,0,0,0,0,0,2945,2840,0,0,0,0,0,0,2840,5785
83,Messina,16,2972,0,0,0,0,0,0,2972,2807,0,0,0,0,0,0,2807,5779
83,Messina,17,3154,1,0,0,0,0,0,3155,2859,0,0,0,0,0,0,2859,6014
83,Messina,18,3210,0,0,0,0,0,0,3210,2916,5,0,0,0,0,0,2921,6131
83,Messina,19,3131,3,0,0,0,0,0,3134,3058,11,0,0,0,0,0,3069,6203
83,Messina,20,3137,8,0,0,0,0,0,3145,2908,24,0,0,0,0,0,2932,6077
83,Messina,21,3208,7,0,0,0,0,0,3215,2881,63,0,0,0,0,0,2944,6159
83,Messina,22,3314,12,1,0,0,0,0,3327,2968,99,0,0,0,0,0,3067,6394
83,Messina,23,3334,33,0,0,0,0,0,3367,2974,158,0,0,1,0,0,3133,6500
83,Messina,24,3388,62,0,0,0,0,0,3450,3007,246,0,0,0,0,0,3253,6703
83,Messina,25,3501,101,1,0,0,0,0,3603,3100,326,3,0,1,0,0,3430,7033
83,Messina,26,3532,154,1,0,0,0,0,3687,3067,507,2,1,0,0,0,3577,7264
83,Messina,27,3403,297,0,0,0,1,0,3701,2862,683,6,2,0,0,0,3553,7254
83,Messina,28,3321,417,6,0,0,0,0,3744,2805,907,8,0,0,0,0,3720,7464
83,Messina,29,3125,523,2,0,0,0,0,3650,2666,1118,10,1,0,0,0,3795,7445
83,Messina,30,3077,682,7,0,1,0,0,3767,2383,1332,18,2,1,0,0,3736,7503
83,Messina,31,2866,914,4,1,2,0,0,3787,2165,1418,29,1,1,0,0,3614,7401
83,Messina,32,2551,1124,12,0,0,0,0,3687,1886,1704,30,8,1,0,0,3629,7316
83,Messina,33,2400,1268,15,1,1,1,0,3686,1757,1840,39,5,1,0,0,3642,7328
83,Messina,34,2274,1372,25,3,0,0,0,3674,1671,1987,38,8,0,0,0,3704,7378
83,Messina,35,2094,1533,31,3,0,0,0,3661,1398,2123,66,8,0,0,0,3595,7256
83,Messina,36,1983,1704,38,2,0,0,0,3727,1396,2349,88,13,1,0,0,3847,7574
83,Messina,37,1810,1846,43,2,1,0,0,3702,1215,2463,84,14,0,0,0,3776,7478
83,Messina,38,1730,2109,37,0,0,0,0,3876,1162,2601,94,14,0,0,0,3871,7747
83,Messina,39,1645,2205,60,4,0,0,0,3914,1180,2676,107,14,2,0,0,3979,7893
83,Messina,40,1562,2382,53,3,1,0,0,4001,1105,2808,126,33,0,0,0,4072,8073
83,Messina,41,1567,2478,105,8,0,0,0,4158,1071,2949,140,21,0,0,0,4181,8339
83,Messina,42,1504,2667,109,6,0,0,0,4286,1025,3254,161,38,0,0,0,4478,8764
83,Messina,43,1479,2877,103,6,2,0,0,4467,1033,3268,173,35,2,0,0,4511,8978
83,Messina,44,1407,2994,122,7,0,0,0,4530,1025,3557,193,59,0,0,0,4834,9364
83,Messina,45,1274,3084,131,16,0,0,0,4505,887,3612,221,74,1,0,0,4795,9300
83,Messina,46,1273,3165,145,17,2,0,0,4602,876,3744,256,75,0,0,0,4951,9553
83,Messina,47,1152,3342,158,16,0,0,0,4668,850,3761,244,100,0,0,0,4955,9623
83,Messina,48,1081,3228,156,23,2,0,0,4490,816,3645,247,100,2,0,0,4810,9300
83,Messina,49,1059,3385,159,20,1,0,0,4624,790,3846,252,115,0,0,0,5003,9627
83,Messina,50,988,3487,184,27,2,0,0,4688,755,3779,274,153,1,0,0,4962,9650
83,Messina,51,964,3632,194,27,2,0,0,4819,736,3896,304,155,0,0,0,5091,9910
83,Messina,52,883,3644,201,33,0,0,0,4761,775,3954,279,172,0,0,0,5180,9941
83,Messina,53,834,3614,178,30,0,0,0,4656,742,4010,276,193,1,0,0,5222,9878
83,Messina,54,838,3726,228,49,1,0,0,4842,707,4021,271,213,0,0,0,5212,10054
83,Messina,55,710,3698,212,51,1,0,0,4672,670,3734,242,246,0,0,0,4892,9564
83,Messina,56,683,3686,176,60,2,1,0,4608,603,3969,253,286,0,0,0,5111,9719
83,Messina,57,644,3587,184,65,1,0,0,4481,625,3763,244,320,1,0,0,4953,9434
83,Messina,58,585,3760,191,77,1,0,0,4614,616,3725,251,377,0,0,0,4969,9583
83,Messina,59,553,3501,186,61,1,0,0,4302,592,3459,231,398,0,0,0,4680,8982
83,Messina,60,527,3399,153,71,1,0,0,4151,559,3425,218,431,0,0,0,4633,8784
83,Messina,61,504,3416,178,89,2,0,0,4189,529,3482,209,480,0,0,0,4700,8889
83,Messina,62,457,3419,136,92,0,0,0,4104,490,3294,172,488,0,0,0,4444,8548
83,Messina,63,472,3480,157,109,0,0,0,4218,463,3175,204,532,0,0,1,4375,8593
83,Messina,64,415,3329,119,124,1,0,0,3988,445,3108,184,600,0,0,0,4337,8325
83,Messina,65,383,3167,132,104,3,0,0,3789,391,2967,154,610,0,0,0,4122,7911
83,Messina,66,353,3029,114,134,1,0,0,3631,395,2741,150,624,0,0,0,3910,7541
83,Messina,67,307,3103,122,112,1,0,0,3645,385,2670,155,698,0,0,0,3908,7553
83,Messina,68,293,3165,111,144,0,0,0,3713,391,2678,135,875,0,0,0,4079,7792
83,Messina,69,288,3096,99,190,0,0,1,3674,380,2658,109,867,0,0,0,4014,7688
83,Messina,70,270,3329,95,213,2,0,0,3909,366,2705,121,1026,0,0,0,4218,8127
83,Messina,71,249,3124,115,212,0,0,0,3700,389,2397,130,1093,0,0,0,4009,7709
83,Messina,72,243,2845,83,192,1,0,0,3364,351,2251,106,1087,0,0,0,3795,7159
83,Messina,73,177,2184,60,179,0,0,0,2600,285,1720,84,989,0,0,0,3078,5678
83,Messina,74,149,2112,54,205,0,0,0,2520,254,1585,84,1022,0,0,0,2945,5465
83,Messina,75,157,2019,59,219,0,0,0,2454,244,1480,63,1116,0,0,0,2903,5357
83,Messina,76,135,2031,40,243,0,0,0,2449,236,1467,74,1278,0,0,0,3055,5504
83,Messina,77,156,1990,34,243,0,0,0,2423,269,1301,81,1378,0,0,1,3030,5453
83,Messina,78,122,2048,46,315,0,0,0,2531,272,1336,70,1551,0,0,0,3229,5760
83,Messina,79,127,1898,47,298,0,0,0,2370,253,1134,58,1498,0,0,0,2943,5313
83,Messina,80,100,1630,27,260,0,0,0,2017,243,977,59,1537,0,0,0,2816,4833
83,Messina,81,99,1500,22,277,1,0,0,1899,225,886,42,1489,0,0,0,2642,4541
83,Messina,82,93,1364,21,299,0,0,0,1777,281,787,42,1569,0,0,0,2679,4456
83,Messina,83,97,1221,22,339,1,0,0,1680,263,632,29,1580,0,0,0,2504,4184
83,Messina,84,56,1137,16,318,0,0,0,1527,206,553,29,1640,0,0,0,2428,3955
83,Messina,85,73,1008,13,349,1,0,0,1444,220,468,26,1661,0,0,0,2375,3819
83,Messina,86,59,791,14,381,0,0,0,1245,209,325,19,1446,0,0,0,1999,3244
83,Messina,87,40,714,5,339,0,0,0,1098,184,302,24,1366,0,0,0,1876,2974
83,Messina,88,45,603,8,333,0,0,0,989,198,258,18,1415,0,0,0,1889,2878
83,Messina,89,35,420,6,218,0,0,0,679,174,159,13,1150,0,0,0,1496,2175
83,Messina,90,21,324,2,208,0,0,0,555,146,125,17,938,0,0,0,1226,1781
83,Messina,91,19,264,4,173,0,0,0,460,106,76,8,758,0,0,0,948,1408
83,Messina,92,16,170,5,157,0,0,0,348,94,55,8,709,0,0,0,866,1214
83,Messina,93,10,140,1,91,0,0,0,242,99,37,9,613,0,0,0,758,1000
83,Messina,94,7,89,1,106,0,0,0,203,72,31,4,513,0,0,0,620,823
83,Messina,95,9,60,0,69,0,0,0,138,43,23,5,325,0,0,0,396,534
83,Messina,96,7,39,0,45,0,0,0,91,32,13,1,295,0,0,0,341,432
83,Messina,97,6,27,0,36,0,0,0,69,24,7,3,196,0,0,0,230,299
83,Messina,98,2,13,0,25,0,0,0,40,19,8,2,125,0,0,0,154,194
83,Messina,99,2,12,0,8,0,0,0,22,12,8,0,62,0,0,0,82,104
83,Messina,100,3,26,2,10,0,0,0,41,14,12,2,103,0,0,0,131,172
84,Agrigento,0,1712,0,0,0,0,0,0,1712,1526,0,0,0,0,0,0,1526,3238
84,Agrigento,1,1686,0,0,0,0,0,0,1686,1675,0,0,0,0,0,0,1675,3361
84,Agrigento,2,1719,0,0,0,0,0,0,1719,1613,0,0,0,0,0,0,1613,3332
84,Agrigento,3,1773,0,0,0,0,0,0,1773,1597,0,0,0,0,0,0,1597,3370
84,Agrigento,4,1846,0,0,0,0,0,0,1846,1736,0,0,0,0,0,0,1736,3582
84,Agrigento,5,1820,0,0,0,0,0,0,1820,1667,0,0,0,0,0,0,1667,3487
84,Agrigento,6,1923,0,0,0,0,0,0,1923,1831,0,0,0,0,0,0,1831,3754
84,Agrigento,7,1947,0,0,0,0,0,0,1947,1936,0,0,0,0,0,0,1936,3883
84,Agrigento,8,2082,0,0,0,0,0,0,2082,1913,0,0,0,0,0,0,1913,3995
84,Agrigento,9,2056,0,0,0,0,0,0,2056,2004,0,0,0,0,0,0,2004,4060
84,Agrigento,10,2179,0,0,0,0,0,0,2179,1972,0,0,0,0,0,0,1972,4151
84,Agrigento,11,2173,0,0,0,0,0,0,2173,2039,0,0,0,0,0,0,2039,4212
84,Agrigento,12,2201,0,0,0,0,0,0,2201,2078,0,0,0,0,0,0,2078,4279
84,Agrigento,13,2308,0,0,0,0,0,0,2308,2202,0,0,0,0,0,0,2202,4510
84,Agrigento,14,2374,0,0,0,0,0,0,2374,2218,0,0,0,0,0,0,2218,4592
84,Agrigento,15,2261,0,0,0,0,0,0,2261,2215,0,0,0,0,0,0,2215,4476
84,Agrigento,16,2396,0,0,0,0,0,0,2396,2284,0,0,0,0,0,0,2284,4680
84,Agrigento,17,2547,0,0,0,0,0,0,2547,2315,0,0,0,0,0,0,2315,4862
84,Agrigento,18,2697,1,0,0,0,0,0,2698,2379,4,0,0,0,0,0,2383,5081
84,Agrigento,19,2765,2,0,1,0,0,0,2768,2501,23,0,0,0,0,0,2524,5292
84,Agrigento,20,2809,5,0,0,0,0,0,2814,2395,50,0,0,0,0,0,2445,5259
84,Agrigento,21,2634,14,0,0,0,0,0,2648,2304,71,0,0,0,0,0,2375,5023
84,Agrigento,22,2649,31,0,0,0,0,0,2680,2274,119,2,0,0,0,0,2395,5075
84,Agrigento,23,2519,43,0,0,0,0,0,2562,2171,212,0,0,0,0,0,2383,4945
84,Agrigento,24,2584,71,0,0,0,0,0,2655,2131,289,1,1,0,0,0,2422,5077
84,Agrigento,25,2535,128,1,0,1,0,0,2665,2016,423,3,0,0,0,0,2442,5107
84,Agrigento,26,2508,212,1,0,1,0,0,2722,2096,581,7,1,0,0,0,2685,5407
84,Agrigento,27,2412,238,1,0,0,0,0,2651,1878,715,7,0,0,0,0,2600,5251
84,Agrigento,28,2332,410,1,0,0,0,0,2743,1732,880,11,1,1,0,0,2625,5368
84,Agrigento,29,2149,512,4,0,0,0,0,2665,1459,1059,10,1,2,0,0,2531,5196
84,Agrigento,30,2043,734,5,1,0,0,0,2783,1296,1286,11,4,0,0,0,2597,5380
84,Agrigento,31,1796,775,5,0,0,0,0,2576,1099,1333,18,0,0,0,0,2450,5026
84,Agrigento,32,1633,950,3,0,0,0,0,2586,1019,1448,20,8,0,0,0,2495,5081
84,Agrigento,33,1503,1028,9,1,0,0,0,2541,868,1610,19,3,0,0,0,2500,5041
84,Agrigento,34,1284,1233,12,2,0,0,0,2531,798,1668,30,4,0,0,0,2500,5031
84,Agrigento,35,1162,1320,17,2,0,0,0,2501,639,1808,39,10,0,0,0,2496,4997
84,Agrigento,36,1055,1396,18,1,0,0,0,2470,609,1863,31,10,0,0,0,2513,4983
84,Agrigento,37,1079,1618,16,1,1,0,0,2715,538,2025,36,14,1,0,0,2614,5329
84,Agrigento,38,951,1769,20,3,0,0,0,2743,551,2049,56,17,0,0,0,2673,5416
84,Agrigento,39,936,1815,29,2,1,0,0,2783,478,2107,61,12,0,0,0,2658,5441
84,Agrigento,40,838,1852,32,2,0,0,0,2724,423,2226,68,24,0,0,0,2741,5465
84,Agrigento,41,800,1973,37,4,0,0,0,2814,438,2340,63,20,0,0,0,2861,5675
84,Agrigento,42,811,2175,60,1,0,0,0,3047,467,2333,82,47,0,0,0,2929,5976
84,Agrigento,43,805,2162,50,6,1,0,0,3024,465,2567,65,43,0,0,0,3140,6164
84,Agrigento,44,719,2229,49,8,3,0,0,3008,485,2595,103,48,0,0,0,3231,6239
84,Agrigento,45,644,2273,56,12,3,0,0,2988,465,2603,99,62,0,0,0,3229,6217
84,Agrigento,46,682,2269,52,9,0,0,0,3012,422,2525,94,47,0,0,0,3088,6100
84,Agrigento,47,633,2453,76,12,0,0,0,3174,405,2781,103,64,2,0,0,3355,6529
84,Agrigento,48,607,2440,81,15,2,0,0,3145,418,2806,109,65,0,1,0,3399,6544
84,Agrigento,49,594,2719,87,12,0,0,0,3412,459,2816,90,80,0,0,0,3445,6857
84,Agrigento,50,559,2599,76,15,0,0,0,3249,431,2837,94,123,0,0,0,3485,6734
84,Agrigento,51,516,2691,76,21,0,0,0,3304,441,2967,108,121,0,0,0,3637,6941
84,Agrigento,52,477,2589,79,12,1,0,0,3158,430,2788,90,123,0,0,0,3431,6589
84,Agrigento,53,433,2673,74,25,0,0,0,3205,406,2781,115,153,0,0,0,3455,6660
84,Agrigento,54,438,2814,86,30,1,0,0,3369,403,2883,103,143,0,0,0,3532,6901
84,Agrigento,55,353,2518,66,42,0,0,1,2980,363,2569,89,164,0,0,0,3185,6165
84,Agrigento,56,345,2447,75,38,0,0,0,2905,337,2513,76,183,0,0,0,3109,6014
84,Agrigento,57,356,2455,80,44,1,0,0,2936,305,2484,71,207,0,0,0,3067,6003
84,Agrigento,58,294,2539,74,40,0,0,0,2947,364,2608,87,247,0,0,0,3306,6253
84,Agrigento,59,286,2379,65,37,0,0,0,2767,320,2380,77,274,0,0,0,3051,5818
84,Agrigento,60,291,2274,53,36,0,0,0,2654,302,2269,54,269,0,0,0,2894,5548
84,Agrigento,61,258,2427,56,42,0,0,0,2783,274,2294,65,318,0,0,0,2951,5734
84,Agrigento,62,239,2245,52,40,2,0,0,2578,268,2215,67,341,0,0,0,2891,5469
84,Agrigento,63,216,2236,35,53,0,0,0,2540,279,2174,54,403,0,0,0,2910,5450
84,Agrigento,64,199,2305,52,71,0,0,0,2627,263,2060,57,434,0,0,0,2814,5441
84,Agrigento,65,176,1972,53,71,1,0,0,2273,219,1866,55,444,0,0,0,2584,4857
84,Agrigento,66,172,2030,45,63,0,0,0,2310,187,1840,55,472,0,0,0,2554,4864
84,Agrigento,67,138,1979,48,79,0,0,0,2244,222,1825,60,503,0,0,0,2610,4854
84,Agrigento,68,141,2011,31,100,0,0,0,2283,212,1749,37,601,0,0,0,2599,4882
84,Agrigento,69,147,2212,45,79,1,0,0,2484,212,1816,44,691,0,0,0,2763,5247
84,Agrigento,70,136,2099,43,109,0,0,0,2387,216,1731,37,692,0,0,0,2676,5063
84,Agrigento,71,139,2150,37,105,0,0,0,2431,202,1693,44,868,0,0,0,2807,5238
84,Agrigento,72,127,1829,28,130,1,0,0,2115,161,1416,30,844,0,0,0,2451,4566
84,Agrigento,73,79,1636,14,110,0,0,0,1839,145,1194,24,782,0,0,0,2145,3984
84,Agrigento,74,82,1532,25,114,0,0,0,1753,155,1111,21,789,0,0,1,2077,3830
84,Agrigento,75,82,1381,16,135,0,0,0,1614,151,941,21,782,0,0,0,1895,3509
84,Agrigento,76,79,1272,14,104,0,0,0,1469,145,898,21,806,0,0,0,1870,3339
84,Agrigento,77,56,1275,14,122,0,0,0,1467,165,822,19,914,0,0,0,1920,3387
84,Agrigento,78,93,1478,23,170,0,0,0,1764,172,887,21,1133,0,0,0,2213,3977
84,Agrigento,79,62,1409,17,173,0,0,0,1661,162,853,17,1189,0,0,0,2221,3882
84,Agrigento,80,55,1266,12,191,0,0,0,1524,165,747,12,1156,0,0,0,2080,3604
84,Agrigento,81,62,1159,13,196,0,0,0,1430,153,569,14,1166,0,0,0,1902,3332
84,Agrigento,82,52,950,4,182,0,0,0,1188,121,460,12,1122,0,0,0,1715,2903
84,Agrigento,83,37,927,10,213,1,0,0,1188,144,379,5,1136,0,0,0,1664,2852
84,Agrigento,84,39,840,7,240,0,0,0,1126,128,334,10,1145,0,0,0,1617,2743
84,Agrigento,85,30,739,3,208,0,0,0,980,110,270,11,1050,0,0,0,1441,2421
84,Agrigento,86,27,578,1,199,0,0,0,805,114,201,8,1016,0,0,0,1339,2144
84,Agrigento,87,26,516,4,224,0,0,0,770,116,150,7,959,0,0,0,1232,2002
84,Agrigento,88,23,458,4,185,0,0,0,670,112,114,9,929,0,0,0,1164,1834
84,Agrigento,89,12,329,0,172,0,0,0,513,93,73,5,736,0,0,0,907,1420
84,Agrigento,90,6,250,0,145,0,0,0,401,88,44,5,659,0,0,0,796,1197
84,Agrigento,91,8,209,0,128,0,0,0,345,56,38,1,562,0,0,0,657,1002
84,Agrigento,92,7,135,0,110,0,0,0,252,56,20,2,479,0,0,0,557,809
84,Agrigento,93,5,105,1,68,0,0,0,179,40,21,2,336,0,0,0,399,578
84,Agrigento,94,5,63,2,63,0,0,0,133,38,5,4,301,0,0,0,348,481
84,Agrigento,95,3,29,0,41,0,0,0,73,19,9,2,194,0,0,0,224,297
84,Agrigento,96,1,29,0,41,0,0,0,71,20,5,1,152,0,0,0,178,249
84,Agrigento,97,3,20,1,25,0,0,0,49,10,3,1,93,0,0,0,107,156
84,Agrigento,98,1,10,0,21,0,0,0,32,6,2,0,62,0,0,0,70,102
84,Agrigento,99,2,5,0,7,0,0,0,14,5,0,0,33,0,0,0,38,52
84,Agrigento,100,0,5,0,15,0,0,0,20,6,3,0,68,0,0,0,77,97
85,Caltanissetta,0,1006,0,0,0,0,0,0,1006,992,0,0,0,0,0,0,992,1998
85,Caltanissetta,1,1025,0,0,0,0,0,0,1025,971,0,0,0,0,0,0,971,1996
85,Caltanissetta,2,1071,0,0,0,0,0,0,1071,1049,0,0,0,0,0,0,1049,2120
85,Caltanissetta,3,1137,0,0,0,0,0,0,1137,1046,0,0,0,0,0,0,1046,2183
85,Caltanissetta,4,1107,0,0,0,0,0,0,1107,1120,0,0,0,0,0,0,1120,2227
85,Caltanissetta,5,1121,0,0,0,0,0,0,1121,1065,0,0,0,0,0,0,1065,2186
85,Caltanissetta,6,1221,0,0,0,0,0,0,1221,1222,0,0,0,0,0,0,1222,2443
85,Caltanissetta,7,1158,0,0,0,0,0,0,1158,1099,0,0,0,0,0,0,1099,2257
85,Caltanissetta,8,1268,0,0,0,0,0,0,1268,1206,0,0,0,0,0,0,1206,2474
85,Caltanissetta,9,1302,0,0,0,0,0,0,1302,1250,0,0,0,0,0,0,1250,2552
85,Caltanissetta,10,1337,0,0,0,0,0,0,1337,1249,0,0,0,0,0,0,1249,2586
85,Caltanissetta,11,1327,0,0,0,0,0,0,1327,1178,0,0,0,0,0,0,1178,2505
85,Caltanissetta,12,1470,0,0,0,0,0,0,1470,1306,0,0,0,0,0,0,1306,2776
85,Caltanissetta,13,1466,0,0,0,0,0,0,1466,1386,0,0,0,0,0,0,1386,2852
85,Caltanissetta,14,1480,0,0,0,0,0,0,1480,1446,0,0,0,0,0,0,1446,2926
85,Caltanissetta,15,1459,0,0,0,0,0,0,1459,1399,0,0,0,0,0,0,1399,2858
85,Caltanissetta,16,1510,0,0,0,0,0,0,1510,1366,0,0,0,0,0,0,1366,2876
85,Caltanissetta,17,1582,0,0,0,0,0,0,1582,1449,1,0,0,0,0,0,1450,3032
85,Caltanissetta,18,1537,2,0,0,0,0,0,1539,1429,6,0,0,0,0,0,1435,2974
85,Caltanissetta,19,1620,3,0,0,0,0,0,1623,1545,16,0,0,0,0,0,1561,3184
85,Caltanissetta,20,1671,2,0,0,0,0,0,1673,1426,53,0,0,0,0,0,1479,3152
85,Caltanissetta,21,1578,15,0,0,0,0,0,1593,1457,62,0,0,0,0,0,1519,3112
85,Caltanissetta,22,1568,23,0,0,0,0,0,1591,1392,111,1,0,0,0,0,1504,3095
85,Caltanissetta,23,1619,49,1,0,0,0,0,1669,1414,124,0,1,0,0,0,1539,3208
85,Caltanissetta,24,1578,71,0,0,0,0,0,1649,1381,181,1,1,0,0,0,1564,3213
85,Caltanissetta,25,1572,112,0,0,0,0,0,1684,1357,304,5,0,0,0,0,1666,3350
85,Caltanissetta,26,1594,181,1,0,0,0,0,1776,1298,375,4,1,0,0,0,1678,3454
85,Caltanissetta,27,1528,225,2,0,0,0,0,1755,1162,493,7,1,0,0,0,1663,3418
85,Caltanissetta,28,1372,308,7,0,0,0,0,1687,999,622,3,1,0,0,0,1625,3312
85,Caltanissetta,29,1384,340,8,0,0,0,0,1732,856,667,6,3,0,0,0,1532,3264
85,Caltanissetta,30,1193,472,5,1,1,0,0,1672,840,735,4,0,0,0,0,1579,3251
85,Caltanissetta,31,1029,535,3,0,0,0,0,1567,722,821,17,0,0,0,0,1560,3127
85,Caltanissetta,32,913,625,12,0,0,0,0,1550,582,911,18,0,0,0,0,1511,3061
85,Caltanissetta,33,851,724,7,1,1,0,0,1584,532,977,23,3,2,0,0,1537,3121
85,Caltanissetta,34,704,778,7,1,0,0,0,1490,496,1011,19,8,0,0,0,1534,3024
85,Caltanissetta,35,665,890,18,0,0,0,0,1573,437,1080,36,7,0,0,0,1560,3133
85,Caltanissetta,36,600,883,24,0,0,0,0,1507,347,1120,31,8,0,0,0,1506,3013
85,Caltanissetta,37,554,960,17,0,0,0,0,1531,371,1185,40,10,0,0,0,1606,3137
85,Caltanissetta,38,572,1033,26,1,1,0,0,1633,329,1241,37,11,0,0,0,1618,3251
85,Caltanissetta,39,565,1045,32,3,0,0,0,1645,332,1288,56,15,0,0,0,1691,3336
85,Caltanissetta,40,493,1097,40,3,0,0,0,1633,265,1317,54,7,0,0,0,1643,3276
85,Caltanissetta,41,500,1186,32,3,1,0,0,1722,256,1266,58,20,0,0,0,1600,3322
85,Caltanissetta,42,463,1247,48,2,0,0,0,1760,262,1411,68,16,1,0,0,1758,3518
85,Caltanissetta,43,438,1327,43,4,1,0,0,1813,269,1477,60,17,0,0,0,1823,3636
85,Caltanissetta,44,387,1367,44,5,0,0,0,1803,239,1554,73,24,0,0,0,1890,3693
85,Caltanissetta,45,383,1380,41,5,0,0,0,1809,258,1588,78,38,0,0,0,1962,3771
85,Caltanissetta,46,381,1371,71,8,0,0,0,1831,241,1625,65,47,0,0,0,1978,3809
85,Caltanissetta,47,344,1422,54,5,0,0,0,1825,242,1605,71,45,1,0,0,1964,3789
85,Caltanissetta,48,302,1473,44,8,0,0,0,1827,264,1649,93,55,0,0,0,2061,3888
85,Caltanissetta,49,324,1492,58,7,1,0,0,1882,234,1676,70,39,0,0,0,2019,3901
85,Caltanissetta,50,312,1518,56,13,0,0,0,1899,230,1658,88,62,0,0,0,2038,3937
85,Caltanissetta,51,255,1653,61,13,1,0,0,1983,236,1726,78,65,0,0,0,2105,4088
85,Caltanissetta,52,278,1595,65,16,0,0,0,1954,219,1691,84,75,0,0,0,2069,4023
85,Caltanissetta,53,251,1599,66,13,0,0,0,1929,261,1729,76,86,0,0,0,2152,4081
85,Caltanissetta,54,230,1633,61,17,1,0,0,1942,243,1773,103,122,0,0,0,2241,4183
85,Caltanissetta,55,214,1638,49,22,0,0,0,1923,241,1556,74,106,0,0,0,1977,3900
85,Caltanissetta,56,168,1526,64,18,0,0,0,1776,213,1645,75,134,0,0,0,2067,3843
85,Caltanissetta,57,158,1480,50,18,0,0,0,1706,212,1507,57,133,0,0,0,1909,3615
85,Caltanissetta,58,184,1633,57,21,0,0,0,1895,206,1550,66,175,0,0,0,1997,3892
85,Caltanissetta,59,130,1464,43,26,0,0,0,1663,181,1485,81,168,0,0,0,1915,3578
85,Caltanissetta,60,148,1387,41,35,0,0,0,1611,180,1420,60,190,0,0,0,1850,3461
85,Caltanissetta,61,125,1344,39,28,0,0,0,1536,174,1342,61,207,0,0,0,1784,3320
85,Caltanissetta,62,110,1309,37,33,0,0,0,1489,143,1341,48,222,0,0,0,1754,3243
85,Caltanissetta,63,105,1435,41,46,0,0,0,1627,134,1300,58,237,0,0,0,1729,3356
85,Caltanissetta,64,91,1342,43,43,0,0,0,1519,137,1266,51,264,0,0,0,1718,3237
85,Caltanissetta,65,75,1142,38,36,0,0,0,1291,135,1102,34,260,0,0,0,1531,2822
85,Caltanissetta,66,75,1127,31,37,0,0,0,1270,125,1107,26,302,0,0,0,1560,2830
85,Caltanissetta,67,80,1200,28,37,0,0,0,1345,136,1021,34,327,0,0,0,1518,2863
85,Caltanissetta,68,71,1187,24,45,0,0,0,1327,135,1017,40,344,0,0,0,1536,2863
85,Caltanissetta,69,83,1277,24,71,0,0,0,1455,131,1046,36,427,0,0,0,1640,3095
85,Caltanissetta,70,65,1239,24,68,0,0,0,1396,133,1058,44,439,0,0,0,1674,3070
85,Caltanissetta,71,72,1212,18,73,0,0,0,1375,126,960,18,516,0,0,0,1620,2995
85,Caltanissetta,72,58,1080,23,85,0,0,0,1246,104,779,20,519,0,0,0,1422,2668
85,Caltanissetta,73,60,907,15,65,0,0,0,1047,109,716,6,513,0,0,0,1344,2391
85,Caltanissetta,74,48,862,14,84,0,0,0,1008,93,598,16,476,0,0,0,1183,2191
85,Caltanissetta,75,44,805,10,77,0,0,0,936,90,558,6,539,0,0,0,1193,2129
85,Caltanissetta,76,44,759,7,72,0,0,0,882,79,470,9,509,0,0,0,1067,1949
85,Caltanissetta,77,41,727,11,85,0,0,0,864,110,497,16,544,0,0,0,1167,2031
85,Caltanissetta,78,46,837,12,104,0,0,0,999,106,493,17,667,0,0,0,1283,2282
85,Caltanissetta,79,34,745,6,126,0,0,0,911,107,421,12,689,0,0,0,1229,2140
85,Caltanissetta,80,38,771,12,117,0,0,0,938,93,391,14,804,0,0,0,1302,2240
85,Caltanissetta,81,33,586,6,110,0,0,0,735,83,267,6,616,0,0,0,972,1707
85,Caltanissetta,82,18,542,7,130,0,0,0,697,85,241,8,691,0,0,0,1025,1722
85,Caltanissetta,83,21,500,9,108,0,0,0,638,90,204,5,630,0,0,0,929,1567
85,Caltanissetta,84,23,459,7,114,0,0,0,603,67,192,7,620,0,0,0,886,1489
85,Caltanissetta,85,24,413,6,130,0,0,0,573,82,137,11,635,0,0,0,865,1438
85,Caltanissetta,86,22,274,5,120,0,0,0,421,94,104,8,586,0,0,0,792,1213
85,Caltanissetta,87,8,259,2,110,0,0,0,379,84,92,3,521,0,0,0,700,1079
85,Caltanissetta,88,12,219,3,113,0,0,0,347,62,48,5,502,0,0,0,617,964
85,Caltanissetta,89,15,172,6,83,0,0,0,276,39,45,3,385,0,0,0,472,748
85,Caltanissetta,90,5,115,5,67,0,0,0,192,40,27,6,337,0,0,0,410,602
85,Caltanissetta,91,6,82,3,75,0,0,0,166,44,12,3,280,0,0,0,339,505
85,Caltanissetta,92,4,77,1,49,0,0,0,131,35,11,2,255,0,0,0,303,434
85,Caltanissetta,93,7,46,0,45,0,0,0,98,22,9,1,169,0,0,0,201,299
85,Caltanissetta,94,2,35,0,37,0,0,0,74,20,7,0,138,0,0,0,165,239
85,Caltanissetta,95,1,20,0,30,0,0,0,51,9,2,0,88,0,0,0,99,150
85,Caltanissetta,96,1,15,0,22,0,0,0,38,10,3,1,83,0,0,0,97,135
85,Caltanissetta,97,0,5,0,10,0,0,0,15,7,1,0,50,0,0,0,58,73
85,Caltanissetta,98,2,9,3,6,0,0,0,20,4,2,0,39,0,0,0,45,65
85,Caltanissetta,99,1,2,0,7,0,0,0,10,0,1,0,15,0,0,0,16,26
85,Caltanissetta,100,2,2,0,6,0,0,0,10,3,1,0,33,0,0,0,37,47
86,Enna,0,574,0,0,0,0,0,0,574,568,0,0,0,0,0,0,568,1142
86,Enna,1,640,0,0,0,0,0,0,640,551,0,0,0,0,0,0,551,1191
86,Enna,2,570,0,0,0,0,0,0,570,599,0,0,0,0,0,0,599,1169
86,Enna,3,645,0,0,0,0,0,0,645,608,0,0,0,0,0,0,608,1253
86,Enna,4,613,0,0,0,0,0,0,613,603,0,0,0,0,0,0,603,1216
86,Enna,5,609,0,0,0,0,0,0,609,613,0,0,0,0,0,0,613,1222
86,Enna,6,677,0,0,0,0,0,0,677,593,0,0,0,0,0,0,593,1270
86,Enna,7,731,0,0,0,0,0,0,731,688,0,0,0,0,0,0,688,1419
86,Enna,8,701,0,0,0,0,0,0,701,719,0,0,0,0,0,0,719,1420
86,Enna,9,815,0,0,0,0,0,0,815,705,0,0,0,0,0,0,705,1520
86,Enna,10,774,0,0,0,0,0,0,774,740,0,0,0,0,0,0,740,1514
86,Enna,11,768,0,0,0,0,0,0,768,755,0,0,0,0,0,0,755,1523
86,Enna,12,847,0,0,0,0,0,0,847,739,0,0,0,0,0,0,739,1586
86,Enna,13,817,0,0,0,0,0,0,817,795,0,0,0,0,0,0,795,1612
86,Enna,14,808,0,0,0,0,0,0,808,774,0,0,0,0,0,0,774,1582
86,Enna,15,866,0,0,0,0,0,0,866,776,0,0,0,0,0,0,776,1642
86,Enna,16,843,0,0,0,0,0,0,843,855,0,0,0,0,0,0,855,1698
86,Enna,17,885,0,0,0,0,0,0,885,914,0,0,0,0,0,0,914,1799
86,Enna,18,985,0,0,0,0,0,0,985,911,1,0,0,0,0,0,912,1897
86,Enna,19,1054,0,0,0,0,0,0,1054,913,3,0,0,0,0,0,916,1970
86,Enna,20,1024,1,0,0,0,0,0,1025,872,14,0,0,0,0,0,886,1911
86,Enna,21,975,3,0,0,0,0,0,978,829,19,0,0,0,0,0,848,1826
86,Enna,22,975,6,0,0,0,0,0,981,854,31,0,0,0,0,0,885,1866
86,Enna,23,994,15,0,0,0,0,0,1009,885,66,1,0,0,0,0,952,1961
86,Enna,24,1017,23,0,0,0,0,0,1040,860,92,1,0,0,0,0,953,1993
86,Enna,25,1061,45,0,0,0,0,0,1106,814,127,1,0,0,0,0,942,2048
86,Enna,26,988,57,1,0,0,0,0,1046,832,162,0,0,0,0,0,994,2040
86,Enna,27,948,88,1,0,0,0,0,1037,750,261,2,1,0,0,0,1014,2051
86,Enna,28,897,115,1,0,0,0,0,1013,707,281,6,0,0,0,0,994,2007
86,Enna,29,847,181,0,0,0,0,0,1028,609,333,6,0,0,0,0,948,1976
86,Enna,30,801,230,2,0,0,0,0,1033,540,428,7,1,0,0,0,976,2009
86,Enna,31,669,276,4,0,0,0,0,949,497,460,7,0,0,0,0,964,1913
86,Enna,32,661,337,4,0,0,0,0,1002,460,466,13,3,0,0,0,942,1944
86,Enna,33,610,363,2,0,0,0,0,975,400,575,12,1,0,0,0,988,1963
86,Enna,34,569,408,5,0,0,0,0,982,328,596,21,3,0,0,0,948,1930
86,Enna,35,497,447,8,0,0,0,0,952,297,585,16,3,0,0,0,901,1853
86,Enna,36,455,478,12,0,0,0,0,945,267,642,15,7,0,0,0,931,1876
86,Enna,37,423,553,9,2,0,0,0,987,234,661,29,4,0,0,0,928,1915
86,Enna,38,416,550,15,1,1,0,0,983,241,697,20,4,0,0,0,962,1945
86,Enna,39,361,616,8,1,0,0,0,986,204,723,31,6,0,0,0,964,1950
86,Enna,40,319,615,21,0,0,0,0,955,211,731,42,12,0,0,0,996,1951
86,Enna,41,296,645,18,2,1,0,0,962,201,833,39,12,0,0,0,1085,2047
86,Enna,42,319,704,19,1,0,0,0,1043,214,880,38,11,0,0,0,1143,2186
86,Enna,43,291,781,29,2,0,0,0,1103,189,921,42,12,0,0,0,1164,2267
86,Enna,44,304,818,31,4,0,0,0,1157,178,886,43,13,0,0,0,1120,2277
86,Enna,45,294,784,36,7,0,0,0,1121,174,878,47,21,0,0,0,1120,2241
86,Enna,46,252,845,41,3,0,0,0,1141,216,956,51,21,0,0,0,1244,2385
86,Enna,47,255,877,34,4,0,0,0,1170,158,985,44,18,0,0,0,1205,2375
86,Enna,48,244,881,30,3,0,0,0,1158,177,1018,37,26,0,0,0,1258,2416
86,Enna,49,203,979,45,9,0,0,0,1236,156,1056,41,37,0,0,0,1290,2526
86,Enna,50,202,987,43,8,0,0,0,1240,146,1119,56,35,0,0,0,1356,2596
86,Enna,51,205,994,31,10,0,0,0,1240,131,1034,66,42,0,0,0,1273,2513
86,Enna,52,203,1035,47,6,0,0,0,1291,168,1020,36,29,0,0,0,1253,2544
86,Enna,53,173,995,48,13,0,0,0,1229,153,996,42,58,0,0,0,1249,2478
86,Enna,54,173,1033,33,14,0,0,0,1253,177,1063,37,72,0,0,0,1349,2602
86,Enna,55,138,950,32,10,0,1,0,1131,164,1013,36,75,0,0,0,1288,2419
86,Enna,56,137,1014,29,15,0,0,0,1195,135,969,43,85,0,0,0,1232,2427
86,Enna,57,136,943,36,8,0,0,0,1123,129,997,50,93,0,0,0,1269,2392
86,Enna,58,121,976,36,10,0,0,0,1143,157,1013,38,98,0,0,0,1306,2449
86,Enna,59,111,972,28,12,0,0,0,1123,114,954,28,96,0,0,0,1192,2315
86,Enna,60,86,895,21,19,0,0,0,1021,122,906,41,120,0,0,0,1189,2210
86,Enna,61,91,832,21,21,0,0,0,965,133,888,36,134,0,0,0,1191,2156
86,Enna,62,78,906,23,24,0,0,0,1031,122,845,36,132,0,0,0,1135,2166
86,Enna,63,83,894,20,29,0,0,0,1026,126,837,34,145,0,0,0,1142,2168
86,Enna,64,81,864,21,20,0,0,0,986,128,872,29,148,0,0,0,1177,2163
86,Enna,65,83,839,19,21,0,0,0,962,122,725,38,177,0,0,0,1062,2024
86,Enna,66,72,808,22,28,0,1,0,931,113,754,20,187,0,0,0,1074,2005
86,Enna,67,56,817,14,35,0,0,0,922,96,738,17,198,0,0,0,1049,1971
86,Enna,68,65,786,22,38,0,0,0,911,121,731,28,229,0,0,0,1109,2020
86,Enna,69,62,856,26,45,0,0,0,989,102,747,20,272,0,0,0,1141,2130
86,Enna,70,54,849,19,51,0,0,0,973,90,687,15,295,0,0,0,1087,2060
86,Enna,71,54,789,14,50,0,0,0,907,88,636,14,289,0,0,0,1027,1934
86,Enna,72,52,673,6,50,0,0,0,781,71,512,13,281,0,0,0,877,1658
86,Enna,73,33,554,12,36,0,0,0,635,72,480,5,270,0,0,0,827,1462
86,Enna,74,56,521,9,47,0,0,0,633,60,380,10,283,0,0,0,733,1366
86,Enna,75,26,485,7,49,0,0,0,567,61,377,6,287,0,0,0,731,1298
86,Enna,76,27,447,4,57,0,0,0,535,36,334,12,290,0,0,0,672,1207
86,Enna,77,35,475,7,45,0,0,0,562,52,349,6,352,0,0,0,759,1321
86,Enna,78,40,568,5,72,0,0,0,685,77,377,11,436,0,0,0,901,1586
86,Enna,79,27,554,7,69,0,0,0,657,64,360,13,475,0,0,0,912,1569
86,Enna,80,37,546,8,92,0,0,0,683,69,317,5,452,0,0,0,843,1526
86,Enna,81,22,426,7,104,0,0,0,559,59,219,6,445,0,0,0,729,1288
86,Enna,82,20,423,2,92,0,0,0,537,53,189,7,417,0,0,0,666,1203
86,Enna,83,23,366,5,88,0,0,0,482,63,158,4,439,0,0,0,664,1146
86,Enna,84,22,349,3,99,0,0,0,473,58,123,5,490,0,0,0,676,1149
86,Enna,85,21,280,3,73,0,0,0,377,48,124,6,404,0,0,0,582,959
86,Enna,86,19,217,0,87,0,0,0,323,62,85,2,398,0,0,0,547,870
86,Enna,87,8,179,2,73,0,0,0,262,44,64,2,360,0,0,0,470,732
86,Enna,88,9,179,3,97,0,0,0,288,41,52,4,384,0,0,0,481,769
86,Enna,89,11,133,2,71,0,0,0,217,35,45,1,285,0,0,0,366,583
86,Enna,90,10,90,1,78,0,0,0,179,40,31,4,278,0,0,0,353,532
86,Enna,91,6,81,0,69,0,0,0,156,24,17,1,228,0,0,0,270,426
86,Enna,92,7,48,0,48,0,0,0,103,22,8,1,173,0,0,0,204,307
86,Enna,93,6,36,0,36,0,0,0,78,18,1,2,143,0,0,0,164,242
86,Enna,94,2,17,0,22,0,0,0,41,12,7,1,92,0,0,0,112,153
86,Enna,95,7,23,0,19,0,0,0,49,9,0,0,75,0,0,0,84,133
86,Enna,96,1,9,1,24,0,0,0,35,4,1,2,57,0,0,0,64,99
86,Enna,97,2,2,0,16,0,0,0,20,3,2,0,46,0,0,0,51,71
86,Enna,98,1,1,1,5,0,0,0,8,6,0,0,26,0,0,0,32,40
86,Enna,99,0,1,0,3,0,0,0,4,2,0,0,22,0,0,0,24,28
86,Enna,100,1,3,0,3,0,0,0,7,6,0,0,17,0,0,0,23,30
87,Catania,0,4912,0,0,0,0,0,0,4912,4837,0,0,0,0,0,0,4837,9749
87,Catania,1,5096,0,0,0,0,0,0,5096,4686,0,0,0,0,0,0,4686,9782
87,Catania,2,5041,0,0,0,0,0,0,5041,4920,0,0,0,0,0,0,4920,9961
87,Catania,3,5393,0,0,0,0,0,0,5393,5071,0,0,0,0,0,0,5071,10464
87,Catania,4,5444,0,0,0,0,0,0,5444,5053,0,0,0,0,0,0,5053,10497
87,Catania,5,5324,0,0,0,0,0,0,5324,5007,0,0,0,0,0,0,5007,10331
87,Catania,6,5419,0,0,0,0,0,0,5419,5235,0,0,0,0,0,0,5235,10654
87,Catania,7,5532,0,0,0,0,0,0,5532,5381,0,0,0,0,0,0,5381,10913
87,Catania,8,5633,0,0,0,0,0,0,5633,5392,0,0,0,0,0,0,5392,11025
87,Catania,9,5766,0,0,0,0,0,0,5766,5383,0,0,0,0,0,0,5383,11149
87,Catania,10,5950,0,0,0,0,0,0,5950,5522,0,0,0,0,0,0,5522,11472
87,Catania,11,5679,0,0,0,0,0,0,5679,5510,0,0,0,0,0,0,5510,11189
87,Catania,12,5939,0,0,0,0,0,0,5939,5385,0,0,0,0,0,0,5385,11324
87,Catania,13,6025,0,0,0,0,0,0,6025,5630,0,0,0,0,0,0,5630,11655
87,Catania,14,6111,0,0,0,0,0,0,6111,5656,0,0,0,0,0,0,5656,11767
87,Catania,15,6044,0,0,0,0,0,0,6044,5762,0,0,0,0,0,0,5762,11806
87,Catania,16,5986,0,0,0,0,0,0,5986,5726,0,0,0,0,0,0,5726,11712
87,Catania,17,6058,1,0,0,0,0,0,6059,5723,0,0,0,0,0,0,5723,11782
87,Catania,18,6423,1,0,0,0,0,0,6424,5784,19,0,0,0,0,0,5803,12227
87,Catania,19,6442,8,0,0,0,0,0,6450,5839,58,0,0,0,0,0,5897,12347
87,Catania,20,6390,17,0,0,0,0,0,6407,5842,137,0,0,0,0,0,5979,12386
87,Catania,21,6422,44,0,0,0,0,0,6466,5765,210,0,0,0,0,0,5975,12441
87,Catania,22,6382,92,0,0,0,0,0,6474,5715,299,0,0,0,0,0,6014,12488
87,Catania,23,6279,162,0,0,0,0,0,6441,5715,456,1,0,0,0,0,6172,12613
87,Catania,24,6365,263,0,0,0,0,0,6628,5754,661,4,0,0,0,0,6419,13047
87,Catania,25,6457,392,0,1,0,0,0,6850,5643,993,6,1,0,0,0,6643,13493
87,Catania,26,6654,567,1,0,0,0,0,7222,5538,1267,5,2,0,0,0,6812,14034
87,Catania,27,6271,838,2,0,1,0,0,7112,5108,1777,12,1,1,0,0,6899,14011
87,Catania,28,6021,1144,6,0,0,0,0,7171,4854,2087,20,3,1,0,0,6965,14136
87,Catania,29,5462,1498,10,1,0,0,0,6971,4439,2489,34,6,1,0,0,6969,13940
87,Catania,30,5226,1744,12,0,2,0,0,6984,3933,3000,28,13,3,0,0,6977,13961
87,Catania,31,4711,2150,19,0,1,0,0,6881,3547,3288,47,6,2,0,0,6890,13771
87,Catania,32,4324,2582,21,3,3,0,0,6933,3060,3551,49,12,0,0,0,6672,13605
87,Catania,33,4029,2837,28,2,2,0,0,6898,2838,4000,61,11,3,0,0,6913,13811
87,Catania,34,3755,3284,50,1,3,0,0,7093,2681,4302,99,23,1,0,0,7106,14199
87,Catania,35,3352,3490,47,6,2,0,0,6897,2323,4372,98,14,2,0,0,6809,13706
87,Catania,36,3275,3785,69,4,2,0,0,7135,2152,4754,117,27,2,0,0,7052,14187
87,Catania,37,2963,3952,71,5,5,0,0,6996,2026,4948,138,32,3,0,0,7147,14143
87,Catania,38,2775,4290,100,4,5,0,0,7174,1896,5183,148,31,4,0,0,7262,14436
87,Catania,39,2614,4549,85,11,1,0,0,7260,1750,5448,159,38,0,0,0,7395,14655
87,Catania,40,2632,4868,104,16,1,0,0,7621,1728,5799,196,60,0,0,0,7783,15404
87,Catania,41,2382,5074,120,9,2,0,0,7587,1717,5633,224,65,0,0,0,7639,15226
87,Catania,42,2434,5264,142,17,2,0,0,7859,1641,6155,261,74,0,0,0,8131,15990
87,Catania,43,2159,5514,157,23,8,0,0,7861,1498,6369,259,86,1,0,0,8213,16074
87,Catania,44,2238,5850,176,24,0,0,0,8288,1546,6539,294,100,0,0,0,8479,16767
87,Catania,45,2016,5662,175,28,3,0,0,7884,1351,6573,333,111,2,0,0,8370,16254
87,Catania,46,1872,6086,192,22,4,0,0,8176,1321,6478,319,128,0,0,0,8246,16422
87,Catania,47,1747,6117,216,27,4,0,0,8111,1321,6789,333,133,3,0,0,8579,16690
87,Catania,48,1539,6087,226,28,1,0,0,7881,1280,6759,370,159,2,0,0,8570,16451
87,Catania,49,1501,6303,210,40,2,0,0,8056,1197,6925,388,213,0,1,0,8724,16780
87,Catania,50,1396,6432,240,53,3,1,0,8125,1166,6779,374,244,2,0,0,8565,16690
87,Catania,51,1315,6521,233,55,4,0,0,8128,1079,6956,412,292,0,0,0,8739,16867
87,Catania,52,1286,6435,255,68,3,0,0,8047,1066,6891,391,279,0,0,0,8627,16674
87,Catania,53,1129,6442,271,64,4,0,0,7910,1033,6815,408,304,1,0,0,8561,16471
87,Catania,54,1103,6696,302,64,5,0,0,8170,1009,6906,395,392,0,0,0,8702,16872
87,Catania,55,1011,6331,274,102,3,0,0,7721,874,6582,368,383,0,0,1,8208,15929
87,Catania,56,861,6498,283,85,2,0,0,7729,903,6527,364,459,1,0,0,8254,15983
87,Catania,57,832,6319,258,114,0,0,0,7523,858,6517,387,509,0,0,0,8271,15794
87,Catania,58,764,6235,249,107,0,0,0,7355,834,6577,336,585,0,0,0,8332,15687
87,Catania,59,749,6014,244,130,3,0,0,7140,751,6021,355,604,0,0,0,7731,14871
87,Catania,60,633,5839,232,125,2,0,0,6831,698,5810,329,680,0,0,0,7517,14348
87,Catania,61,591,5846,225,141,4,0,0,6807,708,5735,334,747,1,0,0,7525,14332
87,Catania,62,549,5670,189,142,1,1,0,6552,647,5670,299,823,0,0,0,7439,13991
87,Catania,63,513,5744,201,177,0,0,0,6635,618,5522,268,871,1,1,0,7281,13916
87,Catania,64,476,5551,170,198,1,0,0,6396,614,5356,294,972,0,0,0,7236,13632
87,Catania,65,435,5308,171,193,0,0,0,6107,523,4901,281,996,0,0,0,6701,12808
87,Catania,66,428,5054,146,206,1,0,0,5835,538,4549,249,1111,1,0,0,6448,12283
87,Catania,67,385,5024,137,212,1,0,0,5759,544,4350,194,1142,0,0,0,6230,11989
87,Catania,68,352,5110,145,245,1,0,0,5853,575,4386,272,1292,0,0,0,6525,12378
87,Catania,69,334,4858,145,251,0,0,0,5588,492,4090,212,1403,0,0,0,6197,11785
87,Catania,70,346,5168,127,296,1,0,0,5938,501,4234,207,1681,0,0,0,6623,12561
87,Catania,71,310,4881,124,331,0,0,0,5646,453,4112,207,1746,0,0,0,6518,12164
87,Catania,72,284,4373,117,334,0,0,0,5108,454,3563,178,1822,0,0,0,6017,11125
87,Catania,73,222,3618,83,301,0,0,0,4224,394,2739,122,1595,0,0,0,4850,9074
87,Catania,74,221,3295,79,276,1,0,0,3872,391,2562,140,1607,0,0,0,4700,8572
87,Catania,75,155,3056,75,329,0,0,0,3615,379,2215,125,1741,0,0,0,4460,8075
87,Catania,76,175,2911,63,339,0,0,0,3488,356,2065,95,1811,0,0,0,4327,7815
87,Catania,77,126,2883,53,323,0,0,0,3385,328,1934,108,1882,0,0,0,4252,7637
87,Catania,78,162,3087,65,408,0,0,0,3722,382,2082,134,2408,0,0,0,5006,8728
87,Catania,79,160,2856,45,461,1,0,0,3523,344,1778,101,2480,0,0,0,4703,8226
87,Catania,80,145,2640,38,438,0,0,0,3261,341,1550,85,2433,0,0,0,4409,7670
87,Catania,81,115,2177,30,417,0,0,0,2739,282,1261,91,2224,0,0,0,3858,6597
87,Catania,82,109,1997,27,454,0,0,0,2587,288,1034,62,2220,0,0,0,3604,6191
87,Catania,83,95,1920,34,407,0,0,0,2456,281,906,72,2383,0,0,0,3642,6098
87,Catania,84,98,1754,21,497,0,0,0,2370,292,790,62,2441,0,0,0,3585,5955
87,Catania,85,71,1580,21,515,0,0,0,2187,287,632,35,2360,0,0,0,3314,5501
87,Catania,86,58,1203,17,455,0,0,0,1733,242,465,47,2007,0,0,0,2761,4494
87,Catania,87,56,981,6,404,1,0,0,1448,231,332,42,1931,0,0,0,2536,3984
87,Catania,88,65,843,14,413,1,0,0,1336,216,297,44,1970,0,0,0,2527,3863
87,Catania,89,42,601,8,335,0,0,0,986,169,186,29,1557,0,0,0,1941,2927
87,Catania,90,35,482,5,283,0,0,0,805,146,144,25,1331,0,0,0,1646,2451
87,Catania,91,25,354,4,246,0,0,0,629,132,91,14,1093,0,0,0,1330,1959
87,Catania,92,16,241,4,180,0,0,0,441,108,61,13,908,0,0,0,1090,1531
87,Catania,93,18,161,3,163,0,0,0,345,110,47,10,728,0,0,0,895,1240
87,Catania,94,21,123,0,128,0,0,0,272,68,33,13,551,0,0,0,665,937
87,Catania,95,14,69,3,95,0,0,0,181,58,14,7,421,0,0,0,500,681
87,Catania,96,9,50,3,69,0,0,0,131,43,14,1,301,0,0,0,359,490
87,Catania,97,7,35,0,54,0,0,0,96,37,4,3,229,0,0,0,273,369
87,Catania,98,7,19,0,27,0,0,0,53,30,8,1,163,0,0,0,202,255
87,Catania,99,4,10,0,17,0,0,0,31,14,2,0,84,0,0,0,100,131
87,Catania,100,5,10,0,24,0,0,0,39,21,4,0,110,0,0,0,135,174
88,Ragusa,0,1370,0,0,0,0,0,0,1370,1358,0,0,0,0,0,0,1358,2728
88,Ragusa,1,1462,0,0,0,0,0,0,1462,1418,0,0,0,0,0,0,1418,2880
88,Ragusa,2,1482,0,0,0,0,0,0,1482,1371,0,0,0,0,0,0,1371,2853
88,Ragusa,3,1461,0,0,0,0,0,0,1461,1425,0,0,0,0,0,0,1425,2886
88,Ragusa,4,1478,0,0,0,0,0,0,1478,1408,0,0,0,0,0,0,1408,2886
88,Ragusa,5,1500,0,0,0,0,0,0,1500,1404,0,0,0,0,0,0,1404,2904
88,Ragusa,6,1522,0,0,0,0,0,0,1522,1500,0,0,0,0,0,0,1500,3022
88,Ragusa,7,1646,0,0,0,0,0,0,1646,1489,0,0,0,0,0,0,1489,3135
88,Ragusa,8,1610,0,0,0,0,0,0,1610,1512,0,0,0,0,0,0,1512,3122
88,Ragusa,9,1634,0,0,0,0,0,0,1634,1636,0,0,0,0,0,0,1636,3270
88,Ragusa,10,1665,0,0,0,0,0,0,1665,1589,0,0,0,0,0,0,1589,3254
88,Ragusa,11,1605,0,0,0,0,0,0,1605,1506,0,0,0,0,0,0,1506,3111
88,Ragusa,12,1727,0,0,0,0,0,0,1727,1555,0,0,0,0,0,0,1555,3282
88,Ragusa,13,1697,0,0,0,0,0,0,1697,1514,0,0,0,0,0,0,1514,3211
88,Ragusa,14,1628,0,0,0,0,0,0,1628,1594,0,0,0,0,0,0,1594,3222
88,Ragusa,15,1733,0,0,0,0,0,0,1733,1621,0,0,0,0,0,0,1621,3354
88,Ragusa,16,1709,0,0,0,0,0,0,1709,1604,0,0,0,0,0,0,1604,3313
88,Ragusa,17,1706,0,0,0,0,0,0,1706,1665,1,0,0,0,0,0,1666,3372
88,Ragusa,18,1835,1,0,0,0,0,0,1836,1600,2,0,0,0,0,0,1602,3438
88,Ragusa,19,1917,1,0,0,0,0,0,1918,1626,29,0,0,0,0,0,1655,3573
88,Ragusa,20,1857,2,0,0,0,0,0,1859,1604,37,0,0,0,0,0,1641,3500
88,Ragusa,21,1953,8,0,0,1,0,0,1962,1636,100,1,0,0,0,0,1737,3699
88,Ragusa,22,1870,19,1,0,0,0,0,1890,1632,116,0,0,0,0,0,1748,3638
88,Ragusa,23,1907,42,0,0,0,0,0,1949,1608,215,3,0,0,0,0,1826,3775
88,Ragusa,24,1932,58,0,0,1,0,0,1991,1489,232,0,0,0,0,0,1721,3712
88,Ragusa,25,1915,127,2,0,0,0,0,2044,1544,388,2,0,0,0,0,1934,3978
88,Ragusa,26,1942,181,1,0,0,0,0,2124,1432,459,3,0,0,0,0,1894,4018
88,Ragusa,27,1737,254,2,0,0,0,0,1993,1353,578,7,0,0,0,0,1938,3931
88,Ragusa,28,1824,345,1,0,0,0,0,2170,1185,729,6,1,0,0,0,1921,4091
88,Ragusa,29,1621,452,2,0,0,0,0,2075,1054,817,15,2,0,0,0,1888,3963
88,Ragusa,30,1628,589,4,0,1,0,0,2222,1029,904,12,3,0,0,0,1948,4170
88,Ragusa,31,1444,705,11,1,0,0,0,2161,927,1088,19,1,0,0,0,2035,4196
88,Ragusa,32,1402,771,9,1,1,0,0,2184,801,1156,27,6,0,0,0,1990,4174
88,Ragusa,33,1176,913,10,0,0,0,0,2099,703,1198,36,2,0,0,0,1939,4038
88,Ragusa,34,1103,975,12,0,1,0,0,2091,665,1316,36,7,0,0,0,2024,4115
88,Ragusa,35,1021,1062,17,2,0,0,0,2102,597,1388,44,5,0,0,0,2034,4136
88,Ragusa,36,1073,1210,25,0,0,0,0,2308,569,1447,55,8,0,0,0,2079,4387
88,Ragusa,37,989,1234,19,2,0,0,0,2244,482,1536,46,12,0,0,0,2076,4320
88,Ragusa,38,910,1347,25,2,0,0,0,2284,506,1545,53,10,0,0,0,2114,4398
88,Ragusa,39,849,1326,43,0,1,0,0,2219,443,1558,57,18,0,0,0,2076,4295
88,Ragusa,40,829,1419,46,0,0,0,0,2294,443,1668,72,7,0,0,0,2190,4484
88,Ragusa,41,789,1539,50,3,0,0,0,2381,412,1708,68,12,0,0,0,2200,4581
88,Ragusa,42,795,1614,51,4,0,0,0,2464,397,1860,77,21,0,0,0,2355,4819
88,Ragusa,43,692,1725,43,3,1,0,0,2464,407,1847,100,28,1,0,0,2383,4847
88,Ragusa,44,668,1766,58,3,1,0,0,2496,373,1973,105,30,0,0,0,2481,4977
88,Ragusa,45,645,1749,71,3,1,0,0,2469,367,1851,104,38,0,0,0,2360,4829
88,Ragusa,46,572,1734,72,9,1,0,0,2388,326,1868,96,31,0,0,0,2321,4709
88,Ragusa,47,517,1764,92,7,0,0,0,2380,327,1988,105,24,0,0,0,2444,4824
88,Ragusa,48,424,1870,84,13,0,0,0,2391,293,1898,107,40,0,0,0,2338,4729
88,Ragusa,49,446,1939,101,16,0,0,0,2502,287,1908,117,63,0,0,0,2375,4877
88,Ragusa,50,383,1872,93,16,2,0,0,2366,265,2030,135,59,0,0,0,2489,4855
88,Ragusa,51,342,1922,86,21,0,0,0,2371,279,1994,122,75,0,0,0,2470,4841
88,Ragusa,52,344,1955,82,21,1,0,0,2403,246,1949,126,74,1,0,0,2396,4799
88,Ragusa,53,351,1982,69,8,1,0,0,2411,231,1895,85,92,0,0,0,2303,4714
88,Ragusa,54,298,1927,81,24,0,0,0,2330,216,1862,107,91,0,0,0,2276,4606
88,Ragusa,55,259,1859,75,13,0,0,0,2206,216,1901,94,112,0,0,0,2323,4529
88,Ragusa,56,254,1876,86,21,1,0,0,2238,224,1837,87,113,0,0,0,2261,4499
88,Ragusa,57,215,1849,84,29,1,0,0,2178,215,1825,96,121,0,0,0,2257,4435
88,Ragusa,58,172,1829,58,32,0,0,0,2091,207,1846,101,163,0,0,0,2317,4408
88,Ragusa,59,187,1745,75,34,0,0,0,2041,178,1716,89,182,0,0,0,2165,4206
88,Ragusa,60,168,1609,62,30,0,0,0,1869,164,1585,85,207,0,0,0,2041,3910
88,Ragusa,61,146,1633,43,40,0,0,0,1862,156,1528,71,195,0,0,0,1950,3812
88,Ragusa,62,137,1609,44,46,0,0,0,1836,165,1611,50,214,0,0,0,2040,3876
88,Ragusa,63,127,1587,50,46,2,0,0,1812,133,1475,58,224,0,0,0,1890,3702
88,Ragusa,64,105,1610,51,51,0,0,0,1817,141,1546,61,263,0,0,0,2011,3828
88,Ragusa,65,96,1465,42,36,0,0,0,1639,116,1339,53,296,0,0,0,1804,3443
88,Ragusa,66,99,1374,44,40,1,0,0,1558,141,1290,55,287,0,0,0,1773,3331
88,Ragusa,67,110,1343,44,69,0,0,0,1566,112,1247,43,340,0,0,0,1742,3308
88,Ragusa,68,83,1415,37,65,0,0,0,1600,105,1247,40,336,0,0,0,1728,3328
88,Ragusa,69,95,1531,43,64,0,0,0,1733,123,1289,41,445,0,0,0,1898,3631
88,Ragusa,70,73,1418,33,90,0,0,1,1615,127,1353,40,458,0,0,0,1978,3593
88,Ragusa,71,82,1472,45,94,0,0,0,1693,129,1246,36,564,0,0,0,1975,3668
88,Ragusa,72,59,1263,25,77,0,0,0,1424,110,1047,40,503,0,0,0,1700,3124
88,Ragusa,73,52,1116,23,73,0,0,0,1264,91,805,30,445,0,0,0,1371,2635
88,Ragusa,74,43,992,17,82,0,0,0,1134,90,752,29,454,0,0,0,1325,2459
88,Ragusa,75,41,969,16,81,0,0,0,1107,84,665,23,523,0,0,0,1295,2402
88,Ragusa,76,40,914,16,88,0,0,0,1058,86,641,22,557,0,0,0,1306,2364
88,Ragusa,77,37,935,21,78,0,0,0,1071,100,604,17,648,0,0,0,1369,2440
88,Ragusa,78,45,1072,20,121,0,0,0,1258,96,646,21,809,0,0,0,1572,2830
88,Ragusa,79,42,975,11,130,0,0,0,1158,127,544,22,838,0,0,0,1531,2689
88,Ragusa,80,33,854,16,129,0,0,0,1032,86,467,11,797,0,0,0,1361,2393
88,Ragusa,81,32,716,8,102,0,0,0,858,97,351,11,718,0,0,0,1177,2035
88,Ragusa,82,29,685,6,140,0,0,0,860,81,322,16,770,0,0,0,1189,2049
88,Ragusa,83,27,619,6,139,0,0,0,791,74,273,14,723,0,0,0,1084,1875
88,Ragusa,84,27,564,9,134,0,0,0,734,76,199,10,717,0,0,0,1002,1736
88,Ragusa,85,18,479,10,128,0,0,0,635,62,150,11,672,0,0,0,895,1530
88,Ragusa,86,11,358,5,128,0,0,0,502,64,123,5,686,0,0,0,878,1380
88,Ragusa,87,13,319,4,136,0,0,0,472,66,81,7,648,0,0,0,802,1274
88,Ragusa,88,16,286,0,130,0,0,0,432,60,69,4,579,0,0,0,712,1144
88,Ragusa,89,10,205,2,115,0,0,0,332,43,51,4,470,0,0,0,568,900
88,Ragusa,90,13,180,0,105,0,0,0,298,40,30,9,425,0,0,0,504,802
88,Ragusa,91,5,116,0,84,0,0,0,205,37,16,3,346,0,0,0,402,607
88,Ragusa,92,6,95,2,78,0,0,0,181,25,26,4,270,0,0,0,325,506
88,Ragusa,93,5,63,0,62,0,0,0,130,26,5,1,245,0,0,0,277,407
88,Ragusa,94,2,42,0,32,1,0,0,77,18,9,0,179,0,0,0,206,283
88,Ragusa,95,2,31,0,35,0,0,0,68,9,7,1,140,0,0,0,157,225
88,Ragusa,96,0,14,0,20,0,0,0,34,7,3,1,116,0,0,0,127,161
88,Ragusa,97,1,15,0,15,0,0,0,31,12,1,0,87,0,0,0,100,131
88,Ragusa,98,3,7,0,7,0,0,0,17,2,3,0,39,0,0,0,44,61
88,Ragusa,99,1,2,0,6,0,0,0,9,0,0,0,26,0,0,0,26,35
88,Ragusa,100,1,7,0,11,0,0,0,19,5,0,0,44,0,0,0,49,68
89,Siracusa,0,1593,0,0,0,0,0,0,1593,1516,0,0,0,0,0,0,1516,3109
89,Siracusa,1,1652,0,0,0,0,0,0,1652,1498,0,0,0,0,0,0,1498,3150
89,Siracusa,2,1690,0,0,0,0,0,0,1690,1611,0,0,0,0,0,0,1611,3301
89,Siracusa,3,1711,0,0,0,0,0,0,1711,1572,0,0,0,0,0,0,1572,3283
89,Siracusa,4,1758,0,0,0,0,0,0,1758,1667,0,0,0,0,0,0,1667,3425
89,Siracusa,5,1767,0,0,0,0,0,0,1767,1684,0,0,0,0,0,0,1684,3451
89,Siracusa,6,1913,0,0,0,0,0,0,1913,1730,0,0,0,0,0,0,1730,3643
89,Siracusa,7,1910,0,0,0,0,0,0,1910,1718,0,0,0,0,0,0,1718,3628
89,Siracusa,8,1891,0,0,0,0,0,0,1891,1857,0,0,0,0,0,0,1857,3748
89,Siracusa,9,1983,0,0,0,0,0,0,1983,1783,0,0,0,0,0,0,1783,3766
89,Siracusa,10,1940,0,0,0,0,0,0,1940,1888,0,0,0,0,0,0,1888,3828
89,Siracusa,11,2008,0,0,0,0,0,0,2008,1743,0,0,0,0,0,0,1743,3751
89,Siracusa,12,2050,0,0,0,0,0,0,2050,1861,0,0,0,0,0,0,1861,3911
89,Siracusa,13,2010,0,0,0,0,0,0,2010,1890,0,0,0,0,0,0,1890,3900
89,Siracusa,14,2052,0,0,0,0,0,0,2052,1902,0,0,0,0,0,0,1902,3954
89,Siracusa,15,2128,0,0,0,0,0,0,2128,1954,0,0,0,0,0,0,1954,4082
89,Siracusa,16,2064,0,0,0,0,0,0,2064,1918,0,0,0,0,0,0,1918,3982
89,Siracusa,17,2165,0,0,0,0,0,0,2165,1925,0,0,0,0,0,0,1925,4090
89,Siracusa,18,2142,1,0,0,0,0,0,2143,1969,6,0,0,0,0,0,1975,4118
89,Siracusa,19,2127,2,0,0,0,0,0,2129,2027,15,0,0,0,0,0,2042,4171
89,Siracusa,20,2200,4,0,0,0,0,0,2204,1964,45,0,0,0,0,0,2009,4213
89,Siracusa,21,2142,13,0,0,0,0,0,2155,1926,66,0,0,0,0,0,1992,4147
89,Siracusa,22,2087,24,1,0,0,0,0,2112,1927,80,0,0,0,0,0,2007,4119
89,Siracusa,23,2184,31,0,0,0,0,0,2215,1922,144,1,0,0,0,0,2067,4282
89,Siracusa,24,2176,53,0,0,1,0,0,2230,1840,202,2,1,0,0,0,2045,4275
89,Siracusa,25,2210,95,0,0,0,0,0,2305,1956,300,4,0,1,0,0,2261,4566
89,Siracusa,26,2266,169,1,0,0,0,0,2436,1918,370,4,0,2,0,0,2294,4730
89,Siracusa,27,2125,236,0,0,0,0,0,2361,1751,521,6,0,0,0,0,2278,4639
89,Siracusa,28,2118,291,4,1,1,0,0,2415,1674,648,14,2,3,0,0,2341,4756
89,Siracusa,29,2012,397,7,1,0,0,0,2417,1588,842,14,0,0,0,0,2444,4861
89,Siracusa,30,1979,528,3,0,1,0,0,2511,1390,922,13,2,1,1,0,2329,4840
89,Siracusa,31,1857,624,8,0,0,0,0,2489,1203,1008,21,1,0,0,0,2233,4722
89,Siracusa,32,1650,783,14,2,1,0,0,2450,1157,1176,30,1,2,0,0,2366,4816
89,Siracusa,33,1614,851,12,1,0,0,0,2478,995,1323,36,2,0,0,0,2356,4834
89,Siracusa,34,1470,1053,29,0,2,0,0,2554,968,1394,45,4,1,0,0,2412,4966
89,Siracusa,35,1385,1150,22,0,0,0,0,2557,889,1525,37,6,1,0,0,2458,5015
89,Siracusa,36,1320,1278,25,1,1,0,0,2625,808,1661,59,13,2,0,0,2543,5168
89,Siracusa,37,1180,1325,34,2,1,0,0,2542,750,1681,60,11,2,0,0,2504,5046
89,Siracusa,38,1132,1532,39,3,0,0,0,2706,666,1826,90,11,0,0,0,2593,5299
89,Siracusa,39,1071,1516,54,4,0,0,0,2645,637,1945,92,9,1,0,0,2684,5329
89,Siracusa,40,1054,1656,62,2,1,0,0,2775,638,2028,114,17,1,0,0,2798,5573
89,Siracusa,41,926,1807,71,2,1,0,0,2807,576,2087,115,23,1,1,0,2803,5610
89,Siracusa,42,1033,1934,93,4,0,0,0,3064,575,2097,138,27,1,0,0,2838,5902
89,Siracusa,43,916,1992,84,4,0,0,0,2996,538,2231,153,28,1,0,0,2951,5947
89,Siracusa,44,902,2098,108,10,1,0,0,3119,561,2433,160,44,1,0,0,3199,6318
89,Siracusa,45,845,2163,104,10,0,0,0,3122,466,2372,160,37,2,0,0,3037,6159
89,Siracusa,46,824,2078,137,9,1,0,0,3049,467,2416,187,58,0,0,0,3128,6177
89,Siracusa,47,732,2229,117,12,1,0,0,3091,427,2484,167,64,0,0,0,3142,6233
89,Siracusa,48,649,2220,124,15,0,0,0,3008,398,2494,175,74,0,0,0,3141,6149
89,Siracusa,49,594,2409,144,21,1,0,0,3169,368,2449,198,75,0,0,0,3090,6259
89,Siracusa,50,546,2271,152,27,1,0,0,2997,363,2388,177,68,0,0,0,2996,5993
89,Siracusa,51,492,2371,134,20,0,0,0,3017,350,2515,152,91,0,0,0,3108,6125
89,Siracusa,52,467,2356,142,29,1,0,0,2995,289,2513,187,115,0,0,0,3104,6099
89,Siracusa,53,436,2385,138,31,0,0,0,2990,310,2368,169,115,0,0,0,2962,5952
89,Siracusa,54,456,2486,137,32,1,0,0,3112,284,2445,160,149,0,0,0,3038,6150
89,Siracusa,55,363,2400,137,26,0,0,0,2926,285,2488,153,152,0,0,0,3078,6004
89,Siracusa,56,321,2391,125,39,2,0,0,2878,276,2426,146,186,0,0,0,3034,5912
89,Siracusa,57,348,2268,114,30,0,0,0,2760,243,2390,139,181,0,0,0,2953,5713
89,Siracusa,58,283,2306,106,43,1,0,0,2739,238,2286,153,217,0,0,0,2894,5633
89,Siracusa,59,285,2239,125,45,2,0,0,2696,203,2201,112,239,0,0,0,2755,5451
89,Siracusa,60,249,2153,80,40,0,0,0,2522,197,2165,95,254,0,0,0,2711,5233
89,Siracusa,61,246,2139,93,51,1,0,0,2530,202,2108,115,292,0,0,0,2717,5247
89,Siracusa,62,201,2035,80,56,0,0,0,2372,168,1925,92,292,0,0,0,2477,4849
89,Siracusa,63,212,2107,85,68,0,0,0,2472,188,2052,92,344,0,0,0,2676,5148
89,Siracusa,64,184,2035,58,74,1,0,0,2352,169,2043,82,332,0,0,0,2626,4978
89,Siracusa,65,145,1868,68,78,0,0,0,2159,159,1788,66,380,0,0,0,2393,4552
89,Siracusa,66,156,1877,57,76,0,0,0,2166,145,1675,71,414,0,0,0,2305,4471
89,Siracusa,67,155,1864,73,94,0,0,0,2186,138,1685,52,452,0,0,0,2327,4513
89,Siracusa,68,127,1937,57,91,0,0,0,2212,156,1747,71,531,0,0,0,2505,4717
89,Siracusa,69,108,1960,48,88,0,0,0,2204,136,1675,66,551,0,0,0,2428,4632
89,Siracusa,70,135,2080,48,120,0,0,0,2383,154,1693,69,687,0,0,0,2603,4986
89,Siracusa,71,124,2173,52,149,0,0,0,2498,148,1708,50,779,0,0,0,2685,5183
89,Siracusa,72,106,1856,42,150,0,0,0,2154,147,1516,44,723,0,0,0,2430,4584
89,Siracusa,73,71,1667,22,135,0,0,0,1895,149,1276,46,659,0,0,0,2130,4025
89,Siracusa,74,70,1465,26,128,0,0,0,1689,92,1029,36,708,0,0,0,1865,3554
89,Siracusa,75,80,1324,26,137,0,0,0,1567,103,974,18,734,0,0,0,1829,3396
89,Siracusa,76,64,1256,25,118,0,0,0,1463,117,857,27,791,0,0,0,1792,3255
89,Siracusa,77,64,1197,16,165,0,0,0,1442,104,812,31,839,0,0,0,1786,3228
89,Siracusa,78,66,1357,18,180,0,0,0,1621,98,841,22,1016,0,0,0,1977,3598
89,Siracusa,79,66,1147,23,191,0,0,0,1427,91,730,26,994,0,0,0,1841,3268
89,Siracusa,80,43,1081,21,177,0,0,0,1322,98,609,22,1053,0,0,0,1782,3104
89,Siracusa,81,36,833,7,197,0,0,0,1073,83,407,12,908,0,0,0,1410,2483
89,Siracusa,82,36,815,16,171,0,0,0,1038,70,384,15,865,0,0,0,1334,2372
89,Siracusa,83,32,760,10,209,0,0,0,1011,81,357,13,909,0,0,0,1360,2371
89,Siracusa,84,30,681,6,190,0,0,0,907,69,242,11,930,0,0,0,1252,2159
89,Siracusa,85,19,542,9,184,0,0,0,754,72,240,8,797,0,0,0,1117,1871
89,Siracusa,86,18,413,4,177,0,0,0,612,58,166,8,774,0,0,0,1006,1618
89,Siracusa,87,27,389,3,171,0,0,0,590,66,116,7,778,0,0,0,967,1557
89,Siracusa,88,19,295,2,188,0,0,0,504,49,88,10,689,0,0,0,836,1340
89,Siracusa,89,11,231,1,114,0,0,0,357,40,54,3,575,0,0,0,672,1029
89,Siracusa,90,9,174,3,119,0,0,0,305,42,44,2,459,0,0,0,547,852
89,Siracusa,91,6,108,1,98,0,0,0,213,40,22,4,376,0,0,0,442,655
89,Siracusa,92,5,91,0,72,0,0,0,168,31,22,3,316,0,0,0,372,540
89,Siracusa,93,4,69,0,47,0,0,0,120,32,8,3,267,0,0,0,310,430
89,Siracusa,94,4,35,1,57,0,0,0,97,20,14,0,230,0,0,0,264,361
89,Siracusa,95,3,22,0,47,0,0,0,72,15,9,1,166,0,0,0,191,263
89,Siracusa,96,2,20,0,29,0,0,0,51,14,6,0,107,0,0,0,127,178
89,Siracusa,97,1,12,0,21,0,0,0,34,8,3,0,77,0,0,0,88,122
89,Siracusa,98,2,9,1,10,0,0,0,22,4,4,0,60,0,0,0,68,90
89,Siracusa,99,0,6,0,4,0,0,0,10,1,3,0,32,0,0,0,36,46
89,Siracusa,100,1,10,0,12,0,0,0,23,5,3,0,62,0,0,0,70,93
90,Sassari,0,1505,0,0,0,0,0,0,1505,1444,0,0,0,0,0,0,1444,2949
90,Sassari,1,1703,0,0,0,0,0,0,1703,1530,0,0,0,0,0,0,1530,3233
90,Sassari,2,1698,0,0,0,0,0,0,1698,1619,0,0,0,0,0,0,1619,3317
90,Sassari,3,1809,0,0,0,0,0,0,1809,1652,0,0,0,0,0,0,1652,3461
90,Sassari,4,1843,0,0,0,0,0,0,1843,1719,0,0,0,0,0,0,1719,3562
90,Sassari,5,1866,0,0,0,0,0,0,1866,1739,0,0,0,0,0,0,1739,3605
90,Sassari,6,2016,0,0,0,0,0,0,2016,1878,0,0,0,0,0,0,1878,3894
90,Sassari,7,2109,0,0,0,0,0,0,2109,2000,0,0,0,0,0,0,2000,4109
90,Sassari,8,2207,0,0,0,0,0,0,2207,2003,0,0,0,0,0,0,2003,4210
90,Sassari,9,2169,0,0,0,0,0,0,2169,2015,0,0,0,0,0,0,2015,4184
90,Sassari,10,2193,0,0,0,0,0,0,2193,2054,0,0,0,0,0,0,2054,4247
90,Sassari,11,2209,0,0,0,0,0,0,2209,2090,0,0,0,0,0,0,2090,4299
90,Sassari,12,2158,0,0,0,0,0,0,2158,2020,0,0,0,0,0,0,2020,4178
90,Sassari,13,2135,0,0,0,0,0,0,2135,2081,0,0,0,0,0,0,2081,4216
90,Sassari,14,2153,0,0,0,0,0,0,2153,1999,0,0,0,0,0,0,1999,4152
90,Sassari,15,2207,0,0,0,0,0,0,2207,2110,0,0,0,0,0,0,2110,4317
90,Sassari,16,2111,0,0,0,0,0,0,2111,2082,0,0,0,0,0,0,2082,4193
90,Sassari,17,2124,0,0,0,0,0,0,2124,2047,1,0,0,0,0,0,2048,4172
90,Sassari,18,2319,0,0,0,0,0,0,2319,2045,2,0,0,0,0,0,2047,4366
90,Sassari,19,2352,1,0,0,0,0,0,2353,2067,2,0,0,0,0,0,2069,4422
90,Sassari,20,2294,1,0,0,0,0,0,2295,2042,7,0,0,0,0,0,2049,4344
90,Sassari,21,2318,3,0,0,0,0,0,2321,2073,17,1,0,0,0,0,2091,4412
90,Sassari,22,2376,7,0,0,1,0,0,2384,2073,32,0,0,0,0,0,2105,4489
90,Sassari,23,2442,17,0,0,1,0,0,2460,2066,61,0,0,0,0,0,2127,4587
90,Sassari,24,2400,27,1,0,1,0,0,2429,2108,74,1,0,0,0,0,2183,4612
90,Sassari,25,2490,36,0,0,0,0,0,2526,2209,128,2,0,1,0,0,2340,4866
90,Sassari,26,2568,60,1,0,0,0,0,2629,2211,222,2,0,0,0,0,2435,5064
90,Sassari,27,2519,115,4,1,0,0,0,2639,2162,281,6,1,1,0,0,2451,5090
90,Sassari,28,2518,168,4,1,2,0,0,2693,2131,411,8,0,1,0,0,2551,5244
90,Sassari,29,2529,234,5,0,1,0,0,2769,2032,561,17,1,0,0,0,2611,5380
90,Sassari,30,2394,290,6,1,1,0,0,2692,1921,683,16,0,2,0,0,2622,5314
90,Sassari,31,2404,419,9,0,1,0,0,2833,1859,795,13,1,1,0,0,2669,5502
90,Sassari,32,2227,570,13,1,1,0,0,2812,1745,925,33,1,0,0,0,2704,5516
90,Sassari,33,2180,686,18,0,0,0,0,2884,1638,1145,38,3,0,0,0,2824,5708
90,Sassari,34,2139,761,15,0,2,0,0,2917,1480,1238,56,8,1,0,0,2783,5700
90,Sassari,35,1983,891,25,1,0,0,0,2900,1516,1316,52,6,0,0,0,2890,5790
90,Sassari,36,2008,1082,27,3,0,0,0,3120,1434,1489,79,14,1,0,0,3017,6137
90,Sassari,37,1924,1163,36,1,2,0,0,3126,1365,1595,82,5,0,0,0,3047,6173
90,Sassari,38,1867,1411,52,4,2,0,0,3336,1292,1719,100,14,1,0,0,3126,6462
90,Sassari,39,1746,1472,51,2,0,0,0,3271,1362,1845,129,10,0,0,0,3346,6617
90,Sassari,40,1914,1671,83,6,1,0,0,3675,1288,2095,139,18,1,0,0,3541,7216
90,Sassari,41,1826,1780,112,4,1,0,0,3723,1243,2165,154,17,0,0,0,3579,7302
90,Sassari,42,1822,1987,102,4,2,0,0,3917,1225,2312,181,39,1,0,0,3758,7675
90,Sassari,43,1870,2148,134,11,3,0,0,4166,1248,2509,183,38,2,0,0,3980,8146
90,Sassari,44,1823,2265,144,12,2,0,0,4246,1218,2607,204,49,0,0,0,4078,8324
90,Sassari,45,1733,2424,159,14,2,0,0,4332,1177,2713,250,47,1,0,0,4188,8520
90,Sassari,46,1536,2400,176,13,6,0,0,4131,1055,2712,248,61,1,0,0,4077,8208
90,Sassari,47,1441,2428,164,10,2,0,0,4045,994,2851,240,79,0,0,0,4164,8209
90,Sassari,48,1329,2534,219,18,1,0,0,4101,937,2723,289,65,2,0,0,4016,8117
90,Sassari,49,1356,2601,223,23,1,0,0,4204,911,2876,263,82,0,0,0,4132,8336
90,Sassari,50,1171,2668,216,25,1,0,0,4081,835,2862,286,95,0,0,0,4078,8159
90,Sassari,51,1095,2693,242,24,1,0,0,4055,817,2951,284,119,1,0,0,4172,8227
90,Sassari,52,1051,2775,239,33,2,0,0,4100,806,3022,279,121,0,0,0,4228,8328
90,Sassari,53,975,2948,256,31,2,0,0,4212,765,3009,281,138,0,0,0,4193,8405
90,Sassari,54,902,2939,277,28,2,0,0,4148,728,3131,289,157,0,0,0,4305,8453
90,Sassari,55,825,2805,253,29,0,0,0,3912,655,2971,281,232,1,0,0,4140,8052
90,Sassari,56,740,2856,233,44,1,0,0,3874,578,2856,252,214,1,0,0,3901,7775
90,Sassari,57,640,2796,214,46,1,0,0,3697,527,2903,222,210,0,0,0,3862,7559
90,Sassari,58,637,2806,233,63,0,0,0,3739,514,2798,223,271,1,0,0,3807,7546
90,Sassari,59,577,2674,172,57,3,0,0,3483,459,2694,224,257,0,0,0,3634,7117
90,Sassari,60,508,2686,167,69,0,0,0,3430,430,2719,191,297,0,0,0,3637,7067
90,Sassari,61,473,2671,173,65,3,0,0,3385,399,2611,179,334,0,0,0,3523,6908
90,Sassari,62,465,2611,146,93,3,0,0,3318,394,2483,167,342,1,0,0,3387,6705
90,Sassari,63,447,2510,162,82,4,0,0,3205,388,2432,146,380,0,0,0,3346,6551
90,Sassari,64,470,2563,155,99,2,0,0,3289,379,2424,146,414,0,0,0,3363,6652
90,Sassari,65,403,2477,155,63,1,0,0,3099,349,2248,132,368,0,0,0,3097,6196
90,Sassari,66,372,2352,127,101,0,0,0,2952,371,2229,113,451,0,0,0,3164,6116
90,Sassari,67,326,2348,115,92,1,0,0,2882,321,2208,102,544,0,0,0,3175,6057
90,Sassari,68,315,2418,98,116,0,0,0,2947,361,2094,112,577,0,0,0,3144,6091
90,Sassari,69,304,2363,89,131,1,0,0,2888,275,2050,87,581,0,0,0,2993,5881
90,Sassari,70,314,2260,103,150,0,0,0,2827,339,2069,97,660,0,0,0,3165,5992
90,Sassari,71,290,2262,96,150,1,0,0,2799,308,1878,75,710,0,0,0,2971,5770
90,Sassari,72,232,2141,89,144,0,0,0,2606,276,1718,84,735,0,0,0,2813,5419
90,Sassari,73,216,1943,47,122,0,0,0,2328,273,1572,64,737,0,0,0,2646,4974
90,Sassari,74,228,1845,44,163,2,0,0,2282,292,1495,70,806,0,0,0,2663,4945
90,Sassari,75,168,1755,39,170,2,0,0,2134,272,1338,52,881,0,0,0,2543,4677
90,Sassari,76,195,1675,43,178,1,0,0,2092,249,1306,51,974,0,0,0,2580,4672
90,Sassari,77,174,1489,45,188,0,0,0,1896,284,1135,39,973,0,0,0,2431,4327
90,Sassari,78,208,1628,48,220,0,0,0,2104,276,1111,34,1142,0,0,0,2563,4667
90,Sassari,79,192,1460,40,202,0,0,0,1894,244,987,39,1115,0,0,0,2385,4279
90,Sassari,80,152,1248,27,206,0,0,0,1633,282,779,30,1079,0,0,0,2170,3803
90,Sassari,81,143,1077,18,209,0,0,0,1447,227,703,25,1111,0,0,0,2066,3513
90,Sassari,82,113,998,23,209,0,0,0,1343,245,553,16,1024,0,0,0,1838,3181
90,Sassari,83,117,806,13,189,0,0,0,1125,240,436,14,1073,0,0,0,1763,2888
90,Sassari,84,132,841,12,218,0,0,0,1203,220,387,14,1077,0,0,0,1698,2901
90,Sassari,85,106,685,10,197,0,0,0,998,205,304,14,1032,0,0,0,1555,2553
90,Sassari,86,97,568,5,195,0,0,0,865,210,251,7,895,0,0,0,1363,2228
90,Sassari,87,78,507,8,179,0,0,0,772,185,156,12,854,0,0,0,1207,1979
90,Sassari,88,69,407,5,187,0,0,0,668,184,142,4,875,0,0,0,1205,1873
90,Sassari,89,55,288,4,158,0,0,0,505,168,96,4,734,0,0,0,1002,1507
90,Sassari,90,40,238,3,127,0,0,0,408,126,62,6,626,0,0,0,820,1228
90,Sassari,91,33,197,1,107,0,0,0,338,107,46,1,548,0,0,0,702,1040
90,Sassari,92,35,129,1,95,0,0,0,260,94,26,2,438,0,0,0,560,820
90,Sassari,93,13,89,0,86,0,0,0,188,68,19,0,354,0,0,0,441,629
90,Sassari,94,11,55,1,65,0,0,0,132,66,24,0,317,0,0,0,407,539
90,Sassari,95,12,53,0,55,0,0,0,120,51,5,2,222,0,0,0,280,400
90,Sassari,96,3,32,0,40,0,0,0,75,20,3,3,176,0,0,0,202,277
90,Sassari,97,4,16,0,27,0,0,0,47,17,3,0,118,0,0,0,138,185
90,Sassari,98,5,14,0,20,0,0,0,39,10,1,0,87,0,0,0,98,137
90,Sassari,99,1,5,0,12,0,0,0,18,8,1,0,47,0,0,0,56,74
90,Sassari,100,0,9,0,8,0,0,0,17,18,0,0,68,0,0,0,86,103
91,Nuoro,0,670,0,0,0,0,0,0,670,600,0,0,0,0,0,0,600,1270
91,Nuoro,1,702,0,0,0,0,0,0,702,668,0,0,0,0,0,0,668,1370
91,Nuoro,2,691,0,0,0,0,0,0,691,679,0,0,0,0,0,0,679,1370
91,Nuoro,3,719,0,0,0,0,0,0,719,693,0,0,0,0,0,0,693,1412
91,Nuoro,4,774,0,0,0,0,0,0,774,730,0,0,0,0,0,0,730,1504
91,Nuoro,5,819,0,0,0,0,0,0,819,746,0,0,0,0,0,0,746,1565
91,Nuoro,6,855,0,0,0,0,0,0,855,770,0,0,0,0,0,0,770,1625
91,Nuoro,7,865,0,0,0,0,0,0,865,860,0,0,0,0,0,0,860,1725
91,Nuoro,8,928,0,0,0,0,0,0,928,848,0,0,0,0,0,0,848,1776
91,Nuoro,9,966,0,0,0,0,0,0,966,800,0,0,0,0,0,0,800,1766
91,Nuoro,10,927,0,0,0,0,0,0,927,873,0,0,0,0,0,0,873,1800
91,Nuoro,11,916,0,0,0,0,0,0,916,816,0,0,0,0,0,0,816,1732
91,Nuoro,12,978,0,0,0,0,0,0,978,859,0,0,0,0,0,0,859,1837
91,Nuoro,13,967,0,0,0,0,0,0,967,910,0,0,0,0,0,0,910,1877
91,Nuoro,14,964,0,0,0,0,0,0,964,864,0,0,0,0,0,0,864,1828
91,Nuoro,15,987,0,0,0,0,0,0,987,908,0,0,0,0,0,0,908,1895
91,Nuoro,16,912,0,0,0,0,0,0,912,878,0,0,0,0,0,0,878,1790
91,Nuoro,17,1042,0,0,0,0,0,0,1042,958,0,0,0,0,0,0,958,2000
91,Nuoro,18,1046,0,0,0,0,0,0,1046,945,0,0,0,0,0,0,945,1991
91,Nuoro,19,1060,0,0,0,0,0,0,1060,933,0,0,0,0,0,0,933,1993
91,Nuoro,20,1029,0,0,0,0,0,0,1029,976,2,0,0,0,0,0,978,2007
91,Nuoro,21,1096,2,0,0,0,0,0,1098,940,7,0,0,0,0,0,947,2045
91,Nuoro,22,1064,0,0,0,0,0,0,1064,945,10,0,0,0,0,0,955,2019
91,Nuoro,23,1122,5,0,0,0,0,0,1127,1000,15,0,0,0,0,0,1015,2142
91,Nuoro,24,1131,5,0,0,0,0,0,1136,993,28,0,0,0,0,0,1021,2157
91,Nuoro,25,1100,11,0,0,0,0,0,1111,970,60,2,0,0,0,0,1032,2143
91,Nuoro,26,1144,18,1,0,0,0,0,1163,956,92,0,0,0,0,0,1048,2211
91,Nuoro,27,1164,41,1,0,1,0,0,1207,971,134,0,0,0,0,0,1105,2312
91,Nuoro,28,1150,58,0,0,0,0,0,1208,979,187,1,1,0,0,0,1168,2376
91,Nuoro,29,1073,91,0,0,0,0,0,1164,827,205,0,0,0,0,0,1032,2196
91,Nuoro,30,1135,135,1,1,0,0,0,1272,838,290,2,1,0,0,0,1131,2403
91,Nuoro,31,967,161,2,1,0,0,0,1131,748,332,6,1,0,0,0,1087,2218
91,Nuoro,32,944,206,0,0,1,0,0,1151,724,377,3,0,0,0,0,1104,2255
91,Nuoro,33,916,254,2,0,1,0,0,1173,641,433,6,2,1,0,0,1083,2256
91,Nuoro,34,902,282,4,1,2,0,0,1191,630,437,12,2,0,0,0,1081,2272
91,Nuoro,35,886,309,3,0,1,0,0,1199,573,529,13,5,3,0,0,1123,2322
91,Nuoro,36,859,379,4,0,0,0,0,1242,544,570,15,4,1,0,0,1134,2376
91,Nuoro,37,781,448,5,0,0,0,0,1234,527,644,15,6,0,0,0,1192,2426
91,Nuoro,38,758,535,6,2,0,0,0,1301,489,649,17,7,1,0,0,1163,2464
91,Nuoro,39,785,488,9,2,0,0,0,1284,436,705,24,6,0,0,0,1171,2455
91,Nuoro,40,785,639,10,1,0,0,0,1435,499,880,37,6,0,0,0,1422,2857
91,Nuoro,41,750,699,19,4,0,0,0,1472,419,858,35,14,0,0,0,1326,2798
91,Nuoro,42,768,696,18,2,0,0,0,1484,449,949,42,12,0,0,0,1452,2936
91,Nuoro,43,729,741,21,0,0,0,0,1491,410,955,49,14,0,0,0,1428,2919
91,Nuoro,44,734,859,39,3,1,0,0,1636,385,985,51,23,0,0,0,1444,3080
91,Nuoro,45,652,888,31,1,0,0,0,1572,382,1059,50,30,0,0,0,1521,3093
91,Nuoro,46,651,865,43,2,0,0,0,1561,370,1066,61,34,0,0,0,1531,3092
91,Nuoro,47,581,989,38,2,0,0,0,1610,375,1094,58,17,0,0,0,1544,3154
91,Nuoro,48,591,959,49,4,0,0,0,1603,339,1112,61,33,0,0,0,1545,3148
91,Nuoro,49,586,1027,70,9,0,0,0,1692,353,1193,65,44,0,0,0,1655,3347
91,Nuoro,50,573,1043,60,7,0,0,0,1683,327,1191,54,44,0,0,0,1616,3299
91,Nuoro,51,566,1156,52,4,1,0,0,1779,315,1264,74,58,1,0,0,1712,3491
91,Nuoro,52,507,1208,56,9,0,0,0,1780,314,1299,77,66,0,0,0,1756,3536
91,Nuoro,53,477,1173,51,13,0,0,0,1714,309,1220,58,69,0,0,0,1656,3370
91,Nuoro,54,421,1287,76,13,0,0,0,1797,318,1331,62,92,0,0,0,1803,3600
91,Nuoro,55,391,1214,66,15,0,0,0,1686,328,1215,58,92,0,0,0,1693,3379
91,Nuoro,56,374,1180,69,21,0,0,0,1644,291,1205,63,103,0,0,0,1662,3306
91,Nuoro,57,412,1138,61,17,0,0,0,1628,265,1255,49,122,0,0,0,1691,3319
91,Nuoro,58,338,1135,41,26,1,0,0,1541,249,1149,46,100,0,0,0,1544,3085
91,Nuoro,59,329,1123,53,16,0,0,0,1521,204,1164,52,107,0,0,0,1527,3048
91,Nuoro,60,330,1150,40,29,0,0,0,1549,247,1089,36,134,0,0,0,1506,3055
91,Nuoro,61,288,1074,41,24,0,0,0,1427,234,1120,45,158,1,0,0,1558,2985
91,Nuoro,62,294,1089,44,33,0,0,0,1460,223,1110,45,164,0,0,0,1542,3002
91,Nuoro,63,267,1068,32,29,0,0,0,1396,238,1071,32,182,0,0,0,1523,2919
91,Nuoro,64,266,1094,42,36,0,0,0,1438,211,1058,38,194,0,0,0,1501,2939
91,Nuoro,65,234,1009,37,39,0,0,0,1319,220,938,33,190,0,0,0,1381,2700
91,Nuoro,66,249,1103,37,35,0,0,0,1424,203,918,24,212,0,0,0,1357,2781
91,Nuoro,67,213,985,29,38,0,0,0,1265,174,848,34,263,1,0,0,1320,2585
91,Nuoro,68,206,969,22,52,0,0,0,1249,181,867,19,297,0,0,0,1364,2613
91,Nuoro,69,174,966,17,41,0,0,0,1198,176,804,22,276,0,0,0,1278,2476
91,Nuoro,70,202,960,34,61,0,0,0,1257,188,819,28,337,0,0,0,1372,2629
91,Nuoro,71,180,879,19,43,0,0,0,1121,158,718,15,342,0,0,0,1233,2354
91,Nuoro,72,146,820,20,59,0,0,0,1045,171,633,15,351,0,0,0,1170,2215
91,Nuoro,73,152,770,21,56,0,0,0,999,173,613,12,403,0,0,0,1201,2200
91,Nuoro,74,153,780,16,52,0,0,0,1001,188,607,15,408,0,0,0,1218,2219
91,Nuoro,75,141,682,11,53,0,0,0,887,193,554,9,405,0,0,0,1161,2048
91,Nuoro,76,127,707,13,70,0,0,0,917,159,540,11,463,0,0,0,1173,2090
91,Nuoro,77,112,623,10,54,0,0,0,799,149,431,7,471,0,0,0,1058,1857
91,Nuoro,78,132,644,10,66,0,0,0,852,185,467,9,541,0,0,0,1202,2054
91,Nuoro,79,105,627,9,75,0,0,0,816,186,389,4,549,0,0,0,1128,1944
91,Nuoro,80,100,547,3,90,0,0,0,740,186,327,7,551,0,0,0,1071,1811
91,Nuoro,81,84,442,3,86,0,0,0,615,168,238,5,527,0,0,0,938,1553
91,Nuoro,82,70,470,2,83,0,0,0,625,189,237,4,527,0,0,0,957,1582
91,Nuoro,83,68,377,7,71,0,0,0,523,174,202,2,508,0,0,0,886,1409
91,Nuoro,84,67,364,4,84,0,0,0,519,165,142,5,498,0,0,0,810,1329
91,Nuoro,85,47,343,6,79,0,0,0,475,154,117,8,475,0,0,0,754,1229
91,Nuoro,86,45,266,1,80,0,0,0,392,149,108,3,496,0,0,0,756,1148
91,Nuoro,87,50,242,0,71,0,0,0,363,120,66,2,462,0,0,0,650,1013
91,Nuoro,88,28,220,1,82,0,0,0,331,109,62,4,443,0,0,0,618,949
91,Nuoro,89,40,157,0,67,0,0,0,264,106,51,1,345,0,0,0,503,767
91,Nuoro,90,24,138,0,57,0,0,0,219,109,46,2,334,0,0,0,491,710
91,Nuoro,91,19,101,1,41,0,0,0,162,71,17,2,260,0,0,0,350,512
91,Nuoro,92,15,75,0,54,0,0,0,144,59,20,0,279,0,0,0,358,502
91,Nuoro,93,15,50,0,39,0,0,0,104,37,15,0,191,0,0,0,243,347
91,Nuoro,94,11,41,0,40,0,0,0,92,31,10,1,167,0,0,0,209,301
91,Nuoro,95,4,36,0,30,0,0,0,70,25,8,0,106,0,0,0,139,209
91,Nuoro,96,5,18,0,23,0,0,0,46,24,2,0,105,0,0,0,131,177
91,Nuoro,97,4,16,0,10,0,0,0,30,13,2,0,53,0,0,0,68,98
91,Nuoro,98,1,5,0,7,0,0,0,13,11,0,1,54,0,0,0,66,79
91,Nuoro,99,1,6,0,8,0,0,0,15,9,0,0,35,0,0,0,44,59
91,Nuoro,100,1,5,0,11,0,0,0,17,5,0,0,41,0,0,0,46,63
92,Cagliari,0,1209,0,0,0,0,0,0,1209,1148,0,0,0,0,0,0,1148,2357
92,Cagliari,1,1356,0,0,0,0,0,0,1356,1286,0,0,0,0,0,0,1286,2642
92,Cagliari,2,1512,0,0,0,0,0,0,1512,1326,0,0,0,0,0,0,1326,2838
92,Cagliari,3,1635,0,0,0,0,0,0,1635,1450,0,0,0,0,0,0,1450,3085
92,Cagliari,4,1577,0,0,0,0,0,0,1577,1458,0,0,0,0,0,0,1458,3035
92,Cagliari,5,1629,0,0,0,0,0,0,1629,1503,0,0,0,0,0,0,1503,3132
92,Cagliari,6,1791,0,0,0,0,0,0,1791,1685,0,0,0,0,0,0,1685,3476
92,Cagliari,7,1781,0,0,0,0,0,0,1781,1681,0,0,0,0,0,0,1681,3462
92,Cagliari,8,1856,0,0,0,0,0,0,1856,1749,0,0,0,0,0,0,1749,3605
92,Cagliari,9,1913,0,0,0,0,0,0,1913,1730,0,0,0,0,0,0,1730,3643
92,Cagliari,10,1848,0,0,0,0,0,0,1848,1764,0,0,0,0,0,0,1764,3612
92,Cagliari,11,1789,0,0,0,0,0,0,1789,1751,0,0,0,0,0,0,1751,3540
92,Cagliari,12,1896,0,0,0,0,0,0,1896,1759,0,0,0,0,0,0,1759,3655
92,Cagliari,13,1883,0,0,0,0,0,0,1883,1699,0,0,0,0,0,0,1699,3582
92,Cagliari,14,1779,0,0,0,0,0,0,1779,1725,0,0,0,0,0,0,1725,3504
92,Cagliari,15,1914,0,0,0,0,0,0,1914,1791,0,0,0,0,0,0,1791,3705
92,Cagliari,16,1826,0,0,0,0,0,0,1826,1724,0,0,0,0,0,0,1724,3550
92,Cagliari,17,1901,0,0,0,0,0,0,1901,1804,0,0,0,0,0,0,1804,3705
92,Cagliari,18,1957,0,0,0,0,0,0,1957,1737,1,0,0,0,0,0,1738,3695
92,Cagliari,19,1994,0,0,0,0,0,0,1994,1742,2,0,0,0,0,0,1744,3738
92,Cagliari,20,2047,1,0,0,0,0,0,2048,1659,6,0,0,0,0,0,1665,3713
92,Cagliari,21,1937,2,0,0,0,0,0,1939,1694,7,0,0,1,0,0,1702,3641
92,Cagliari,22,2009,10,0,0,0,0,0,2019,1703,22,0,0,0,0,0,1725,3744
92,Cagliari,23,2109,8,0,0,1,0,0,2118,1710,39,0,1,0,0,0,1750,3868
92,Cagliari,24,2138,27,0,0,0,0,0,2165,1810,70,0,0,0,0,0,1880,4045
92,Cagliari,25,2075,31,0,0,0,0,0,2106,1906,93,0,0,0,0,0,1999,4105
92,Cagliari,26,2142,56,0,0,0,0,0,2198,1901,127,3,0,0,0,0,2031,4229
92,Cagliari,27,2148,95,0,0,0,0,0,2243,1855,195,3,1,1,0,0,2055,4298
92,Cagliari,28,2336,132,1,0,0,0,0,2469,1924,282,2,0,1,0,0,2209,4678
92,Cagliari,29,2167,174,4,0,1,0,0,2346,1821,334,4,0,1,0,0,2160,4506
92,Cagliari,30,2204,264,1,0,0,0,0,2469,1789,477,11,5,0,0,0,2282,4751
92,Cagliari,31,2088,284,3,0,0,0,0,2375,1670,594,17,0,1,0,0,2282,4657
92,Cagliari,32,1954,387,8,0,1,0,0,2350,1687,669,19,2,1,0,0,2378,4728
92,Cagliari,33,2035,489,7,1,0,0,0,2532,1665,739,22,4,4,0,0,2434,4966
92,Cagliari,34,1953,610,17,1,1,0,0,2582,1560,803,42,4,2,0,0,2411,4993
92,Cagliari,35,1979,706,16,1,2,0,0,2704,1523,1038,45,3,1,1,0,2611,5315
92,Cagliari,36,1877,865,25,0,1,0,0,2768,1509,1214,51,4,0,0,0,2778,5546
92,Cagliari,37,1828,877,33,2,3,0,0,2743,1440,1345,63,8,3,0,0,2859,5602
92,Cagliari,38,1807,1093,36,2,3,0,0,2941,1379,1401,70,7,2,0,0,2859,5800
92,Cagliari,39,1774,1140,45,5,3,0,0,2967,1338,1479,67,13,1,0,0,2898,5865
92,Cagliari,40,1703,1394,49,3,1,0,0,3150,1386,1643,90,18,2,0,0,3139,6289
92,Cagliari,41,1761,1462,61,4,2,0,0,3290,1307,1785,108,19,1,0,0,3220,6510
92,Cagliari,42,1738,1525,90,2,0,0,0,3355,1366,1931,135,27,1,0,0,3460,6815
92,Cagliari,43,1734,1798,102,4,3,0,0,3641,1352,2204,162,26,0,0,0,3744,7385
92,Cagliari,44,1781,1998,114,11,3,0,0,3907,1411,2251,153,30,5,0,0,3850,7757
92,Cagliari,45,1694,2083,147,12,2,0,0,3938,1236,2376,188,44,1,0,0,3845,7783
92,Cagliari,46,1562,2099,125,10,3,0,0,3799,1220,2405,246,41,0,0,0,3912,7711
92,Cagliari,47,1367,2114,150,18,3,0,0,3652,1153,2509,219,50,0,0,0,3931,7583
92,Cagliari,48,1273,2226,152,13,4,0,0,3668,1026,2432,229,77,1,0,0,3765,7433
92,Cagliari,49,1256,2219,186,21,2,0,0,3684,930,2619,227,67,0,0,0,3843,7527
92,Cagliari,50,1065,2263,184,15,2,0,0,3529,935,2555,256,74,0,0,0,3820,7349
92,Cagliari,51,1087,2342,199,28,1,0,0,3657,869,2602,253,80,1,0,0,3805,7462
92,Cagliari,52,999,2391,189,24,3,0,0,3606,854,2609,260,95,0,0,0,3818,7424
92,Cagliari,53,876,2522,210,41,0,0,0,3649,831,2693,298,138,1,0,0,3961,7610
92,Cagliari,54,863,2621,216,35,2,0,0,3737,722,2749,263,135,1,0,1,3871,7608
92,Cagliari,55,711,2511,230,33,1,0,0,3486,734,2577,260,153,0,0,0,3724,7210
92,Cagliari,56,619,2405,220,53,0,0,0,3297,630,2558,276,169,0,0,0,3633,6930
92,Cagliari,57,555,2336,186,49,3,0,0,3129,629,2485,248,196,1,0,0,3559,6688
92,Cagliari,58,502,2376,191,54,1,0,0,3124,570,2348,225,178,0,0,0,3321,6445
92,Cagliari,59,453,2327,203,60,3,0,0,3046,561,2407,253,242,1,0,0,3464,6510
92,Cagliari,60,379,2301,187,44,1,0,0,2912,479,2280,255,215,0,0,0,3229,6141
92,Cagliari,61,388,2254,172,64,1,0,0,2879,463,2337,202,269,0,0,0,3271,6150
92,Cagliari,62,335,2295,167,59,3,0,0,2859,382,2427,192,291,1,0,0,3293,6152
92,Cagliari,63,296,2237,147,67,1,0,0,2748,408,2207,150,303,0,0,0,3068,5816
92,Cagliari,64,259,2226,138,92,2,0,0,2717,427,2238,188,352,0,0,0,3205,5922
92,Cagliari,65,212,2119,124,93,0,0,0,2548,382,2106,158,351,0,0,0,2997,5545
92,Cagliari,66,212,2085,100,86,0,0,0,2483,343,2058,152,372,0,0,0,2925,5408
92,Cagliari,67,178,2016,107,79,1,0,0,2381,334,2031,127,385,0,0,0,2877,5258
92,Cagliari,68,169,2058,115,126,1,0,0,2469,345,1882,148,501,0,0,0,2876,5345
92,Cagliari,69,171,2039,76,103,0,0,0,2389,284,1903,112,515,0,0,0,2814,5203
92,Cagliari,70,157,2021,87,115,0,0,0,2380,300,1905,114,531,0,0,0,2850,5230
92,Cagliari,71,120,1958,77,121,0,0,1,2277,309,1786,94,611,0,0,0,2800,5077
92,Cagliari,72,107,1945,65,140,0,0,0,2257,291,1570,87,574,0,0,0,2522,4779
92,Cagliari,73,138,1749,42,117,0,0,0,2046,244,1477,89,653,0,0,0,2463,4509
92,Cagliari,74,89,1530,48,131,0,0,0,1798,235,1241,55,596,0,0,0,2127,3925
92,Cagliari,75,75,1404,49,138,0,0,0,1666,235,1193,57,719,0,0,0,2204,3870
92,Cagliari,76,98,1526,38,183,0,0,0,1845,237,1220,42,794,0,0,0,2293,4138
92,Cagliari,77,69,1419,39,152,0,0,0,1679,247,1075,49,780,0,0,0,2151,3830
92,Cagliari,78,97,1417,35,186,0,0,0,1735,237,1038,48,966,0,0,0,2289,4024
92,Cagliari,79,83,1286,24,170,0,0,0,1563,232,847,44,892,0,0,0,2015,3578
92,Cagliari,80,77,1126,17,146,0,0,0,1366,201,727,41,839,0,0,0,1808,3174
92,Cagliari,81,65,962,22,178,0,0,0,1227,195,637,28,815,0,0,0,1675,2902
92,Cagliari,82,61,910,17,166,0,0,0,1154,182,521,17,910,0,0,0,1630,2784
92,Cagliari,83,34,727,11,150,0,0,0,922,180,431,14,805,0,0,0,1430,2352
92,Cagliari,84,29,666,9,166,0,0,0,870,171,380,14,889,1,0,1,1456,2326
92,Cagliari,85,36,609,6,172,0,0,0,823,167,320,17,827,0,0,0,1331,2154
92,Cagliari,86,33,457,6,166,0,0,0,662,165,231,6,747,0,0,0,1149,1811
92,Cagliari,87,25,402,6,146,0,0,1,580,129,174,9,715,0,0,0,1027,1607
92,Cagliari,88,29,383,6,147,0,0,0,565,127,143,5,749,0,0,0,1024,1589
92,Cagliari,89,20,267,2,104,0,0,0,393,132,101,6,642,1,0,0,882,1275
92,Cagliari,90,17,201,3,110,0,0,0,331,107,78,5,570,0,0,0,760,1091
92,Cagliari,91,9,151,1,77,0,0,0,238,82,45,3,486,0,0,0,616,854
92,Cagliari,92,9,107,0,71,0,0,0,187,72,35,1,390,0,0,0,498,685
92,Cagliari,93,7,58,2,53,0,0,0,120,57,21,2,300,0,0,0,380,500
92,Cagliari,94,5,55,0,35,0,0,0,95,50,12,2,243,0,0,0,307,402
92,Cagliari,95,5,29,2,39,0,0,0,75,30,7,0,162,0,0,0,199,274
92,Cagliari,96,5,26,0,38,0,0,0,69,23,5,1,154,0,0,0,183,252
92,Cagliari,97,1,10,0,26,0,0,0,37,20,3,1,121,0,0,0,145,182
92,Cagliari,98,1,10,0,18,0,0,0,29,14,2,0,93,0,0,0,109,138
92,Cagliari,99,0,3,0,8,0,0,0,11,11,0,0,30,0,0,0,41,52
92,Cagliari,100,0,2,0,8,0,0,0,10,17,1,2,64,0,0,0,84,94
93,Pordenone,0,1180,0,0,0,0,0,0,1180,1078,0,0,0,0,0,0,1078,2258
93,Pordenone,1,1217,0,0,0,0,0,0,1217,1144,0,0,0,0,0,0,1144,2361
93,Pordenone,2,1285,0,0,0,0,0,0,1285,1221,0,0,0,0,0,0,1221,2506
93,Pordenone,3,1317,0,0,0,0,0,0,1317,1209,0,0,0,0,0,0,1209,2526
93,Pordenone,4,1404,0,0,0,0,0,0,1404,1285,0,0,0,0,0,0,1285,2689
93,Pordenone,5,1393,0,0,0,0,0,0,1393,1391,0,0,0,0,0,0,1391,2784
93,Pordenone,6,1448,0,0,0,0,0,0,1448,1346,0,0,0,0,0,0,1346,2794
93,Pordenone,7,1560,0,0,0,0,0,0,1560,1365,0,0,0,0,0,0,1365,2925
93,Pordenone,8,1538,0,0,0,0,0,0,1538,1437,0,0,0,0,0,0,1437,2975
93,Pordenone,9,1625,0,0,0,0,0,0,1625,1478,0,0,0,0,0,0,1478,3103
93,Pordenone,10,1595,0,0,0,0,0,0,1595,1451,0,0,0,0,0,0,1451,3046
93,Pordenone,11,1607,0,0,0,0,0,0,1607,1515,0,0,0,0,0,0,1515,3122
93,Pordenone,12,1557,0,0,0,0,0,0,1557,1468,0,0,0,0,0,0,1468,3025
93,Pordenone,13,1485,0,0,0,0,0,0,1485,1416,0,0,0,0,0,0,1416,2901
93,Pordenone,14,1470,0,0,0,0,0,0,1470,1503,0,0,0,0,0,0,1503,2973
93,Pordenone,15,1477,0,0,0,0,0,0,1477,1364,0,0,0,0,0,0,1364,2841
93,Pordenone,16,1433,0,0,0,0,0,0,1433,1361,0,0,0,0,0,0,1361,2794
93,Pordenone,17,1520,0,0,0,0,0,0,1520,1341,0,0,0,0,0,0,1341,2861
93,Pordenone,18,1498,0,0,0,0,0,0,1498,1439,2,0,0,0,0,0,1441,2939
93,Pordenone,19,1502,1,1,0,0,0,0,1504,1363,19,0,0,0,0,0,1382,2886
93,Pordenone,20,1480,2,0,0,0,0,0,1482,1345,32,1,0,0,0,0,1378,2860
93,Pordenone,21,1421,9,0,0,0,0,0,1430,1301,35,0,0,0,0,0,1336,2766
93,Pordenone,22,1574,6,0,0,0,0,0,1580,1322,62,0,0,0,0,0,1384,2964
93,Pordenone,23,1463,24,0,0,0,0,0,1487,1196,88,0,1,2,0,0,1287,2774
93,Pordenone,24,1451,35,0,0,0,0,0,1486,1170,129,1,0,0,0,0,1300,2786
93,Pordenone,25,1443,62,1,0,0,0,0,1506,1192,178,2,0,1,0,0,1373,2879
93,Pordenone,26,1471,79,0,0,1,0,0,1551,1184,256,5,0,0,0,0,1445,2996
93,Pordenone,27,1455,127,3,0,0,0,0,1585,1130,393,5,0,0,0,0,1528,3113
93,Pordenone,28,1387,186,4,0,0,0,0,1577,1046,434,4,0,1,0,0,1485,3062
93,Pordenone,29,1335,277,4,0,0,0,0,1616,996,512,20,0,1,0,0,1529,3145
93,Pordenone,30,1319,337,6,0,0,0,0,1662,933,651,14,1,1,0,0,1600,3262
93,Pordenone,31,1124,455,4,0,0,0,0,1583,807,733,26,0,0,0,0,1566,3149
93,Pordenone,32,1052,530,9,0,0,0,0,1591,764,832,24,3,2,0,0,1625,3216
93,Pordenone,33,1093,600,12,0,0,0,0,1705,757,909,24,3,0,0,0,1693,3398
93,Pordenone,34,1020,733,15,0,0,0,0,1768,687,934,30,0,3,0,0,1654,3422
93,Pordenone,35,1014,753,20,2,1,0,0,1790,662,1002,44,3,0,0,0,1711,3501
93,Pordenone,36,976,925,27,0,0,0,0,1928,678,1128,74,7,1,0,0,1888,3816
93,Pordenone,37,973,995,22,0,0,0,0,1990,616,1205,56,8,0,0,0,1885,3875
93,Pordenone,38,956,1066,36,3,1,0,0,2062,640,1218,65,12,1,0,0,1936,3998
93,Pordenone,39,929,1133,40,3,0,0,0,2105,598,1274,75,10,2,0,0,1959,4064
93,Pordenone,40,984,1262,43,1,0,0,0,2290,627,1364,103,10,0,0,0,2104,4394
93,Pordenone,41,952,1275,82,1,1,0,0,2311,564,1424,108,8,1,0,0,2105,4416
93,Pordenone,42,976,1344,61,3,0,0,0,2384,615,1519,126,18,1,0,0,2279,4663
93,Pordenone,43,948,1395,96,5,3,0,0,2447,613,1593,138,18,0,0,0,2362,4809
93,Pordenone,44,924,1540,117,8,1,0,0,2590,584,1760,181,21,0,0,0,2546,5136
93,Pordenone,45,901,1567,90,6,1,0,0,2565,547,1702,189,27,0,0,0,2465,5030
93,Pordenone,46,770,1617,132,5,0,0,0,2524,477,1898,204,29,0,0,0,2608,5132
93,Pordenone,47,762,1639,144,15,0,0,0,2560,504,1776,203,26,0,0,0,2509,5069
93,Pordenone,48,730,1614,158,4,0,0,0,2506,489,1870,193,50,0,0,0,2602,5108
93,Pordenone,49,690,1732,163,13,1,0,0,2599,456,1857,228,47,0,0,0,2588,5187
93,Pordenone,50,660,1826,149,17,1,0,0,2653,462,1865,213,61,1,0,0,2602,5255
93,Pordenone,51,575,1806,174,21,2,0,0,2578,409,1908,254,50,0,0,0,2621,5199
93,Pordenone,52,530,1713,193,24,2,0,0,2462,411,1815,256,76,0,0,0,2558,5020
93,Pordenone,53,557,1784,186,12,2,0,0,2541,368,1817,241,56,0,0,0,2482,5023
93,Pordenone,54,491,1901,187,18,0,0,0,2597,391,1907,237,80,1,0,0,2616,5213
93,Pordenone,55,438,1777,188,27,1,0,0,2431,298,1910,215,89,0,0,0,2512,4943
93,Pordenone,56,386,1676,180,28,1,0,0,2271,278,1768,194,102,0,0,0,2342,4613
93,Pordenone,57,390,1690,159,35,0,0,0,2274,209,1733,210,85,0,0,0,2237,4511
93,Pordenone,58,316,1612,161,16,1,0,0,2106,209,1650,205,112,0,0,0,2176,4282
93,Pordenone,59,314,1597,156,31,0,0,0,2098,181,1690,198,128,0,0,0,2197,4295
93,Pordenone,60,263,1470,141,33,1,0,0,1908,190,1591,171,136,0,0,0,2088,3996
93,Pordenone,61,271,1513,123,34,1,0,0,1942,175,1580,176,137,1,0,0,2069,4011
93,Pordenone,62,233,1515,123,35,1,0,0,1907,157,1476,155,200,0,0,0,1988,3895
93,Pordenone,63,222,1446,114,39,0,0,0,1821,139,1471,117,184,0,0,0,1911,3732
93,Pordenone,64,209,1419,112,34,1,0,0,1775,151,1484,141,220,0,0,0,1996,3771
93,Pordenone,65,200,1476,103,51,0,0,0,1830,133,1432,124,206,0,0,0,1895,3725
93,Pordenone,66,199,1415,82,62,0,0,0,1758,131,1519,119,256,0,0,0,2025,3783
93,Pordenone,67,197,1419,76,66,0,0,0,1758,132,1395,110,286,0,0,0,1923,3681
93,Pordenone,68,190,1505,89,78,0,0,0,1862,115,1396,109,343,1,0,0,1964,3826
93,Pordenone,69,174,1464,79,66,0,0,0,1783,107,1332,78,341,0,0,0,1858,3641
93,Pordenone,70,161,1572,82,102,0,0,0,1917,110,1417,98,375,0,0,0,2000,3917
93,Pordenone,71,152,1477,54,99,0,0,0,1782,103,1372,64,441,0,0,0,1980,3762
93,Pordenone,72,166,1568,58,114,0,0,0,1906,122,1402,67,489,0,0,0,2080,3986
93,Pordenone,73,118,1090,43,95,0,0,0,1346,71,869,47,393,0,0,0,1380,2726
93,Pordenone,74,145,1232,36,117,0,0,0,1530,82,1019,51,534,0,0,0,1686,3216
93,Pordenone,75,135,1168,39,135,2,0,0,1479,84,973,51,559,0,0,0,1667,3146
93,Pordenone,76,124,1118,45,116,0,0,0,1403,101,962,49,578,0,0,0,1690,3093
93,Pordenone,77,115,1096,21,120,0,0,0,1352,78,811,42,673,0,0,0,1604,2956
93,Pordenone,78,108,1120,36,152,0,0,0,1416,90,840,39,761,0,0,0,1730,3146
93,Pordenone,79,88,1018,19,159,1,0,0,1285,99,723,29,797,0,0,0,1648,2933
93,Pordenone,80,94,948,21,136,0,0,0,1199,78,641,26,811,0,0,0,1556,2755
93,Pordenone,81,78,844,21,163,0,0,0,1106,73,507,27,801,0,0,0,1408,2514
93,Pordenone,82,44,686,12,145,0,0,0,887,80,415,22,753,0,0,0,1270,2157
93,Pordenone,83,56,627,13,160,0,0,0,856,44,359,23,740,0,0,0,1166,2022
93,Pordenone,84,53,487,7,123,0,0,0,670,73,286,18,752,0,0,0,1129,1799
93,Pordenone,85,43,443,5,145,0,0,0,636,63,240,12,723,0,0,1,1039,1675
93,Pordenone,86,43,422,3,131,0,0,0,599,45,176,11,759,0,0,0,991,1590
93,Pordenone,87,36,322,7,91,0,0,0,456,55,134,9,678,0,0,1,877,1333
93,Pordenone,88,32,301,5,107,0,0,0,445,63,108,9,684,0,0,0,864,1309
93,Pordenone,89,25,200,3,93,0,0,0,321,52,90,5,641,0,0,0,788,1109
93,Pordenone,90,18,181,4,89,0,0,0,292,41,50,5,599,0,0,0,695,987
93,Pordenone,91,11,120,3,87,0,0,0,221,31,35,9,516,0,0,0,591,812
93,Pordenone,92,12,94,1,59,0,0,0,166,35,32,2,461,0,0,0,530,696
93,Pordenone,93,9,70,0,74,0,0,0,153,31,18,1,397,0,0,0,447,600
93,Pordenone,94,9,61,0,50,0,0,0,120,26,7,1,345,0,0,0,379,499
93,Pordenone,95,1,28,0,38,0,0,0,67,22,7,3,230,0,0,0,262,329
93,Pordenone,96,2,21,0,29,0,0,0,52,14,1,0,188,0,0,0,203,255
93,Pordenone,97,4,17,0,20,0,0,0,41,14,3,2,157,0,0,0,176,217
93,Pordenone,98,1,5,0,14,0,0,0,20,9,2,0,108,0,0,0,119,139
93,Pordenone,99,1,1,0,7,0,0,0,9,5,0,0,46,0,0,0,51,60
93,Pordenone,100,1,0,0,5,0,0,0,6,7,0,0,68,0,0,0,75,81
94,Isernia,0,281,0,0,0,0,0,0,281,283,0,0,0,0,0,0,283,564
94,Isernia,1,310,0,0,0,0,0,0,310,274,0,0,0,0,0,0,274,584
94,Isernia,2,288,0,0,0,0,0,0,288,292,0,0,0,0,0,0,292,580
94,Isernia,3,338,0,0,0,0,0,0,338,283,0,0,0,0,0,0,283,621
94,Isernia,4,328,0,0,0,0,0,0,328,275,0,0,0,0,0,0,275,603
94,Isernia,5,321,0,0,0,0,0,0,321,301,0,0,0,0,0,0,301,622
94,Isernia,6,325,0,0,0,0,0,0,325,309,0,0,0,0,0,0,309,634
94,Isernia,7,316,0,0,0,0,0,0,316,301,0,0,0,0,0,0,301,617
94,Isernia,8,336,0,0,0,0,0,0,336,312,0,0,0,0,0,0,312,648
94,Isernia,9,328,0,0,0,0,0,0,328,299,0,0,0,0,0,0,299,627
94,Isernia,10,348,0,0,0,0,0,0,348,304,0,0,0,0,0,0,304,652
94,Isernia,11,331,0,0,0,0,0,0,331,328,0,0,0,0,0,0,328,659
94,Isernia,12,330,0,0,0,0,0,0,330,319,0,0,0,0,0,0,319,649
94,Isernia,13,342,0,0,0,0,0,0,342,349,0,0,0,0,0,0,349,691
94,Isernia,14,339,0,0,0,0,0,0,339,313,0,0,0,0,0,0,313,652
94,Isernia,15,344,0,0,0,0,0,0,344,290,0,0,0,0,0,0,290,634
94,Isernia,16,344,0,0,0,0,0,0,344,351,0,0,0,0,0,0,351,695
94,Isernia,17,354,0,0,0,0,0,0,354,338,0,0,0,0,0,0,338,692
94,Isernia,18,414,0,0,0,0,0,0,414,338,1,0,0,0,0,0,339,753
94,Isernia,19,399,1,0,0,0,0,0,400,335,1,0,0,0,0,0,336,736
94,Isernia,20,474,1,0,0,0,0,0,475,378,4,0,0,0,0,0,382,857
94,Isernia,21,448,2,0,0,0,0,0,450,366,4,0,0,0,0,0,370,820
94,Isernia,22,466,2,0,0,0,0,0,468,399,8,0,0,0,0,0,407,875
94,Isernia,23,429,3,0,0,0,0,0,432,395,18,0,0,0,0,0,413,845
94,Isernia,24,495,9,0,0,0,0,0,504,394,16,0,0,0,0,0,410,914
94,Isernia,25,479,13,0,0,0,0,0,492,409,29,0,0,0,0,0,438,930
94,Isernia,26,473,17,0,0,0,0,0,490,428,66,0,0,0,0,0,494,984
94,Isernia,27,519,23,0,0,0,0,0,542,381,68,1,0,0,0,0,450,992
94,Isernia,28,477,32,0,0,0,0,0,509,368,98,2,0,0,0,0,468,977
94,Isernia,29,463,49,0,0,0,0,0,512,349,118,1,1,0,0,0,469,981
94,Isernia,30,475,92,0,0,0,0,0,567,327,152,2,0,0,0,0,481,1048
94,Isernia,31,436,90,1,0,0,0,0,527,315,198,0,2,0,0,0,515,1042
94,Isernia,32,408,137,0,1,0,0,0,546,296,185,1,0,0,0,0,482,1028
94,Isernia,33,382,167,2,0,0,0,0,551,265,217,4,1,0,0,0,487,1038
94,Isernia,34,381,188,1,0,0,0,0,570,225,255,7,1,0,0,0,488,1058
94,Isernia,35,318,205,2,0,0,0,0,525,211,239,2,2,0,0,0,454,979
94,Isernia,36,318,208,3,0,0,0,0,529,199,287,4,1,0,0,0,491,1020
94,Isernia,37,308,263,3,2,1,0,0,577,206,313,10,0,0,0,0,529,1106
94,Isernia,38,272,259,4,0,0,0,0,535,156,351,9,0,0,0,0,516,1051
94,Isernia,39,260,277,3,0,0,0,0,540,147,349,15,1,0,0,0,512,1052
94,Isernia,40,227,301,12,0,0,0,0,540,142,359,14,2,0,0,0,517,1057
94,Isernia,41,229,322,11,1,0,0,0,563,141,355,13,4,0,0,0,513,1076
94,Isernia,42,231,378,11,1,0,0,0,621,134,393,16,4,0,0,0,547,1168
94,Isernia,43,210,377,11,1,1,0,0,600,117,400,12,6,0,0,0,535,1135
94,Isernia,44,213,415,7,0,0,0,0,635,110,462,19,12,0,0,0,603,1238
94,Isernia,45,193,393,13,2,0,0,0,601,109,465,19,11,0,0,0,604,1205
94,Isernia,46,158,418,13,1,0,0,0,590,107,450,20,5,0,0,0,582,1172
94,Isernia,47,177,418,13,2,0,0,0,610,97,521,24,8,0,0,0,650,1260
94,Isernia,48,155,396,22,1,0,0,0,574,81,475,25,16,0,0,0,597,1171
94,Isernia,49,131,414,22,4,0,0,0,571,77,535,21,10,0,0,0,643,1214
94,Isernia,50,153,459,22,4,0,0,0,638,80,543,31,18,0,0,0,672,1310
94,Isernia,51,159,465,24,4,0,0,0,652,89,533,29,20,0,0,0,671,1323
94,Isernia,52,143,503,21,3,0,0,0,670,96,505,27,29,0,0,0,657,1327
94,Isernia,53,129,481,29,4,0,0,0,643,79,532,29,38,0,0,0,678,1321
94,Isernia,54,111,552,26,3,1,0,0,693,76,548,24,37,0,0,0,685,1378
94,Isernia,55,119,510,18,15,0,0,0,662,67,534,25,26,0,0,0,652,1314
94,Isernia,56,106,467,24,10,0,0,0,607,62,512,28,37,0,0,0,639,1246
94,Isernia,57,92,493,20,6,0,0,0,611,56,498,10,49,0,0,0,613,1224
94,Isernia,58,87,517,18,7,0,0,0,629,71,523,23,50,0,0,0,667,1296
94,Isernia,59,83,536,18,6,0,0,0,643,56,496,19,61,0,0,0,632,1275
94,Isernia,60,79,485,13,11,1,0,0,589,53,470,13,52,0,0,0,588,1177
94,Isernia,61,76,509,22,11,0,0,0,618,59,460,12,74,0,0,0,605,1223
94,Isernia,62,61,545,16,10,0,0,0,632,39,465,19,67,0,0,0,590,1222
94,Isernia,63,64,489,13,17,1,0,0,584,49,459,18,71,0,0,0,597,1181
94,Isernia,64,63,520,11,19,0,0,0,613,45,453,15,88,0,0,0,601,1214
94,Isernia,65,42,475,20,22,0,0,0,559,41,450,15,85,0,0,0,591,1150
94,Isernia,66,40,478,10,18,0,0,0,546,49,411,14,86,0,0,0,560,1106
94,Isernia,67,28,442,10,17,0,0,0,497,38,375,10,101,0,0,0,524,1021
94,Isernia,68,39,466,15,17,0,0,0,537,35,400,10,110,0,0,0,555,1092
94,Isernia,69,46,483,17,27,0,0,0,573,37,399,11,128,0,0,0,575,1148
94,Isernia,70,48,445,10,41,0,0,0,544,40,365,8,134,0,0,0,547,1091
94,Isernia,71,39,454,11,35,0,0,0,539,44,375,11,136,0,0,0,566,1105
94,Isernia,72,30,419,6,34,0,0,0,489,28,308,9,131,0,0,0,476,965
94,Isernia,73,27,310,6,26,0,0,0,369,21,222,3,122,0,0,0,368,737
94,Isernia,74,19,284,6,18,0,0,0,327,27,225,8,130,0,0,0,390,717
94,Isernia,75,23,241,2,26,0,0,0,292,22,199,5,119,0,0,0,345,637
94,Isernia,76,20,270,5,45,0,0,0,340,21,171,10,131,0,0,0,333,673
94,Isernia,77,14,268,6,31,0,0,0,319,28,208,3,145,0,0,0,384,703
94,Isernia,78,18,280,3,43,0,0,0,344,27,195,6,207,0,0,0,435,779
94,Isernia,79,15,277,5,38,0,0,0,335,21,198,5,215,0,0,0,439,774
94,Isernia,80,12,256,4,36,0,0,0,308,20,184,2,192,0,0,0,398,706
94,Isernia,81,17,223,0,44,0,0,0,284,25,141,4,208,0,0,0,378,662
94,Isernia,82,11,225,2,54,0,0,0,292,19,155,2,242,0,0,0,418,710
94,Isernia,83,12,188,2,65,0,0,0,267,24,112,4,230,0,0,0,370,637
94,Isernia,84,16,175,1,59,0,0,0,251,25,116,4,243,0,0,0,388,639
94,Isernia,85,13,178,1,52,0,0,0,244,39,106,3,246,0,0,0,394,638
94,Isernia,86,7,133,0,39,0,0,0,179,23,81,4,223,0,0,0,331,510
94,Isernia,87,4,135,0,44,0,0,0,183,14,61,3,238,0,0,0,316,499
94,Isernia,88,5,113,1,59,0,0,0,178,22,55,2,235,0,0,0,314,492
94,Isernia,89,1,92,0,41,0,0,0,134,18,38,4,199,0,0,0,259,393
94,Isernia,90,3,66,1,37,0,0,0,107,20,24,0,169,0,0,0,213,320
94,Isernia,91,3,47,0,38,0,0,0,88,12,20,1,153,0,0,0,186,274
94,Isernia,92,3,36,1,30,0,0,0,70,17,13,1,137,0,0,0,168,238
94,Isernia,93,0,23,0,18,0,0,0,41,10,13,1,118,0,0,0,142,183
94,Isernia,94,2,15,0,23,0,0,0,40,7,9,0,101,0,0,0,117,157
94,Isernia,95,2,16,0,19,0,0,0,37,8,6,0,75,0,0,0,89,126
94,Isernia,96,2,8,0,15,0,0,0,25,6,5,1,58,0,0,0,70,95
94,Isernia,97,0,8,0,11,0,0,0,19,5,1,0,42,0,0,0,48,67
94,Isernia,98,0,4,0,9,0,0,0,13,0,1,0,26,0,0,0,27,40
94,Isernia,99,0,2,0,3,0,0,0,5,1,1,0,13,0,0,0,15,20
94,Isernia,100,0,3,0,5,0,0,0,8,1,0,1,28,0,0,0,30,38
95,Oristano,0,406,0,0,0,0,0,0,406,405,0,0,0,0,0,0,405,811
95,Oristano,1,493,0,0,0,0,0,0,493,435,0,0,0,0,0,0,435,928
95,Oristano,2,492,0,0,0,0,0,0,492,410,0,0,0,0,0,0,410,902
95,Oristano,3,462,0,0,0,0,0,0,462,462,0,0,0,0,0,0,462,924
95,Oristano,4,510,0,0,0,0,0,0,510,451,0,0,0,0,0,0,451,961
95,Oristano,5,504,0,0,0,0,0,0,504,530,0,0,0,0,0,0,530,1034
95,Oristano,6,508,0,0,0,0,0,0,508,470,0,0,0,0,0,0,470,978
95,Oristano,7,584,0,0,0,0,0,0,584,530,0,0,0,0,0,0,530,1114
95,Oristano,8,578,0,0,0,0,0,0,578,588,0,0,0,0,0,0,588,1166
95,Oristano,9,605,0,0,0,0,0,0,605,524,0,0,0,0,0,0,524,1129
95,Oristano,10,614,0,0,0,0,0,0,614,542,0,0,0,0,0,0,542,1156
95,Oristano,11,589,0,0,0,0,0,0,589,594,0,0,0,0,0,0,594,1183
95,Oristano,12,645,0,0,0,0,0,0,645,531,0,0,0,0,0,0,531,1176
95,Oristano,13,638,0,0,0,0,0,0,638,594,0,0,0,0,0,0,594,1232
95,Oristano,14,613,0,0,0,0,0,0,613,609,0,0,0,0,0,0,609,1222
95,Oristano,15,678,0,0,0,0,0,0,678,595,0,0,0,0,0,0,595,1273
95,Oristano,16,631,0,0,0,0,0,0,631,624,0,0,0,0,0,0,624,1255
95,Oristano,17,665,0,0,0,0,0,0,665,649,0,0,0,0,0,0,649,1314
95,Oristano,18,719,0,0,0,0,0,0,719,640,0,0,0,0,0,0,640,1359
95,Oristano,19,766,0,1,0,0,0,0,767,664,1,0,0,0,0,0,665,1432
95,Oristano,20,743,0,0,0,0,0,0,743,627,1,0,0,0,0,0,628,1371
95,Oristano,21,777,0,0,0,0,0,0,777,635,7,0,0,0,0,0,642,1419
95,Oristano,22,740,0,0,0,0,0,0,740,646,3,0,0,0,0,0,649,1389
95,Oristano,23,777,4,0,0,0,0,0,781,663,12,0,0,0,0,0,675,1456
95,Oristano,24,746,2,0,0,0,0,0,748,655,20,0,0,0,0,0,675,1423
95,Oristano,25,792,12,0,0,0,0,0,804,652,37,0,1,0,0,0,690,1494
95,Oristano,26,799,11,1,0,0,0,0,811,721,38,0,0,0,0,0,759,1570
95,Oristano,27,875,21,1,0,0,0,0,897,659,85,1,0,0,0,0,745,1642
95,Oristano,28,798,45,0,0,0,0,0,843,697,96,3,0,1,0,0,797,1640
95,Oristano,29,810,50,0,0,0,0,0,860,643,136,2,0,0,0,0,781,1641
95,Oristano,30,765,69,1,0,0,0,0,835,603,173,2,1,0,0,0,779,1614
95,Oristano,31,798,119,0,0,0,0,0,917,607,218,2,0,0,0,0,827,1744
95,Oristano,32,698,118,1,0,0,0,0,817,569,236,5,0,1,0,0,811,1628
95,Oristano,33,713,162,2,0,0,0,0,877,521,291,4,2,0,0,0,818,1695
95,Oristano,34,725,201,8,1,0,0,0,935,535,349,12,0,0,0,0,896,1831
95,Oristano,35,724,230,2,0,0,0,0,956,515,364,10,0,0,0,0,889,1845
95,Oristano,36,739,276,5,1,0,0,0,1021,438,423,22,5,0,0,0,888,1909
95,Oristano,37,631,335,8,2,0,0,0,976,469,430,20,4,1,0,0,924,1900
95,Oristano,38,612,332,10,1,0,0,0,955,429,484,17,2,0,0,0,932,1887
95,Oristano,39,590,387,14,0,0,0,0,991,401,553,24,2,0,0,0,980,1971
95,Oristano,40,640,455,12,1,0,0,0,1108,386,612,20,5,0,0,0,1023,2131
95,Oristano,41,594,507,18,3,0,0,0,1122,381,635,27,8,0,0,0,1051,2173
95,Oristano,42,577,547,20,2,0,0,0,1146,358,652,25,8,0,0,0,1043,2189
95,Oristano,43,581,545,17,0,0,0,0,1143,359,739,47,10,0,0,0,1155,2298
95,Oristano,44,569,653,23,4,0,0,0,1249,344,745,52,7,0,0,0,1148,2397
95,Oristano,45,475,651,27,1,0,0,0,1154,314,762,47,14,0,0,0,1137,2291
95,Oristano,46,474,696,33,2,0,0,0,1205,316,799,39,18,0,0,0,1172,2377
95,Oristano,47,449,760,41,5,0,0,0,1255,310,887,51,19,0,0,0,1267,2522
95,Oristano,48,460,762,31,5,0,0,0,1258,255,823,54,19,0,0,0,1151,2409
95,Oristano,49,442,807,37,5,0,0,0,1291,258,903,42,28,0,1,0,1232,2523
95,Oristano,50,359,782,38,3,0,0,0,1182,262,898,56,19,0,0,0,1235,2417
95,Oristano,51,375,843,46,9,2,0,0,1275,239,939,62,38,0,0,0,1278,2553
95,Oristano,52,336,887,50,5,0,0,0,1278,241,1004,76,34,0,0,0,1355,2633
95,Oristano,53,328,911,45,13,0,0,0,1297,201,986,60,57,0,0,0,1304,2601
95,Oristano,54,311,934,57,10,0,0,0,1312,223,1062,60,46,0,0,0,1391,2703
95,Oristano,55,278,875,54,16,0,0,0,1223,190,1068,64,40,0,0,0,1362,2585
95,Oristano,56,258,965,52,13,1,0,0,1289,205,997,45,60,0,0,0,1307,2596
95,Oristano,57,256,928,56,13,0,0,0,1253,183,975,54,61,1,0,0,1274,2527
95,Oristano,58,219,897,46,14,0,0,0,1176,154,969,40,72,0,0,0,1235,2411
95,Oristano,59,243,919,45,15,0,0,0,1222,125,934,36,97,0,0,0,1192,2414
95,Oristano,60,216,853,38,23,0,0,0,1130,134,928,47,108,0,0,0,1217,2347
95,Oristano,61,198,918,45,24,0,0,0,1185,153,916,38,114,0,0,0,1221,2406
95,Oristano,62,193,890,34,17,0,0,0,1134,159,845,41,118,0,0,0,1163,2297
95,Oristano,63,162,914,35,25,0,0,0,1136,132,859,37,127,0,0,0,1155,2291
95,Oristano,64,163,904,39,22,0,0,0,1128,123,833,29,153,0,0,0,1138,2266
95,Oristano,65,161,902,28,26,0,0,0,1117,131,821,40,153,0,0,0,1145,2262
95,Oristano,66,151,836,28,31,0,0,0,1046,118,806,27,147,0,0,0,1098,2144
95,Oristano,67,147,859,29,44,0,0,0,1079,128,730,27,196,0,0,0,1081,2160
95,Oristano,68,162,871,35,56,0,0,0,1124,132,726,25,197,0,0,0,1080,2204
95,Oristano,69,138,835,28,32,0,0,0,1033,112,730,24,200,0,0,0,1066,2099
95,Oristano,70,121,796,22,49,0,0,0,988,129,689,23,206,0,0,0,1047,2035
95,Oristano,71,125,767,18,49,0,0,0,959,114,680,26,220,0,0,0,1040,1999
95,Oristano,72,102,739,24,48,0,0,0,913,118,585,18,219,0,0,0,940,1853
95,Oristano,73,119,669,19,55,0,0,0,862,113,488,13,256,0,0,0,870,1732
95,Oristano,74,120,692,16,62,0,0,0,890,123,561,8,324,0,0,0,1016,1906
95,Oristano,75,84,596,16,57,0,0,0,753,113,527,11,338,0,0,0,989,1742
95,Oristano,76,82,611,11,61,0,0,0,765,118,472,11,323,0,0,0,924,1689
95,Oristano,77,91,529,11,56,0,0,0,687,99,380,6,321,0,0,0,806,1493
95,Oristano,78,101,556,13,80,0,0,0,750,150,422,8,422,0,0,0,1002,1752
95,Oristano,79,101,559,16,97,0,0,0,773,124,359,8,390,0,0,0,881,1654
95,Oristano,80,61,458,9,78,0,0,0,606,109,316,8,392,0,0,0,825,1431
95,Oristano,81,58,415,6,65,0,0,0,544,114,243,4,379,0,0,0,740,1284
95,Oristano,82,70,359,4,76,0,0,0,509,134,224,11,410,0,0,0,779,1288
95,Oristano,83,59,308,2,64,0,0,0,433,104,183,8,396,0,0,0,691,1124
95,Oristano,84,50,317,7,92,0,0,0,466,104,160,7,395,0,0,0,666,1132
95,Oristano,85,46,301,0,89,0,0,0,436,88,124,5,469,0,0,0,686,1122
95,Oristano,86,38,257,4,74,0,0,0,373,98,91,0,378,0,0,0,567,940
95,Oristano,87,25,200,3,69,0,0,0,297,72,73,1,366,0,0,0,512,809
95,Oristano,88,42,137,1,72,0,0,0,252,96,53,6,330,0,0,0,485,737
95,Oristano,89,25,148,1,66,0,0,0,240,66,40,1,331,0,0,0,438,678
95,Oristano,90,26,107,0,54,0,0,0,187,74,30,3,283,0,0,0,390,577
95,Oristano,91,11,71,0,38,0,0,0,120,62,30,1,223,0,0,0,316,436
95,Oristano,92,15,65,1,50,0,0,0,131,54,20,2,195,0,0,0,271,402
95,Oristano,93,4,35,0,34,0,0,0,73,42,12,3,168,0,0,0,225,298
95,Oristano,94,6,29,0,28,0,0,0,63,31,9,1,132,0,0,0,173,236
95,Oristano,95,9,17,0,14,0,0,0,40,16,3,0,108,0,0,0,127,167
95,Oristano,96,3,11,0,19,0,0,0,33,21,5,0,62,0,0,0,88,121
95,Oristano,97,1,9,0,9,0,0,0,19,11,1,0,58,0,0,0,70,89
95,Oristano,98,2,0,0,7,0,0,0,9,7,4,0,35,0,0,0,46,55
95,Oristano,99,1,2,0,6,0,0,0,9,4,1,0,25,0,0,0,30,39
95,Oristano,100,1,7,0,8,0,0,0,16,4,0,0,23,0,0,0,27,43
96,Biella,0,471,0,0,0,0,0,0,471,488,0,0,0,0,0,0,488,959
96,Biella,1,502,0,0,0,0,0,0,502,489,0,0,0,0,0,0,489,991
96,Biella,2,571,0,0,0,0,0,0,571,542,0,0,0,0,0,0,542,1113
96,Biella,3,559,0,0,0,0,0,0,559,528,0,0,0,0,0,0,528,1087
96,Biella,4,602,0,0,0,0,0,0,602,572,0,0,0,0,0,0,572,1174
96,Biella,5,618,0,0,0,0,0,0,618,537,0,0,0,0,0,0,537,1155
96,Biella,6,685,0,0,0,0,0,0,685,612,0,0,0,0,0,0,612,1297
96,Biella,7,613,0,0,0,0,0,0,613,640,0,0,0,0,0,0,640,1253
96,Biella,8,678,0,0,0,0,0,0,678,653,0,0,0,0,0,0,653,1331
96,Biella,9,673,0,0,0,0,0,0,673,713,0,0,0,0,0,0,713,1386
96,Biella,10,719,0,0,0,0,0,0,719,684,0,0,0,0,0,0,684,1403
96,Biella,11,759,0,0,0,0,0,0,759,705,0,0,0,0,0,0,705,1464
96,Biella,12,763,0,0,0,0,0,0,763,693,0,0,0,0,0,0,693,1456
96,Biella,13,756,0,0,0,0,0,0,756,680,0,0,0,0,0,0,680,1436
96,Biella,14,745,0,0,0,0,0,0,745,676,0,0,0,0,0,0,676,1421
96,Biella,15,792,0,0,0,0,0,0,792,730,0,0,0,0,0,0,730,1522
96,Biella,16,767,0,0,0,0,0,0,767,714,0,0,0,0,0,0,714,1481
96,Biella,17,706,0,0,0,0,0,0,706,740,0,0,0,0,0,0,740,1446
96,Biella,18,822,0,2,0,0,0,0,824,744,0,0,0,0,0,0,744,1568
96,Biella,19,801,0,0,0,0,0,0,801,731,3,1,0,0,0,0,735,1536
96,Biella,20,825,1,0,0,0,0,0,826,709,4,0,0,0,0,0,713,1539
96,Biella,21,837,2,0,0,0,0,0,839,687,15,0,0,0,0,0,702,1541
96,Biella,22,790,6,0,0,1,0,0,797,716,12,0,0,0,0,0,728,1525
96,Biella,23,783,5,1,0,0,0,0,789,717,28,0,0,1,0,0,746,1535
96,Biella,24,753,7,0,0,0,0,0,760,720,45,1,0,0,0,0,766,1526
96,Biella,25,763,22,1,0,0,0,0,786,692,69,0,0,0,0,0,761,1547
96,Biella,26,782,34,1,0,0,0,0,817,672,88,2,0,0,0,0,762,1579
96,Biella,27,825,58,1,0,0,0,0,884,641,117,3,0,0,0,0,761,1645
96,Biella,28,743,67,1,0,1,0,0,812,598,135,3,0,0,0,0,736,1548
96,Biella,29,672,90,3,0,0,0,0,765,549,164,5,1,0,0,0,719,1484
96,Biella,30,727,129,2,0,0,0,0,858,520,235,5,0,0,0,0,760,1618
96,Biella,31,581,143,1,0,0,0,0,725,422,249,7,1,2,0,0,681,1406
96,Biella,32,581,208,7,0,1,0,0,797,405,298,25,1,1,0,0,730,1527
96,Biella,33,588,202,6,0,1,0,0,797,396,342,21,2,1,0,0,762,1559
96,Biella,34,571,252,8,0,0,0,0,831,389,368,17,1,1,0,0,776,1607
96,Biella,35,517,269,12,1,0,0,0,799,362,370,18,4,0,0,0,754,1553
96,Biella,36,519,322,16,0,1,0,0,858,421,463,22,1,0,0,0,907,1765
96,Biella,37,465,331,21,1,0,0,0,818,368,496,26,2,1,0,0,893,1711
96,Biella,38,502,382,19,2,1,0,0,906,408,531,49,4,0,0,0,992,1898
96,Biella,39,485,395,30,1,0,0,0,911,361,526,43,6,0,0,0,936,1847
96,Biella,40,561,524,25,0,0,0,0,1110,391,637,62,5,0,0,0,1095,2205
96,Biella,41,513,560,31,3,1,0,0,1108,358,670,58,8,3,0,0,1097,2205
96,Biella,42,539,581,30,1,1,0,0,1152,364,740,74,20,0,0,0,1198,2350
96,Biella,43,515,628,44,0,1,0,0,1188,385,797,78,12,3,0,0,1275,2463
96,Biella,44,547,702,53,5,1,0,0,1308,362,874,92,16,0,0,0,1344,2652
96,Biella,45,554,722,54,4,2,0,0,1336,318,866,87,15,0,0,0,1286,2622
96,Biella,46,485,789,72,5,2,0,0,1353,328,895,126,23,1,0,0,1373,2726
96,Biella,47,489,811,77,6,2,0,0,1385,296,985,123,21,0,0,0,1425,2810
96,Biella,48,475,853,94,2,1,0,0,1425,282,1001,140,29,0,0,0,1452,2877
96,Biella,49,436,900,87,9,1,0,0,1433,258,986,144,27,1,0,0,1416,2849
96,Biella,50,432,901,107,9,3,0,0,1452,276,1064,157,31,0,0,0,1528,2980
96,Biella,51,393,933,107,10,0,0,0,1443,271,1027,164,54,1,0,0,1517,2960
96,Biella,52,363,1021,114,13,5,0,0,1516,232,1033,136,31,0,0,0,1432,2948
96,Biella,53,347,1006,123,18,1,0,0,1495,208,1128,185,45,0,0,0,1566,3061
96,Biella,54,334,1029,145,10,2,0,0,1520,218,1148,158,56,1,0,0,1581,3101
96,Biella,55,296,1011,103,8,0,0,0,1418,166,1042,148,44,0,0,0,1400,2818
96,Biella,56,269,912,132,21,1,0,0,1335,159,977,141,67,1,0,0,1345,2680
96,Biella,57,228,985,125,21,0,0,0,1359,152,1009,166,76,2,0,0,1405,2764
96,Biella,58,217,929,110,22,1,0,0,1279,134,984,148,90,0,0,0,1356,2635
96,Biella,59,191,886,117,27,1,0,0,1222,126,909,117,114,0,0,0,1266,2488
96,Biella,60,178,862,94,37,1,0,0,1172,110,903,122,97,0,0,0,1232,2404
96,Biella,61,163,917,111,24,0,0,0,1215,110,930,112,126,0,0,0,1278,2493
96,Biella,62,160,927,93,30,1,0,0,1211,121,900,112,114,1,0,0,1248,2459
96,Biella,63,135,916,85,26,1,0,0,1163,114,932,125,132,0,0,0,1303,2466
96,Biella,64,135,910,73,33,0,0,0,1151,89,952,115,144,1,0,0,1301,2452
96,Biella,65,121,908,81,37,1,0,0,1148,92,882,80,169,0,0,0,1223,2371
96,Biella,66,131,919,80,45,0,0,0,1175,98,894,86,182,0,0,0,1260,2435
96,Biella,67,102,915,57,53,0,0,0,1127,70,898,97,198,1,0,0,1264,2391
96,Biella,68,94,891,68,66,0,0,0,1119,86,982,66,236,0,0,0,1370,2489
96,Biella,69,118,977,68,61,0,0,0,1224,77,875,72,228,0,0,0,1252,2476
96,Biella,70,119,997,58,71,0,0,0,1245,92,910,66,292,1,0,0,1361,2606
96,Biella,71,97,933,59,62,0,0,0,1151,63,838,67,300,0,0,0,1268,2419
96,Biella,72,85,890,43,94,1,0,0,1113,67,815,67,336,0,0,0,1285,2398
96,Biella,73,68,677,35,84,0,0,0,864,61,577,55,280,0,0,0,973,1837
96,Biella,74,86,743,39,77,0,0,0,945,68,623,28,325,0,0,0,1044,1989
96,Biella,75,73,699,31,85,0,0,0,888,53,580,40,354,0,0,0,1027,1915
96,Biella,76,72,704,25,88,0,0,0,889,51,592,45,424,0,0,0,1112,2001
96,Biella,77,79,683,26,101,1,0,0,890,80,576,45,429,0,0,0,1130,2020
96,Biella,78,68,754,22,121,1,0,0,966,66,611,47,511,0,0,0,1235,2201
96,Biella,79,60,685,22,123,1,0,0,891,70,540,42,529,0,0,0,1181,2072
96,Biella,80,63,619,19,123,0,0,0,824,74,487,26,580,0,0,0,1167,1991
96,Biella,81,45,544,23,116,0,0,0,728,75,384,24,527,0,0,0,1010,1738
96,Biella,82,46,493,12,123,0,0,0,674,52,300,25,555,0,0,0,932,1606
96,Biella,83,39,454,13,111,0,0,0,617,58,290,19,589,0,0,0,956,1573
96,Biella,84,20,379,11,115,0,0,0,525,72,222,19,583,0,0,0,896,1421
96,Biella,85,26,290,4,100,0,0,0,420,59,181,13,580,0,0,0,833,1253
96,Biella,86,28,280,4,111,0,0,0,423,55,145,13,574,0,0,0,787,1210
96,Biella,87,21,243,7,104,0,0,0,375,62,128,10,527,0,0,0,727,1102
96,Biella,88,14,236,2,81,0,0,0,333,53,113,6,522,0,0,0,694,1027
96,Biella,89,11,167,1,82,0,0,0,261,45,59,6,525,0,0,0,635,896
96,Biella,90,8,113,0,86,0,0,0,207,39,35,9,427,0,0,0,510,717
96,Biella,91,9,84,1,66,0,0,0,160,39,40,6,393,0,0,0,478,638
96,Biella,92,10,60,3,55,0,0,0,128,38,25,7,338,0,0,0,408,536
96,Biella,93,5,46,0,37,0,0,0,88,25,13,1,254,0,0,0,293,381
96,Biella,94,6,30,0,25,0,0,0,61,33,9,3,182,0,0,0,227,288
96,Biella,95,2,11,0,24,0,0,0,37,25,10,2,154,0,0,0,191,228
96,Biella,96,2,11,0,15,0,0,0,28,9,3,2,113,0,0,0,127,155
96,Biella,97,0,7,0,15,0,0,0,22,8,3,3,89,0,0,0,103,125
96,Biella,98,0,3,0,9,0,0,0,12,4,0,0,68,0,0,0,72,84
96,Biella,99,1,1,0,0,0,0,0,2,3,0,0,31,0,0,0,34,36
96,Biella,100,0,2,0,7,0,0,0,9,7,1,1,35,0,0,0,44,53
97,Lecco,0,1238,0,0,0,0,0,0,1238,1144,0,0,0,0,0,0,1144,2382
97,Lecco,1,1410,0,0,0,0,0,0,1410,1246,0,0,0,0,0,0,1246,2656
97,Lecco,2,1267,0,0,0,0,0,0,1267,1327,0,0,0,0,0,0,1327,2594
97,Lecco,3,1470,0,0,0,0,0,0,1470,1396,0,0,0,0,0,0,1396,2866
97,Lecco,4,1428,0,0,0,0,0,0,1428,1367,0,0,0,0,0,0,1367,2795
97,Lecco,5,1452,0,0,0,0,0,0,1452,1447,0,0,0,0,0,0,1447,2899
97,Lecco,6,1572,0,0,0,0,0,0,1572,1522,0,0,0,0,0,0,1522,3094
97,Lecco,7,1613,0,0,0,0,0,0,1613,1531,0,0,0,0,0,0,1531,3144
97,Lecco,8,1720,0,0,0,0,0,0,1720,1576,0,0,0,0,0,0,1576,3296
97,Lecco,9,1752,0,0,0,0,0,0,1752,1580,0,0,0,0,0,0,1580,3332
97,Lecco,10,1715,0,0,0,0,0,0,1715,1649,0,0,0,0,0,0,1649,3364
97,Lecco,11,1687,0,0,0,0,0,0,1687,1627,0,0,0,0,0,0,1627,3314
97,Lecco,12,1616,0,0,0,0,0,0,1616,1615,0,0,0,0,0,0,1615,3231
97,Lecco,13,1711,0,0,0,0,0,0,1711,1613,0,0,0,0,0,0,1613,3324
97,Lecco,14,1614,0,0,0,0,0,0,1614,1570,0,0,0,0,0,0,1570,3184
97,Lecco,15,1588,0,0,0,0,0,0,1588,1590,0,0,0,0,0,0,1590,3178
97,Lecco,16,1642,0,0,0,0,0,0,1642,1676,0,0,0,0,0,0,1676,3318
97,Lecco,17,1655,0,0,0,0,0,0,1655,1599,0,0,0,0,0,0,1599,3254
97,Lecco,18,1716,0,0,0,0,0,0,1716,1614,4,0,0,0,0,0,1618,3334
97,Lecco,19,1747,0,0,0,0,0,0,1747,1559,7,0,0,0,0,0,1566,3313
97,Lecco,20,1800,1,0,0,0,0,0,1801,1481,21,0,0,0,0,0,1502,3303
97,Lecco,21,1744,2,0,0,0,0,0,1746,1576,36,0,0,0,0,0,1612,3358
97,Lecco,22,1814,10,0,0,0,0,0,1824,1519,65,1,0,0,0,0,1585,3409
97,Lecco,23,1704,15,0,0,0,0,0,1719,1463,91,1,0,0,0,0,1555,3274
97,Lecco,24,1698,25,0,0,1,0,0,1724,1420,127,4,0,1,0,0,1552,3276
97,Lecco,25,1632,43,1,0,0,0,0,1676,1497,152,1,0,0,0,0,1650,3326
97,Lecco,26,1673,81,1,0,0,0,0,1755,1407,211,1,0,0,0,0,1619,3374
97,Lecco,27,1654,104,2,0,0,0,0,1760,1310,274,2,0,0,0,0,1586,3346
97,Lecco,28,1600,144,0,0,0,0,0,1744,1205,400,5,1,1,0,0,1612,3356
97,Lecco,29,1598,222,3,0,0,0,0,1823,1140,483,8,1,0,0,0,1632,3455
97,Lecco,30,1460,314,2,0,1,0,0,1777,1055,610,6,0,0,0,0,1671,3448
97,Lecco,31,1327,416,6,0,1,0,0,1750,927,734,14,2,0,0,0,1677,3427
97,Lecco,32,1310,463,4,0,0,0,0,1777,747,813,16,2,1,0,0,1579,3356
97,Lecco,33,1142,558,12,1,1,0,0,1714,772,907,30,2,2,0,0,1713,3427
97,Lecco,34,1079,678,13,1,1,0,0,1772,706,980,29,6,2,0,0,1723,3495
97,Lecco,35,1043,745,16,0,2,0,0,1806,669,1110,49,1,1,0,0,1830,3636
97,Lecco,36,1044,922,27,1,1,0,0,1995,652,1152,49,2,1,0,0,1856,3851
97,Lecco,37,1043,976,28,1,0,0,0,2048,660,1208,42,8,1,0,0,1919,3967
97,Lecco,38,939,990,32,2,0,0,0,1963,591,1268,68,9,0,0,0,1936,3899
97,Lecco,39,964,1070,40,2,1,0,0,2077,645,1315,68,9,1,0,0,2038,4115
97,Lecco,40,943,1209,52,2,1,0,0,2207,593,1530,77,9,0,0,0,2209,4416
97,Lecco,41,921,1376,58,1,2,0,0,2358,575,1620,102,7,1,0,0,2305,4663
97,Lecco,42,963,1464,63,1,1,0,0,2492,583,1642,113,16,0,0,0,2354,4846
97,Lecco,43,960,1606,65,4,3,0,0,2638,547,1761,149,23,1,0,0,2481,5119
97,Lecco,44,986,1667,89,10,1,0,0,2753,590,1854,146,17,1,0,0,2608,5361
97,Lecco,45,841,1766,112,2,2,0,0,2723,552,1880,156,32,0,0,0,2620,5343
97,Lecco,46,837,1690,119,11,2,0,0,2659,498,1982,158,22,1,0,0,2661,5320
97,Lecco,47,841,1722,113,9,3,0,0,2688,515,1907,160,38,0,0,0,2620,5308
97,Lecco,48,730,1884,126,10,1,0,0,2751,475,1951,169,39,2,0,0,2636,5387
97,Lecco,49,750,1930,148,10,0,0,0,2838,440,2011,176,29,0,0,0,2656,5494
97,Lecco,50,712,1928,164,10,3,0,0,2817,451,2064,185,38,1,0,0,2739,5556
97,Lecco,51,677,1949,150,14,5,0,0,2795,404,2127,218,58,0,0,0,2807,5602
97,Lecco,52,649,2148,168,15,1,0,0,2981,406,2219,188,62,1,0,0,2876,5857
97,Lecco,53,589,2052,171,16,1,0,1,2830,422,2179,194,80,1,0,0,2876,5706
97,Lecco,54,567,2116,184,27,0,0,0,2894,332,2072,197,69,1,0,0,2671,5565
97,Lecco,55,471,1983,149,22,3,0,0,2628,334,1972,209,91,0,0,0,2606,5234
97,Lecco,56,405,1930,167,40,3,0,0,2545,305,1889,169,105,0,0,0,2468,5013
97,Lecco,57,372,1866,145,25,3,0,0,2411,291,1912,156,123,0,0,0,2482,4893
97,Lecco,58,352,1859,124,34,4,0,1,2374,315,1857,144,121,0,0,0,2437,4811
97,Lecco,59,331,1828,142,33,0,0,0,2334,276,1842,138,126,0,0,0,2382,4716
97,Lecco,60,322,1740,128,37,3,0,0,2230,216,1746,153,143,0,0,0,2258,4488
97,Lecco,61,276,1712,102,27,0,0,0,2117,238,1720,110,150,1,0,0,2219,4336
97,Lecco,62,261,1812,118,47,3,0,0,2241,214,1697,103,187,1,0,0,2202,4443
97,Lecco,63,270,1717,96,43,2,0,0,2128,197,1659,90,213,0,0,0,2159,4287
97,Lecco,64,234,1662,76,55,1,0,0,2028,221,1575,100,209,0,1,0,2106,4134
97,Lecco,65,224,1632,74,52,1,0,0,1983,176,1546,103,250,0,0,0,2075,4058
97,Lecco,66,204,1642,65,62,2,0,0,1975,159,1510,76,252,0,0,0,1997,3972
97,Lecco,67,204,1607,69,64,0,0,2,1946,199,1578,81,314,0,0,0,2172,4118
97,Lecco,68,215,1629,63,82,0,0,0,1989,180,1578,77,348,0,0,0,2183,4172
97,Lecco,69,220,1673,65,92,1,0,0,2051,182,1553,74,374,0,0,0,2183,4234
97,Lecco,70,179,1653,57,107,0,0,0,1996,177,1505,69,426,0,0,0,2177,4173
97,Lecco,71,173,1611,62,106,1,0,0,1953,160,1404,57,492,0,0,0,2113,4066
97,Lecco,72,151,1635,45,121,0,0,0,1952,157,1334,52,531,0,0,0,2074,4026
97,Lecco,73,123,1234,36,102,0,0,0,1495,111,1031,41,428,0,0,0,1611,3106
97,Lecco,74,122,1268,28,124,0,0,0,1542,110,1027,37,529,0,0,0,1703,3245
97,Lecco,75,101,1180,27,99,0,0,0,1407,106,1002,40,514,0,0,0,1662,3069
97,Lecco,76,116,1159,26,117,0,0,0,1418,129,951,32,592,0,0,0,1704,3122
97,Lecco,77,137,1179,18,157,0,0,0,1491,129,914,24,662,0,0,0,1729,3220
97,Lecco,78,134,1231,22,160,0,0,0,1547,148,909,27,715,0,0,0,1799,3346
97,Lecco,79,124,1139,17,162,0,0,0,1442,155,798,20,819,0,0,0,1792,3234
97,Lecco,80,93,1081,14,156,0,0,0,1344,156,722,24,860,0,0,0,1762,3106
97,Lecco,81,76,896,11,171,0,0,0,1154,142,576,10,786,0,0,0,1514,2668
97,Lecco,82,78,700,5,169,0,0,0,952,122,444,14,807,0,1,0,1388,2340
97,Lecco,83,77,637,6,151,0,0,0,871,118,379,11,845,0,0,0,1353,2224
97,Lecco,84,51,605,8,145,0,0,0,809,131,294,6,797,0,0,0,1228,2037
97,Lecco,85,47,515,7,134,0,0,0,703,131,256,9,801,0,0,0,1197,1900
97,Lecco,86,41,432,6,140,0,0,0,619,102,219,9,828,0,0,0,1158,1777
97,Lecco,87,44,374,7,124,0,0,0,549,101,152,10,703,0,0,0,966,1515
97,Lecco,88,34,288,4,126,0,0,0,452,104,121,8,686,0,0,0,919,1371
97,Lecco,89,24,222,2,107,0,0,0,355,92,71,7,642,0,0,0,812,1167
97,Lecco,90,24,150,1,100,0,0,0,275,74,56,1,556,0,0,0,687,962
97,Lecco,91,18,122,0,88,0,0,0,228,67,40,6,520,0,0,0,633,861
97,Lecco,92,14,94,1,67,0,0,0,176,64,24,3,370,0,0,0,461,637
97,Lecco,93,12,60,0,51,0,0,0,123,37,16,0,314,0,0,0,367,490
97,Lecco,94,7,42,0,42,0,0,0,91,39,6,2,258,0,0,0,305,396
97,Lecco,95,5,22,0,36,0,0,0,63,26,8,1,239,0,0,0,274,337
97,Lecco,96,1,10,0,27,0,0,0,38,28,2,0,117,0,0,0,147,185
97,Lecco,97,4,9,0,12,0,0,0,25,18,3,0,107,0,0,0,128,153
97,Lecco,98,1,4,0,11,0,0,0,16,11,0,0,95,0,0,0,106,122
97,Lecco,99,0,2,0,6,0,0,0,8,0,0,0,33,0,0,0,33,41
97,Lecco,100,0,0,0,5,0,0,0,5,8,0,1,48,0,0,0,57,62
98,Lodi,0,944,0,0,0,0,0,0,944,871,0,0,0,0,0,0,871,1815
98,Lodi,1,998,0,0,0,0,0,0,998,917,0,0,0,0,0,0,917,1915
98,Lodi,2,993,0,0,0,0,0,0,993,1006,0,0,0,0,0,0,1006,1999
98,Lodi,3,991,0,0,0,0,0,0,991,1002,0,0,0,0,0,0,1002,1993
98,Lodi,4,1077,0,0,0,0,0,0,1077,1029,0,0,0,0,0,0,1029,2106
98,Lodi,5,1047,0,0,0,0,0,0,1047,992,0,0,0,0,0,0,992,2039
98,Lodi,6,1105,0,0,0,0,0,0,1105,1034,0,0,0,0,0,0,1034,2139
98,Lodi,7,1155,0,0,0,0,0,0,1155,1037,0,0,0,0,0,0,1037,2192
98,Lodi,8,1141,0,0,0,0,0,0,1141,1095,0,0,0,0,0,0,1095,2236
98,Lodi,9,1273,0,0,0,0,0,0,1273,1141,0,0,0,0,0,0,1141,2414
98,Lodi,10,1179,0,0,0,0,0,0,1179,1079,0,0,0,0,0,0,1079,2258
98,Lodi,11,1189,0,0,0,0,0,0,1189,1072,0,0,0,0,0,0,1072,2261
98,Lodi,12,1158,0,0,0,0,0,0,1158,1088,0,0,0,0,0,0,1088,2246
98,Lodi,13,1165,0,0,0,0,0,0,1165,1088,0,0,0,0,0,0,1088,2253
98,Lodi,14,1126,0,0,0,0,0,0,1126,1126,0,0,0,0,0,0,1126,2252
98,Lodi,15,1100,0,0,0,0,0,0,1100,1066,0,0,0,0,0,0,1066,2166
98,Lodi,16,1007,0,0,0,0,0,0,1007,1048,0,0,0,0,0,0,1048,2055
98,Lodi,17,1122,0,0,0,0,0,0,1122,1020,0,0,0,0,0,0,1020,2142
98,Lodi,18,1095,0,0,0,0,0,0,1095,1041,6,0,0,0,0,0,1047,2142
98,Lodi,19,1131,0,0,0,0,0,0,1131,1030,2,0,0,0,0,0,1032,2163
98,Lodi,20,1158,1,0,0,1,0,0,1160,977,21,1,0,0,0,0,999,2159
98,Lodi,21,1152,4,0,0,0,0,0,1156,991,31,1,0,0,0,0,1023,2179
98,Lodi,22,1153,9,0,0,0,0,0,1162,999,59,0,0,0,0,0,1058,2220
98,Lodi,23,1097,19,0,0,0,0,0,1116,978,74,0,0,0,0,0,1052,2168
98,Lodi,24,1081,23,0,0,0,0,0,1104,977,128,1,0,0,0,0,1106,2210
98,Lodi,25,1086,42,0,0,0,0,0,1128,904,138,0,0,0,0,0,1042,2170
98,Lodi,26,1162,65,0,0,2,0,0,1229,946,188,1,0,2,0,0,1137,2366
98,Lodi,27,1072,94,0,0,0,0,0,1166,906,273,2,0,1,0,0,1182,2348
98,Lodi,28,1042,127,2,0,0,0,0,1171,897,295,2,1,1,0,0,1196,2367
98,Lodi,29,1072,200,7,0,0,0,0,1279,794,393,3,2,0,0,0,1192,2471
98,Lodi,30,1018,252,7,0,1,0,0,1278,703,511,8,2,1,0,0,1225,2503
98,Lodi,31,940,308,2,0,1,0,0,1251,698,587,12,2,1,0,0,1300,2551
98,Lodi,32,925,387,4,0,2,0,0,1318,602,680,17,1,2,0,0,1302,2620
98,Lodi,33,840,484,9,0,1,0,0,1334,561,669,28,2,1,0,0,1261,2595
98,Lodi,34,849,494,7,0,2,0,0,1352,553,795,24,2,0,0,0,1374,2726
98,Lodi,35,811,603,24,0,0,0,0,1438,512,804,32,2,1,0,0,1351,2789
98,Lodi,36,754,707,22,1,1,0,0,1485,453,878,37,5,0,0,0,1373,2858
98,Lodi,37,713,720,23,0,0,0,0,1456,474,913,32,5,2,0,0,1426,2882
98,Lodi,38,673,838,28,4,1,0,0,1544,456,1019,54,5,1,0,0,1535,3079
98,Lodi,39,714,893,33,1,0,0,0,1641,436,1035,59,9,0,0,0,1539,3180
98,Lodi,40,660,924,39,1,0,0,0,1624,417,1138,64,4,1,0,0,1624,3248
98,Lodi,41,673,1035,36,3,0,0,0,1747,435,1147,76,10,0,0,0,1668,3415
98,Lodi,42,689,1049,53,4,0,0,0,1795,373,1244,70,13,1,0,0,1701,3496
98,Lodi,43,723,1139,51,2,2,0,0,1917,442,1346,79,14,0,0,0,1881,3798
98,Lodi,44,660,1253,75,1,2,0,0,1991,411,1391,101,25,1,0,0,1929,3920
98,Lodi,45,628,1243,59,3,1,0,0,1934,376,1334,110,11,1,0,0,1832,3766
98,Lodi,46,584,1339,81,3,0,0,0,2007,392,1370,105,19,0,0,0,1886,3893
98,Lodi,47,546,1324,82,6,1,0,0,1959,321,1395,131,20,0,0,0,1867,3826
98,Lodi,48,544,1389,90,10,1,0,0,2034,297,1333,131,33,0,0,0,1794,3828
98,Lodi,49,491,1359,97,12,1,0,0,1960,312,1478,150,37,0,0,0,1977,3937
98,Lodi,50,482,1432,114,8,1,0,0,2037,301,1445,143,40,0,0,0,1929,3966
98,Lodi,51,463,1456,104,11,0,0,0,2034,282,1521,151,41,0,0,0,1995,4029
98,Lodi,52,442,1466,110,10,0,0,0,2028,239,1460,143,61,0,0,0,1903,3931
98,Lodi,53,378,1531,130,23,1,0,0,2063,222,1467,155,58,2,0,0,1904,3967
98,Lodi,54,361,1414,129,18,2,0,0,1924,209,1415,119,61,0,0,0,1804,3728
98,Lodi,55,315,1393,105,17,4,0,0,1834,214,1317,130,73,0,0,0,1734,3568
98,Lodi,56,275,1316,103,21,4,0,0,1719,153,1358,117,66,0,0,0,1694,3413
98,Lodi,57,290,1212,101,26,1,0,0,1630,162,1254,99,90,0,0,0,1605,3235
98,Lodi,58,206,1241,103,25,2,0,0,1577,151,1238,120,106,2,0,0,1617,3194
98,Lodi,59,215,1265,85,19,0,0,0,1584,133,1226,92,109,0,0,0,1560,3144
98,Lodi,60,213,1155,73,40,0,0,0,1481,116,1117,106,125,1,0,0,1465,2946
98,Lodi,61,162,1150,92,31,1,0,0,1436,128,1110,96,156,0,0,0,1490,2926
98,Lodi,62,163,1147,66,27,0,0,0,1403,96,1160,82,147,0,0,0,1485,2888
98,Lodi,63,147,1077,78,34,0,0,0,1336,107,1103,83,133,0,0,0,1426,2762
98,Lodi,64,140,1068,70,35,0,0,0,1313,92,1076,78,191,0,0,0,1437,2750
98,Lodi,65,126,1041,58,31,0,0,0,1256,82,920,59,176,0,0,0,1237,2493
98,Lodi,66,128,1049,46,43,0,0,0,1266,85,981,65,211,1,0,1,1344,2610
98,Lodi,67,125,1001,49,43,1,0,0,1219,83,934,37,197,0,0,0,1251,2470
98,Lodi,68,148,1087,48,54,0,0,0,1337,81,961,46,258,1,0,1,1348,2685
98,Lodi,69,124,1092,35,59,0,0,0,1310,79,949,46,325,0,0,0,1399,2709
98,Lodi,70,112,1094,44,88,1,0,1,1340,74,954,52,305,0,0,0,1385,2725
98,Lodi,71,93,1019,35,68,0,0,0,1215,82,884,37,349,0,0,0,1352,2567
98,Lodi,72,100,1031,37,87,0,0,0,1255,62,855,40,361,0,0,0,1318,2573
98,Lodi,73,80,752,22,73,0,0,0,927,52,599,27,346,0,0,0,1024,1951
98,Lodi,74,78,762,23,79,0,0,0,942,63,592,23,384,0,0,0,1062,2004
98,Lodi,75,79,706,18,76,0,0,0,879,63,587,20,418,0,0,0,1088,1967
98,Lodi,76,83,689,20,81,1,0,0,874,55,571,23,428,0,0,0,1077,1951
98,Lodi,77,75,685,11,102,0,0,0,873,69,483,23,519,0,0,0,1094,1967
98,Lodi,78,69,698,12,103,0,0,0,882,56,527,20,550,0,0,0,1153,2035
98,Lodi,79,87,648,14,120,0,0,0,869,64,461,17,605,0,0,0,1147,2016
98,Lodi,80,72,560,15,126,0,0,0,773,55,391,21,621,0,0,0,1088,1861
98,Lodi,81,51,507,9,115,0,0,0,682,73,328,13,578,0,0,0,992,1674
98,Lodi,82,43,412,7,98,0,0,0,560,54,266,7,597,0,0,0,924,1484
98,Lodi,83,47,388,4,103,0,0,0,542,73,200,7,595,0,0,0,875,1417
98,Lodi,84,35,337,6,98,0,0,0,476,50,161,7,558,0,0,0,776,1252
98,Lodi,85,33,280,5,75,0,0,0,393,45,127,9,518,0,0,0,699,1092
98,Lodi,86,24,228,2,91,0,0,0,345,41,108,12,508,0,0,0,669,1014
98,Lodi,87,32,163,3,84,0,0,0,282,46,90,4,504,0,0,0,644,926
98,Lodi,88,21,163,5,79,0,0,0,268,50,50,6,462,0,0,0,568,836
98,Lodi,89,14,127,0,64,0,0,0,205,48,38,1,396,0,0,0,483,688
98,Lodi,90,4,92,0,68,0,0,0,164,37,49,0,327,0,0,0,413,577
98,Lodi,91,7,66,1,50,0,0,1,125,28,18,1,315,0,0,0,362,487
98,Lodi,92,3,50,0,34,0,0,0,87,25,12,1,227,0,0,0,265,352
98,Lodi,93,6,24,0,28,0,0,0,58,20,13,1,190,0,0,0,224,282
98,Lodi,94,2,20,1,20,0,0,0,43,16,9,1,155,0,0,0,181,224
98,Lodi,95,1,9,0,24,0,0,0,34,14,2,3,116,0,0,0,135,169
98,Lodi,96,0,8,0,12,0,0,0,20,7,1,2,97,0,0,0,107,127
98,Lodi,97,1,3,0,8,0,0,0,12,5,1,2,67,0,0,0,75,87
98,Lodi,98,1,2,0,11,0,0,0,14,7,0,0,54,0,0,0,61,75
98,Lodi,99,0,0,0,1,0,0,0,1,2,0,0,22,0,0,0,24,25
98,Lodi,100,0,1,0,3,0,0,0,4,5,0,0,16,0,0,0,21,25
99,Rimini,0,1256,0,0,0,0,0,0,1256,1097,0,0,0,0,0,0,1097,2353
99,Rimini,1,1278,0,0,0,0,0,0,1278,1198,0,0,0,0,0,0,1198,2476
99,Rimini,2,1302,0,0,0,0,0,0,1302,1310,0,0,0,0,0,0,1310,2612
99,Rimini,3,1405,0,0,0,0,0,0,1405,1389,0,0,0,0,0,0,1389,2794
99,Rimini,4,1526,0,0,0,0,0,0,1526,1389,0,0,0,0,0,0,1389,2915
99,Rimini,5,1585,0,0,0,0,0,0,1585,1395,0,0,0,0,0,0,1395,2980
99,Rimini,6,1596,0,0,0,0,0,0,1596,1451,0,0,0,0,0,0,1451,3047
99,Rimini,7,1537,0,0,0,0,0,0,1537,1511,0,0,0,0,0,0,1511,3048
99,Rimini,8,1668,0,0,0,0,0,0,1668,1632,0,0,0,0,0,0,1632,3300
99,Rimini,9,1637,0,0,0,0,0,0,1637,1620,0,0,0,0,0,0,1620,3257
99,Rimini,10,1691,0,0,0,0,0,0,1691,1635,0,0,0,0,0,0,1635,3326
99,Rimini,11,1712,0,0,0,0,0,0,1712,1599,0,0,0,0,0,0,1599,3311
99,Rimini,12,1677,0,0,0,0,0,0,1677,1515,0,0,0,0,0,0,1515,3192
99,Rimini,13,1648,0,0,0,0,0,0,1648,1559,0,0,0,0,0,0,1559,3207
99,Rimini,14,1552,0,0,0,0,0,0,1552,1545,0,0,0,0,0,0,1545,3097
99,Rimini,15,1563,0,0,0,0,0,0,1563,1503,0,0,0,0,0,0,1503,3066
99,Rimini,16,1594,0,0,0,0,0,0,1594,1494,0,0,0,0,0,0,1494,3088
99,Rimini,17,1583,0,0,0,0,0,0,1583,1560,0,0,0,0,0,0,1560,3143
99,Rimini,18,1674,0,0,0,0,0,0,1674,1519,2,0,0,0,0,0,1521,3195
99,Rimini,19,1697,0,0,0,0,0,0,1697,1515,15,0,0,0,0,0,1530,3227
99,Rimini,20,1585,2,0,0,0,0,0,1587,1433,13,0,0,0,0,0,1446,3033
99,Rimini,21,1574,3,0,0,0,0,0,1577,1487,29,0,0,0,0,0,1516,3093
99,Rimini,22,1630,9,0,0,0,0,0,1639,1414,63,2,0,0,0,0,1479,3118
99,Rimini,23,1628,14,0,0,0,0,0,1642,1340,70,1,0,0,0,0,1411,3053
99,Rimini,24,1596,21,1,0,0,0,0,1618,1392,129,2,0,0,1,0,1524,3142
99,Rimini,25,1606,61,1,0,0,0,0,1668,1360,159,2,0,0,0,0,1521,3189
99,Rimini,26,1600,73,1,0,0,0,0,1674,1356,232,3,0,0,0,0,1591,3265
99,Rimini,27,1559,113,2,0,0,0,0,1674,1354,268,2,0,0,0,0,1624,3298
99,Rimini,28,1505,164,2,0,0,0,0,1671,1313,382,9,1,0,0,0,1705,3376
99,Rimini,29,1517,214,5,0,1,0,0,1737,1173,512,12,0,0,1,0,1698,3435
99,Rimini,30,1410,319,6,1,0,0,0,1736,1117,620,24,1,0,0,0,1762,3498
99,Rimini,31,1281,373,8,0,4,0,0,1666,1038,663,21,0,2,0,0,1724,3390
99,Rimini,32,1217,448,17,0,1,0,0,1683,1009,780,31,2,1,1,0,1824,3507
99,Rimini,33,1227,561,14,0,2,0,0,1804,950,845,51,5,3,0,0,1854,3658
99,Rimini,34,1233,655,14,0,1,0,0,1903,982,964,39,4,0,0,0,1989,3892
99,Rimini,35,1179,735,30,0,0,0,0,1944,1022,1006,54,3,1,0,0,2086,4030
99,Rimini,36,1181,827,36,1,2,0,0,2047,947,1116,64,6,2,0,0,2135,4182
99,Rimini,37,1171,922,36,1,1,0,0,2131,921,1123,62,5,0,0,0,2111,4242
99,Rimini,38,1118,931,28,0,2,0,0,2079,847,1266,78,5,1,0,0,2197,4276
99,Rimini,39,1082,1089,66,2,1,0,1,2241,827,1353,82,9,0,0,0,2271,4512
99,Rimini,40,1109,1175,51,6,2,0,0,2343,887,1425,107,7,2,0,0,2428,4771
99,Rimini,41,1150,1294,76,2,2,0,0,2524,812,1593,133,12,0,0,0,2550,5074
99,Rimini,42,1069,1391,95,3,6,0,0,2564,879,1689,141,15,1,0,0,2725,5289
99,Rimini,43,1119,1485,90,4,2,0,0,2700,855,1789,155,30,1,0,0,2830,5530
99,Rimini,44,1130,1560,108,7,4,0,0,2809,893,1810,209,18,1,0,0,2931,5740
99,Rimini,45,1044,1654,123,8,3,0,0,2832,743,1922,201,27,0,0,0,2893,5725
99,Rimini,46,951,1700,131,4,8,1,0,2795,722,1893,191,33,2,0,0,2841,5636
99,Rimini,47,924,1783,136,6,6,0,0,2855,698,1954,225,29,0,0,0,2906,5761
99,Rimini,48,795,1787,169,5,3,0,0,2759,696,2019,257,52,1,0,0,3025,5784
99,Rimini,49,841,1832,155,13,1,0,0,2842,644,1974,246,34,2,0,0,2900,5742
99,Rimini,50,729,1916,180,16,4,0,0,2845,606,2030,268,50,0,0,0,2954,5799
99,Rimini,51,722,1878,188,18,1,1,0,2808,604,1924,242,48,0,0,0,2818,5626
99,Rimini,52,646,1948,202,20,5,0,0,2821,507,1956,277,75,1,0,0,2816,5637
99,Rimini,53,640,1892,194,27,5,0,0,2758,467,1928,257,79,0,0,0,2731,5489
99,Rimini,54,590,2036,183,18,5,0,0,2832,475,2187,310,74,1,0,0,3047,5879
99,Rimini,55,481,1807,215,28,4,0,0,2535,425,1948,292,86,0,0,0,2751,5286
99,Rimini,56,452,1818,232,26,0,0,0,2528,321,1948,284,85,0,0,0,2638,5166
99,Rimini,57,411,1726,191,28,2,0,0,2358,316,1906,253,100,1,0,0,2576,4934
99,Rimini,58,365,1734,171,26,3,0,0,2299,301,1854,234,118,0,0,0,2507,4806
99,Rimini,59,345,1718,158,23,1,0,0,2245,278,1801,243,136,0,0,0,2458,4703
99,Rimini,60,275,1649,138,38,3,0,0,2103,312,1712,233,165,0,0,0,2422,4525
99,Rimini,61,277,1649,168,38,2,0,0,2134,251,1678,211,169,0,0,0,2309,4443
99,Rimini,62,271,1582,149,45,1,0,0,2048,212,1630,176,181,0,0,0,2199,4247
99,Rimini,63,221,1535,128,31,0,0,0,1915,214,1554,173,211,0,0,0,2152,4067
99,Rimini,64,193,1494,133,33,1,0,0,1854,187,1595,143,201,0,0,0,2126,3980
99,Rimini,65,195,1394,111,47,0,0,0,1747,176,1496,162,213,0,0,0,2047,3794
99,Rimini,66,176,1422,76,60,0,0,0,1734,165,1502,131,228,0,0,0,2026,3760
99,Rimini,67,146,1465,104,67,0,0,0,1782,126,1529,139,261,1,0,0,2056,3838
99,Rimini,68,131,1537,101,69,4,0,0,1842,115,1481,126,337,0,0,0,2059,3901
99,Rimini,69,150,1537,76,79,1,1,0,1844,121,1461,120,364,0,0,0,2066,3910
99,Rimini,70,140,1586,74,118,0,0,0,1918,124,1499,94,433,0,0,0,2150,4068
99,Rimini,71,132,1563,81,69,0,0,0,1845,100,1427,98,461,0,0,0,2086,3931
99,Rimini,72,123,1535,69,94,0,0,0,1821,133,1397,105,468,0,0,0,2103,3924
99,Rimini,73,117,1167,52,80,0,0,0,1416,80,1069,80,419,0,0,0,1648,3064
99,Rimini,74,86,1182,54,90,0,0,0,1412,103,1061,67,440,0,0,0,1671,3083
99,Rimini,75,89,1218,47,141,0,0,0,1495,88,1020,49,533,0,0,0,1690,3185
99,Rimini,76,82,1080,39,112,0,0,0,1313,94,847,59,544,0,0,0,1544,2857
99,Rimini,77,89,1084,49,132,3,0,0,1357,56,851,54,621,0,0,0,1582,2939
99,Rimini,78,98,1089,30,159,0,0,0,1376,87,908,54,715,0,0,0,1764,3140
99,Rimini,79,94,1068,27,156,0,0,0,1345,79,805,55,697,0,0,0,1636,2981
99,Rimini,80,83,1066,30,179,0,0,0,1358,84,748,38,856,0,0,0,1726,3084
99,Rimini,81,77,903,19,170,0,0,0,1169,80,593,31,813,0,0,0,1517,2686
99,Rimini,82,51,765,18,138,0,0,0,972,65,448,38,784,0,0,0,1335,2307
99,Rimini,83,59,702,12,152,0,0,0,925,75,427,25,841,0,0,0,1368,2293
99,Rimini,84,45,649,12,170,0,0,0,876,83,369,29,855,0,0,0,1336,2212
99,Rimini,85,39,561,6,151,0,0,0,757,56,252,23,800,0,0,0,1131,1888
99,Rimini,86,46,439,9,136,0,0,0,630,42,214,13,741,0,0,0,1010,1640
99,Rimini,87,39,406,5,136,0,0,0,586,54,175,13,756,0,0,0,998,1584
99,Rimini,88,21,314,5,154,0,0,0,494,52,162,12,789,0,0,0,1015,1509
99,Rimini,89,21,288,3,121,0,0,0,433,52,90,10,627,0,0,0,779,1212
99,Rimini,90,24,203,1,113,0,0,0,341,50,48,7,591,0,0,0,696,1037
99,Rimini,91,13,163,1,93,0,0,0,270,38,54,7,511,0,0,0,610,880
99,Rimini,92,12,129,0,79,0,0,0,220,42,26,3,463,0,0,0,534,754
99,Rimini,93,5,76,0,77,0,0,0,158,33,21,5,333,0,0,0,392,550
99,Rimini,94,5,60,0,54,0,0,0,119,22,10,2,285,0,0,0,319,438
99,Rimini,95,7,33,0,58,0,0,0,98,22,9,2,251,0,0,0,284,382
99,Rimini,96,1,27,0,34,0,0,0,62,12,6,1,164,0,0,0,183,245
99,Rimini,97,1,18,0,25,0,0,0,44,15,2,1,151,0,0,0,169,213
99,Rimini,98,0,9,0,13,0,0,0,22,4,1,0,105,0,0,0,110,132
99,Rimini,99,0,6,0,5,0,0,0,11,3,1,1,39,0,0,0,44,55
99,Rimini,100,0,5,0,8,0,0,0,13,7,0,0,59,0,0,0,66,79
100,Prato,0,986,0,0,0,0,0,0,986,924,0,0,0,0,0,0,924,1910
100,Prato,1,1106,0,0,0,0,0,0,1106,1011,0,0,0,0,0,0,1011,2117
100,Prato,2,1123,0,0,0,0,0,0,1123,1063,0,0,0,0,0,0,1063,2186
100,Prato,3,1131,0,0,0,0,0,0,1131,1055,0,0,0,0,0,0,1055,2186
100,Prato,4,1219,0,0,0,0,0,0,1219,1079,0,0,0,0,0,0,1079,2298
100,Prato,5,1192,0,0,0,0,0,0,1192,1112,0,0,0,0,0,0,1112,2304
100,Prato,6,1257,0,0,0,0,0,0,1257,1201,0,0,0,0,0,0,1201,2458
100,Prato,7,1273,0,0,0,0,0,0,1273,1201,0,0,0,0,0,0,1201,2474
100,Prato,8,1392,0,0,0,0,0,0,1392,1210,0,0,0,0,0,0,1210,2602
100,Prato,9,1358,0,0,0,0,0,0,1358,1214,0,0,0,0,0,0,1214,2572
100,Prato,10,1390,0,0,0,0,0,0,1390,1282,0,0,0,0,0,0,1282,2672
100,Prato,11,1371,0,0,0,0,0,0,1371,1282,0,0,0,0,0,0,1282,2653
100,Prato,12,1390,0,0,0,0,0,0,1390,1321,0,0,0,0,0,0,1321,2711
100,Prato,13,1372,0,0,0,0,0,0,1372,1256,0,0,0,0,0,0,1256,2628
100,Prato,14,1265,0,0,0,0,0,0,1265,1239,0,0,0,0,0,0,1239,2504
100,Prato,15,1314,0,0,0,0,0,0,1314,1213,0,0,0,0,0,0,1213,2527
100,Prato,16,1299,0,0,0,0,0,0,1299,1184,0,0,0,0,0,0,1184,2483
100,Prato,17,1268,0,0,0,0,0,0,1268,1169,0,0,0,0,0,0,1169,2437
100,Prato,18,1274,0,0,0,0,0,0,1274,1226,1,0,0,0,0,0,1227,2501
100,Prato,19,1271,1,0,0,0,0,0,1272,1134,2,0,0,0,0,0,1136,2408
100,Prato,20,1294,1,0,0,0,0,0,1295,1154,13,0,0,0,0,0,1167,2462
100,Prato,21,1272,1,0,0,0,0,0,1273,1070,22,0,0,0,0,0,1092,2365
100,Prato,22,1228,5,1,0,0,0,0,1234,1041,54,0,0,0,0,0,1095,2329
100,Prato,23,1207,8,0,0,0,0,0,1215,1005,53,0,0,0,0,0,1058,2273
100,Prato,24,1160,14,0,0,0,0,0,1174,1032,69,0,0,0,0,0,1101,2275
100,Prato,25,1229,28,0,0,2,0,0,1259,1051,117,1,0,0,0,0,1169,2428
100,Prato,26,1250,34,1,0,0,0,0,1285,1104,180,2,0,0,0,0,1286,2571
100,Prato,27,1213,88,0,0,0,0,0,1301,1030,234,9,0,0,0,0,1273,2574
100,Prato,28,1296,145,0,0,1,0,0,1442,996,257,2,1,0,0,0,1256,2698
100,Prato,29,1223,181,2,0,1,0,0,1407,1018,379,8,0,1,0,0,1406,2813
100,Prato,30,1193,226,4,0,1,0,0,1424,951,439,17,1,1,0,0,1409,2833
100,Prato,31,1134,299,8,0,0,0,0,1441,881,557,11,0,0,0,0,1449,2890
100,Prato,32,1036,405,9,0,2,0,0,1452,866,656,14,0,2,0,0,1538,2990
100,Prato,33,974,469,15,0,0,0,0,1458,769,744,25,2,2,0,0,1542,3000
100,Prato,34,903,556,10,1,2,0,0,1472,717,854,15,2,1,0,0,1589,3061
100,Prato,35,914,582,16,0,4,0,0,1516,683,813,26,6,0,0,0,1528,3044
100,Prato,36,861,735,22,0,2,0,0,1620,700,933,36,2,0,0,0,1671,3291
100,Prato,37,842,831,24,1,0,0,0,1698,654,965,57,5,2,0,0,1683,3381
100,Prato,38,850,834,32,0,0,0,0,1716,644,1005,47,6,1,0,0,1703,3419
100,Prato,39,796,883,28,2,2,0,0,1711,561,1141,52,9,0,1,0,1764,3475
100,Prato,40,841,964,54,3,2,0,0,1864,654,1125,66,8,0,0,0,1853,3717
100,Prato,41,790,998,37,1,3,0,0,1829,578,1204,93,7,2,0,0,1884,3713
100,Prato,42,765,1109,69,3,3,0,0,1949,610,1369,102,11,2,0,0,2094,4043
100,Prato,43,852,1169,61,4,3,0,0,2089,589,1405,93,16,2,0,0,2105,4194
100,Prato,44,768,1254,71,4,5,0,0,2102,509,1449,119,17,1,0,0,2095,4197
100,Prato,45,764,1352,79,7,5,0,0,2207,554,1496,149,14,1,0,0,2214,4421
100,Prato,46,683,1365,80,6,3,0,0,2137,456,1449,138,18,1,0,0,2062,4199
100,Prato,47,571,1467,83,8,5,0,0,2134,433,1538,156,32,2,0,0,2161,4295
100,Prato,48,576,1495,100,5,5,0,0,2181,385,1488,133,23,0,0,0,2029,4210
100,Prato,49,510,1534,111,7,1,0,0,2163,407,1548,155,33,0,0,0,2143,4306
100,Prato,50,462,1495,117,8,2,0,0,2084,351,1571,151,35,0,0,0,2108,4192
100,Prato,51,418,1405,121,9,2,0,0,1955,333,1599,161,39,1,0,0,2133,4088
100,Prato,52,420,1486,147,12,2,0,0,2067,329,1574,167,45,1,0,0,2116,4183
100,Prato,53,378,1540,151,18,3,0,0,2090,292,1581,189,64,0,0,0,2126,4216
100,Prato,54,346,1557,126,16,2,0,0,2047,232,1635,165,65,1,0,0,2098,4145
100,Prato,55,299,1441,141,20,3,0,0,1904,228,1500,173,72,1,0,0,1974,3878
100,Prato,56,251,1397,133,17,0,0,0,1798,188,1473,180,86,0,0,0,1927,3725
100,Prato,57,211,1343,103,16,1,0,0,1674,195,1423,180,72,0,0,0,1870,3544
100,Prato,58,192,1347,117,20,0,0,0,1676,180,1369,160,81,0,0,0,1790,3466
100,Prato,59,200,1270,108,30,0,0,0,1608,177,1311,132,78,0,0,0,1698,3306
100,Prato,60,170,1251,107,36,3,0,0,1567,138,1320,145,106,0,0,0,1709,3276
100,Prato,61,146,1277,89,37,0,0,0,1549,147,1260,129,125,0,0,0,1661,3210
100,Prato,62,132,1252,77,38,0,0,0,1499,147,1254,113,145,0,0,0,1659,3158
100,Prato,63,133,1243,67,39,0,0,0,1482,120,1275,100,144,0,0,0,1639,3121
100,Prato,64,97,1142,95,52,0,0,0,1386,104,1184,112,167,0,0,0,1567,2953
100,Prato,65,86,1128,59,53,0,0,0,1326,106,1109,83,158,0,0,0,1456,2782
100,Prato,66,105,1128,59,46,1,0,0,1339,100,1153,81,173,0,0,0,1507,2846
100,Prato,67,93,1089,52,50,0,0,0,1284,70,1078,63,216,0,0,0,1427,2711
100,Prato,68,67,1119,47,57,1,0,0,1291,76,1110,72,232,0,0,0,1490,2781
100,Prato,69,89,1169,53,51,0,0,0,1362,79,1147,68,287,0,0,0,1581,2943
100,Prato,70,86,1272,37,65,0,0,0,1460,77,1110,68,309,0,0,0,1564,3024
100,Prato,71,73,1179,46,71,0,0,0,1369,79,1097,65,346,0,0,0,1587,2956
100,Prato,72,79,1221,39,75,0,0,0,1414,87,1063,64,369,0,0,0,1583,2997
100,Prato,73,64,933,23,59,0,0,0,1079,58,824,45,308,0,0,0,1235,2314
100,Prato,74,36,869,25,92,0,0,0,1022,64,777,47,360,0,0,0,1248,2270
100,Prato,75,50,886,18,91,0,0,0,1045,66,769,36,400,0,0,0,1271,2316
100,Prato,76,60,799,18,82,0,0,0,959,65,674,36,406,0,0,0,1181,2140
100,Prato,77,56,792,13,98,0,0,0,959,61,657,28,458,0,0,0,1204,2163
100,Prato,78,67,864,16,103,0,0,0,1050,51,727,31,555,0,0,0,1364,2414
100,Prato,79,66,824,12,139,0,0,0,1041,63,603,33,586,0,0,0,1285,2326
100,Prato,80,53,799,9,133,0,0,0,994,70,565,21,673,0,0,0,1329,2323
100,Prato,81,41,633,10,97,0,0,0,781,51,442,25,600,0,0,0,1118,1899
100,Prato,82,40,571,10,140,0,0,0,761,42,373,20,549,0,0,0,984,1745
100,Prato,83,41,500,7,109,0,0,0,657,39,353,14,612,0,0,0,1018,1675
100,Prato,84,26,450,7,118,0,0,0,601,33,254,8,574,0,0,0,869,1470
100,Prato,85,22,398,6,117,0,0,0,543,53,208,11,531,0,0,0,803,1346
100,Prato,86,29,325,6,122,0,0,0,482,38,156,10,564,0,0,0,768,1250
100,Prato,87,20,283,6,85,0,0,0,394,24,153,4,505,0,0,0,686,1080
100,Prato,88,17,251,2,110,0,0,0,380,39,100,8,539,0,0,0,686,1066
100,Prato,89,11,186,2,95,0,0,0,294,28,79,8,474,0,0,0,589,883
100,Prato,90,12,138,3,82,0,0,0,235,30,51,2,476,0,0,0,559,794
100,Prato,91,3,117,2,86,0,0,0,208,28,37,3,360,0,0,0,428,636
100,Prato,92,7,88,1,62,0,0,0,158,24,25,1,319,0,0,0,369,527
100,Prato,93,8,60,1,53,0,0,0,122,16,11,1,283,0,0,0,311,433
100,Prato,94,3,38,1,51,0,0,0,93,15,18,2,208,0,0,0,243,336
100,Prato,95,2,22,0,31,0,0,0,55,12,7,2,174,0,0,0,195,250
100,Prato,96,2,9,0,19,0,0,0,30,6,2,0,105,0,0,0,113,143
100,Prato,97,4,8,0,23,0,0,0,35,6,2,0,103,0,0,0,111,146
100,Prato,98,0,0,0,12,0,0,0,12,3,1,0,67,0,0,0,71,83
100,Prato,99,0,1,0,6,0,0,0,7,2,0,0,38,0,0,0,40,47
100,Prato,100,0,4,0,4,0,0,0,8,6,0,0,28,0,0,0,34,42
101,Crotone,0,773,0,0,0,0,0,0,773,684,0,0,0,0,0,0,684,1457
101,Crotone,1,797,0,0,0,0,0,0,797,709,0,0,0,0,0,0,709,1506
101,Crotone,2,753,0,0,0,0,0,0,753,763,0,0,0,0,0,0,763,1516
101,Crotone,3,819,0,0,0,0,0,0,819,761,0,0,0,0,0,0,761,1580
101,Crotone,4,797,0,0,0,0,0,0,797,725,0,0,0,0,0,0,725,1522
101,Crotone,5,829,0,0,0,0,0,0,829,753,0,0,0,0,0,0,753,1582
101,Crotone,6,866,0,0,0,0,0,0,866,767,0,0,0,0,0,0,767,1633
101,Crotone,7,883,0,0,0,0,0,0,883,798,0,0,0,0,0,0,798,1681
101,Crotone,8,888,0,0,0,0,0,0,888,935,0,0,0,0,0,0,935,1823
101,Crotone,9,938,0,0,0,0,0,0,938,822,0,0,0,0,0,0,822,1760
101,Crotone,10,1006,0,0,0,0,0,0,1006,857,0,0,0,0,0,0,857,1863
101,Crotone,11,891,0,0,0,0,0,0,891,819,0,0,0,0,0,0,819,1710
101,Crotone,12,913,0,0,0,0,0,0,913,936,0,0,0,0,0,0,936,1849
101,Crotone,13,953,0,0,0,0,0,0,953,915,0,0,0,0,0,0,915,1868
101,Crotone,14,1012,0,0,0,0,0,0,1012,953,0,0,0,0,0,0,953,1965
101,Crotone,15,1017,0,0,0,0,0,0,1017,889,0,0,0,0,0,0,889,1906
101,Crotone,16,946,0,0,0,0,0,0,946,862,0,0,0,0,0,0,862,1808
101,Crotone,17,991,0,0,0,0,0,0,991,926,1,0,0,0,0,0,927,1918
101,Crotone,18,1075,0,0,0,0,0,0,1075,1005,1,0,0,0,0,0,1006,2081
101,Crotone,19,1137,0,0,0,0,0,0,1137,910,4,0,0,0,0,0,914,2051
101,Crotone,20,1157,0,0,0,0,0,0,1157,954,19,0,0,0,0,0,973,2130
101,Crotone,21,1120,1,0,0,0,0,0,1121,890,26,0,0,0,0,0,916,2037
101,Crotone,22,1170,5,0,0,0,0,0,1175,922,60,0,0,0,0,0,982,2157
101,Crotone,23,1223,13,0,0,0,0,0,1236,913,53,0,0,0,0,0,966,2202
101,Crotone,24,1173,27,0,0,0,0,0,1200,944,106,1,0,0,0,0,1051,2251
101,Crotone,25,1243,51,0,0,0,0,0,1294,889,163,4,0,0,0,0,1056,2350
101,Crotone,26,1259,74,0,0,0,0,0,1333,842,215,2,0,0,0,0,1059,2392
101,Crotone,27,1121,107,0,0,0,0,0,1228,793,285,0,2,0,1,0,1081,2309
101,Crotone,28,1169,164,2,0,0,0,0,1335,711,353,2,0,0,0,0,1066,2401
101,Crotone,29,1181,224,1,0,0,0,0,1406,634,423,3,1,0,0,0,1061,2467
101,Crotone,30,1093,274,2,0,0,0,0,1369,558,510,6,0,0,0,0,1074,2443
101,Crotone,31,974,346,1,0,0,0,0,1321,532,562,12,3,0,0,0,1109,2430
101,Crotone,32,896,396,7,1,0,0,0,1300,443,591,10,3,0,0,0,1047,2347
101,Crotone,33,808,410,1,1,0,0,0,1220,361,666,9,0,0,0,0,1036,2256
101,Crotone,34,777,498,9,1,0,0,0,1285,371,661,15,1,0,0,0,1048,2333
101,Crotone,35,681,528,11,1,0,0,0,1221,334,673,13,4,0,0,0,1024,2245
101,Crotone,36,664,598,7,0,0,0,0,1269,290,727,19,3,0,0,0,1039,2308
101,Crotone,37,580,601,8,0,0,0,0,1189,269,776,15,3,0,0,0,1063,2252
101,Crotone,38,564,689,9,0,0,0,0,1262,266,798,13,9,0,0,0,1086,2348
101,Crotone,39,521,713,12,5,0,0,0,1251,246,782,21,6,0,0,0,1055,2306
101,Crotone,40,467,737,13,3,0,0,0,1220,233,852,18,8,0,1,0,1112,2332
101,Crotone,41,413,706,11,3,0,0,0,1133,205,906,26,11,0,0,0,1148,2281
101,Crotone,42,416,832,18,3,0,0,0,1269,222,881,33,14,0,0,0,1150,2419
101,Crotone,43,359,785,28,4,0,0,0,1176,220,930,28,16,0,0,0,1194,2370
101,Crotone,44,359,889,20,4,0,0,0,1272,226,972,30,19,0,0,0,1247,2519
101,Crotone,45,332,853,25,4,0,0,0,1214,224,949,21,21,0,0,0,1215,2429
101,Crotone,46,327,902,26,4,0,0,0,1259,182,1004,38,25,0,0,0,1249,2508
101,Crotone,47,278,921,33,6,0,0,0,1238,206,1027,34,22,0,0,0,1289,2527
101,Crotone,48,292,916,25,5,0,0,0,1238,175,969,34,38,0,0,0,1216,2454
101,Crotone,49,252,946,33,2,0,0,0,1233,203,1057,45,45,0,0,0,1350,2583
101,Crotone,50,245,921,33,2,0,0,0,1201,160,1058,35,34,0,0,0,1287,2488
101,Crotone,51,233,944,26,3,0,0,0,1206,178,1055,33,57,0,0,0,1323,2529
101,Crotone,52,206,986,31,8,0,0,0,1231,175,1049,30,60,0,0,0,1314,2545
101,Crotone,53,197,972,28,12,0,0,0,1209,170,1003,53,55,0,0,0,1281,2490
101,Crotone,54,199,1084,30,18,0,0,0,1331,151,1009,40,73,0,0,0,1273,2604
101,Crotone,55,157,1015,32,11,0,0,0,1215,155,1030,31,61,0,0,0,1277,2492
101,Crotone,56,118,988,21,10,0,0,0,1137,129,1031,45,68,0,0,0,1273,2410
101,Crotone,57,152,1048,34,18,0,0,0,1252,158,946,24,100,0,0,0,1228,2480
101,Crotone,58,115,995,24,9,0,0,0,1143,127,947,25,76,0,0,0,1175,2318
101,Crotone,59,105,933,30,16,0,0,0,1084,126,917,26,96,0,0,0,1165,2249
101,Crotone,60,109,888,26,18,0,0,0,1041,77,868,23,103,0,0,0,1071,2112
101,Crotone,61,95,977,29,27,0,0,0,1128,94,806,30,123,0,0,0,1053,2181
101,Crotone,62,85,918,16,27,0,0,0,1046,105,868,26,117,0,0,0,1116,2162
101,Crotone,63,73,925,22,15,0,0,0,1035,95,850,22,127,0,0,0,1094,2129
101,Crotone,64,70,923,20,29,0,0,0,1042,91,786,26,165,0,0,0,1068,2110
101,Crotone,65,71,834,20,28,0,0,0,953,95,729,17,176,0,0,0,1017,1970
101,Crotone,66,57,797,15,35,0,0,0,904,69,710,24,166,0,0,0,969,1873
101,Crotone,67,54,813,10,25,0,0,0,902,77,677,8,173,0,0,0,935,1837
101,Crotone,68,50,865,21,33,0,0,0,969,73,691,11,214,0,0,0,989,1958
101,Crotone,69,59,809,19,37,0,0,0,924,81,729,12,260,0,0,0,1082,2006
101,Crotone,70,39,820,13,42,0,0,0,914,59,685,17,243,0,0,0,1004,1918
101,Crotone,71,39,772,13,45,0,0,0,869,67,625,11,264,0,0,0,967,1836
101,Crotone,72,35,704,14,45,0,0,0,798,64,548,11,267,0,0,0,890,1688
101,Crotone,73,38,566,10,49,0,0,0,663,57,442,17,254,0,0,0,770,1433
101,Crotone,74,25,565,8,41,0,0,0,639,48,397,10,259,0,0,0,714,1353
101,Crotone,75,30,502,4,39,0,0,0,575,46,353,10,267,0,0,0,676,1251
101,Crotone,76,27,511,7,43,0,0,0,588,51,330,7,299,0,0,0,687,1275
101,Crotone,77,28,439,8,52,0,0,0,527,46,289,5,311,0,0,0,651,1178
101,Crotone,78,18,525,5,64,0,0,0,612,50,332,13,397,0,0,0,792,1404
101,Crotone,79,16,461,4,86,0,0,0,567,49,302,9,367,0,0,0,727,1294
101,Crotone,80,14,425,5,54,0,0,0,498,44,245,7,375,0,0,0,671,1169
101,Crotone,81,11,380,7,72,0,0,0,470,36,225,6,410,0,0,0,677,1147
101,Crotone,82,13,366,6,71,0,0,0,456,36,177,6,393,0,0,0,612,1068
101,Crotone,83,10,317,1,88,0,0,0,416,34,170,1,383,0,0,0,588,1004
101,Crotone,84,13,281,2,78,0,0,0,374,27,104,2,390,0,0,0,523,897
101,Crotone,85,14,248,1,92,0,0,0,355,20,99,3,348,0,0,0,470,825
101,Crotone,86,7,219,2,84,0,0,0,312,36,65,1,334,0,0,0,436,748
101,Crotone,87,8,147,0,66,0,0,0,221,33,67,1,314,0,0,0,415,636
101,Crotone,88,11,132,0,83,0,0,0,226,23,42,0,276,0,0,0,341,567
101,Crotone,89,5,111,0,71,0,0,0,187,16,37,2,212,0,0,0,267,454
101,Crotone,90,2,79,0,55,0,0,0,136,11,20,0,204,0,0,0,235,371
101,Crotone,91,2,53,0,46,0,0,0,101,11,17,0,168,0,0,0,196,297
101,Crotone,92,2,35,0,41,0,0,0,78,6,9,4,126,0,0,0,145,223
101,Crotone,93,1,18,0,27,0,0,0,46,12,10,1,95,0,0,0,118,164
101,Crotone,94,4,14,0,18,0,0,0,36,6,4,0,87,0,0,0,97,133
101,Crotone,95,1,9,0,20,0,0,0,30,6,5,0,44,0,0,0,55,85
101,Crotone,96,1,4,0,10,0,0,0,15,0,2,0,28,0,0,0,30,45
101,Crotone,97,0,5,0,5,0,0,0,10,5,1,0,29,0,0,0,35,45
101,Crotone,98,2,6,0,7,0,0,0,15,2,3,0,14,0,0,0,19,34
101,Crotone,99,0,0,0,1,0,0,0,1,0,0,0,10,0,0,0,10,11
101,Crotone,100,0,0,0,1,0,0,0,1,2,0,0,16,0,0,0,18,19
102,Vibo Valentia,0,598,0,0,0,0,0,0,598,606,0,0,0,0,0,0,606,1204
102,Vibo Valentia,1,631,0,0,0,0,0,0,631,615,0,0,0,0,0,0,615,1246
102,Vibo Valentia,2,628,0,0,0,0,0,0,628,614,0,0,0,0,0,0,614,1242
102,Vibo Valentia,3,672,0,0,0,0,0,0,672,620,0,0,0,0,0,0,620,1292
102,Vibo Valentia,4,697,0,0,0,0,0,0,697,651,0,0,0,0,0,0,651,1348
102,Vibo Valentia,5,671,0,0,0,0,0,0,671,606,0,0,0,0,0,0,606,1277
102,Vibo Valentia,6,739,0,0,0,0,0,0,739,665,0,0,0,0,0,0,665,1404
102,Vibo Valentia,7,690,0,0,0,0,0,0,690,661,0,0,0,0,0,0,661,1351
102,Vibo Valentia,8,747,0,0,0,0,0,0,747,736,0,0,0,0,0,0,736,1483
102,Vibo Valentia,9,732,0,0,0,0,0,0,732,721,0,0,0,0,0,0,721,1453
102,Vibo Valentia,10,757,0,0,0,0,0,0,757,794,0,0,0,0,0,0,794,1551
102,Vibo Valentia,11,810,0,0,0,0,0,0,810,755,0,0,0,0,0,0,755,1565
102,Vibo Valentia,12,786,0,0,0,0,0,0,786,778,0,0,0,0,0,0,778,1564
102,Vibo Valentia,13,857,0,0,0,0,0,0,857,762,0,0,0,0,0,0,762,1619
102,Vibo Valentia,14,813,0,0,0,0,0,0,813,816,0,0,0,0,0,0,816,1629
102,Vibo Valentia,15,886,0,0,0,0,0,0,886,791,0,0,0,0,0,0,791,1677
102,Vibo Valentia,16,836,0,0,0,0,0,0,836,778,0,0,0,0,0,0,778,1614
102,Vibo Valentia,17,961,0,0,0,0,0,0,961,810,0,0,0,0,0,0,810,1771
102,Vibo Valentia,18,970,0,1,0,0,0,0,971,783,3,0,0,0,0,0,786,1757
102,Vibo Valentia,19,950,0,0,0,0,0,0,950,782,2,0,0,0,0,0,784,1734
102,Vibo Valentia,20,957,2,0,0,0,0,0,959,840,18,0,0,0,0,0,858,1817
102,Vibo Valentia,21,961,3,0,0,0,0,0,964,863,27,0,0,0,0,0,890,1854
102,Vibo Valentia,22,964,7,0,0,0,0,0,971,795,45,0,0,0,0,0,840,1811
102,Vibo Valentia,23,1018,13,0,0,0,0,0,1031,828,65,0,0,0,0,0,893,1924
102,Vibo Valentia,24,982,24,0,0,0,0,0,1006,788,116,1,0,0,0,0,905,1911
102,Vibo Valentia,25,991,50,0,0,0,0,0,1041,796,151,2,0,0,0,0,949,1990
102,Vibo Valentia,26,1021,63,0,0,0,0,0,1084,791,233,1,0,0,0,0,1025,2109
102,Vibo Valentia,27,911,115,0,0,0,0,0,1026,691,248,1,0,0,0,0,940,1966
102,Vibo Valentia,28,922,136,0,0,0,0,0,1058,668,308,3,0,0,0,0,979,2037
102,Vibo Valentia,29,904,181,1,0,0,0,0,1086,567,381,4,1,0,1,0,954,2040
102,Vibo Valentia,30,816,275,2,0,0,0,0,1093,580,416,6,0,0,0,0,1002,2095
102,Vibo Valentia,31,743,283,0,1,0,0,0,1027,480,471,6,0,0,0,0,957,1984
102,Vibo Valentia,32,662,351,1,1,0,1,0,1016,453,554,7,3,0,0,0,1017,2033
102,Vibo Valentia,33,615,373,2,0,0,1,0,991,390,587,3,0,0,0,0,980,1971
102,Vibo Valentia,34,573,463,2,0,0,0,0,1038,368,545,10,2,0,0,0,925,1963
102,Vibo Valentia,35,531,476,2,0,0,0,0,1009,285,602,8,1,0,0,0,896,1905
102,Vibo Valentia,36,490,506,6,0,0,0,0,1002,283,699,11,3,0,0,0,996,1998
102,Vibo Valentia,37,455,489,8,0,0,0,0,952,262,682,14,5,0,0,0,963,1915
102,Vibo Valentia,38,394,577,4,0,0,0,0,975,215,715,12,6,0,0,0,948,1923
102,Vibo Valentia,39,357,625,8,0,0,0,0,990,232,770,21,8,0,0,0,1031,2021
102,Vibo Valentia,40,362,606,8,1,1,0,0,978,258,733,9,6,0,0,0,1006,1984
102,Vibo Valentia,41,366,661,8,0,0,0,0,1035,214,799,24,10,0,0,0,1047,2082
102,Vibo Valentia,42,351,719,12,1,0,0,0,1083,206,913,28,10,0,0,0,1157,2240
102,Vibo Valentia,43,346,769,21,2,0,0,0,1138,181,849,28,8,1,0,0,1067,2205
102,Vibo Valentia,44,304,721,17,1,0,0,0,1043,185,935,31,22,1,0,0,1174,2217
102,Vibo Valentia,45,297,817,16,1,0,0,0,1131,177,895,29,22,1,0,0,1124,2255
102,Vibo Valentia,46,292,781,15,9,0,0,0,1097,172,924,30,20,0,0,0,1146,2243
102,Vibo Valentia,47,275,855,22,7,0,0,0,1159,153,926,22,33,0,0,0,1134,2293
102,Vibo Valentia,48,256,780,30,2,0,0,0,1068,177,915,30,32,0,0,0,1154,2222
102,Vibo Valentia,49,263,860,18,4,0,0,0,1145,178,1059,38,25,0,0,0,1300,2445
102,Vibo Valentia,50,242,891,14,10,1,0,0,1158,174,982,33,42,0,0,0,1231,2389
102,Vibo Valentia,51,225,888,25,10,0,0,0,1148,167,954,28,48,0,0,0,1197,2345
102,Vibo Valentia,52,232,952,24,7,0,0,0,1215,166,1052,27,49,0,0,0,1294,2509
102,Vibo Valentia,53,221,894,26,9,0,0,0,1150,148,942,29,56,0,0,0,1175,2325
102,Vibo Valentia,54,218,1005,20,9,0,0,0,1252,147,1035,28,64,0,0,0,1274,2526
102,Vibo Valentia,55,200,963,15,11,0,0,0,1189,104,994,29,65,0,0,0,1192,2381
102,Vibo Valentia,56,173,923,13,13,0,0,0,1122,144,1000,31,77,0,0,0,1252,2374
102,Vibo Valentia,57,182,897,21,16,0,0,0,1116,109,947,25,100,0,0,0,1181,2297
102,Vibo Valentia,58,166,891,39,12,0,0,0,1108,112,978,24,93,1,0,0,1208,2316
102,Vibo Valentia,59,151,889,18,17,0,0,0,1075,104,920,32,107,0,0,0,1163,2238
102,Vibo Valentia,60,145,853,23,23,0,1,0,1045,86,827,27,94,0,0,0,1034,2079
102,Vibo Valentia,61,149,823,29,20,0,0,0,1021,102,848,19,121,0,0,0,1090,2111
102,Vibo Valentia,62,117,863,16,18,0,0,0,1014,78,768,22,141,0,0,0,1009,2023
102,Vibo Valentia,63,109,878,19,26,0,0,0,1032,103,752,24,139,0,0,0,1018,2050
102,Vibo Valentia,64,117,828,17,18,0,0,0,980,69,777,21,139,0,0,0,1006,1986
102,Vibo Valentia,65,107,852,16,23,0,0,0,998,88,716,21,157,0,0,0,982,1980
102,Vibo Valentia,66,82,813,18,26,0,0,0,939,81,664,19,151,0,0,0,915,1854
102,Vibo Valentia,67,70,821,16,23,0,0,0,930,70,634,17,167,0,0,0,888,1818
102,Vibo Valentia,68,78,842,19,32,0,0,0,971,66,656,22,208,0,0,0,952,1923
102,Vibo Valentia,69,69,818,14,39,0,0,0,940,71,660,9,219,0,0,0,959,1899
102,Vibo Valentia,70,60,837,15,47,1,0,0,960,62,626,18,261,0,0,0,967,1927
102,Vibo Valentia,71,71,793,10,44,0,0,0,918,64,552,10,260,0,0,0,886,1804
102,Vibo Valentia,72,48,693,13,47,0,0,0,801,65,537,8,250,0,0,0,860,1661
102,Vibo Valentia,73,36,584,18,39,0,0,0,677,47,402,7,223,0,0,0,679,1356
102,Vibo Valentia,74,30,545,9,47,0,0,0,631,48,351,6,213,0,0,0,618,1249
102,Vibo Valentia,75,34,493,6,39,0,0,0,572,60,344,9,240,0,0,0,653,1225
102,Vibo Valentia,76,21,487,7,61,0,0,0,576,35,316,8,289,0,0,0,648,1224
102,Vibo Valentia,77,29,459,8,42,0,0,0,538,41,262,5,263,0,0,0,571,1109
102,Vibo Valentia,78,34,520,10,86,0,0,0,650,53,349,4,330,0,0,0,736,1386
102,Vibo Valentia,79,37,512,5,79,0,0,0,633,52,306,2,373,0,0,0,733,1366
102,Vibo Valentia,80,31,441,3,66,0,0,0,541,65,273,9,345,0,0,0,692,1233
102,Vibo Valentia,81,27,376,4,81,0,0,0,488,46,242,5,338,0,0,0,631,1119
102,Vibo Valentia,82,22,355,0,66,0,0,0,443,47,199,3,365,0,0,0,614,1057
102,Vibo Valentia,83,18,333,4,95,0,0,0,450,47,185,9,355,0,0,0,596,1046
102,Vibo Valentia,84,17,303,3,89,0,0,0,412,36,173,3,359,0,0,0,571,983
102,Vibo Valentia,85,13,280,3,89,0,0,0,385,55,143,3,416,0,0,0,617,1002
102,Vibo Valentia,86,9,229,1,81,0,0,0,320,42,86,1,373,0,0,0,502,822
102,Vibo Valentia,87,13,164,2,64,0,0,0,243,44,90,4,305,0,0,0,443,686
102,Vibo Valentia,88,9,170,2,79,0,0,0,260,48,68,0,304,0,0,0,420,680
102,Vibo Valentia,89,11,117,0,59,0,0,0,187,37,45,4,248,0,0,0,334,521
102,Vibo Valentia,90,6,85,0,70,0,0,0,161,30,37,0,221,0,0,0,288,449
102,Vibo Valentia,91,5,66,0,58,0,0,0,129,21,28,0,170,0,0,0,219,348
102,Vibo Valentia,92,6,40,1,41,0,0,0,88,29,18,2,155,0,0,0,204,292
102,Vibo Valentia,93,1,41,1,32,0,0,0,75,18,15,1,129,0,0,0,163,238
102,Vibo Valentia,94,5,23,0,29,0,0,0,57,7,12,0,81,0,0,0,100,157
102,Vibo Valentia,95,1,18,0,23,0,0,0,42,10,8,0,94,0,0,0,112,154
102,Vibo Valentia,96,1,6,0,22,0,0,0,29,10,9,0,68,0,0,0,87,116
102,Vibo Valentia,97,1,8,0,11,0,0,0,20,7,5,3,49,0,0,0,64,84
102,Vibo Valentia,98,0,8,0,12,0,0,0,20,5,0,0,39,0,0,0,44,64
102,Vibo Valentia,99,0,1,0,1,0,0,0,2,2,3,0,7,0,0,0,12,14
102,Vibo Valentia,100,2,3,0,6,0,0,0,11,2,2,0,29,0,0,0,33,44
103,Verbano-Cusio-Ossola,0,439,0,0,0,0,0,0,439,434,0,0,0,0,0,0,434,873
103,Verbano-Cusio-Ossola,1,451,0,0,0,0,0,0,451,475,0,0,0,0,0,0,475,926
103,Verbano-Cusio-Ossola,2,498,0,0,0,0,0,0,498,473,0,0,0,0,0,0,473,971
103,Verbano-Cusio-Ossola,3,512,0,0,0,0,0,0,512,552,0,0,0,0,0,0,552,1064
103,Verbano-Cusio-Ossola,4,583,0,0,0,0,0,0,583,544,0,0,0,0,0,0,544,1127
103,Verbano-Cusio-Ossola,5,560,0,0,0,0,0,0,560,567,0,0,0,0,0,0,567,1127
103,Verbano-Cusio-Ossola,6,579,0,0,0,0,0,0,579,615,0,0,0,0,0,0,615,1194
103,Verbano-Cusio-Ossola,7,643,0,0,0,0,0,0,643,610,0,0,0,0,0,0,610,1253
103,Verbano-Cusio-Ossola,8,656,0,0,0,0,0,0,656,610,0,0,0,0,0,0,610,1266
103,Verbano-Cusio-Ossola,9,675,0,0,0,0,0,0,675,648,0,0,0,0,0,0,648,1323
103,Verbano-Cusio-Ossola,10,699,0,0,0,0,0,0,699,617,0,0,0,0,0,0,617,1316
103,Verbano-Cusio-Ossola,11,635,0,0,0,0,0,0,635,636,0,0,0,0,0,0,636,1271
103,Verbano-Cusio-Ossola,12,697,0,0,0,0,0,0,697,661,0,0,0,0,0,0,661,1358
103,Verbano-Cusio-Ossola,13,680,0,0,0,0,0,0,680,652,0,0,0,0,0,0,652,1332
103,Verbano-Cusio-Ossola,14,733,0,0,0,0,0,0,733,646,0,0,0,0,0,0,646,1379
103,Verbano-Cusio-Ossola,15,732,0,0,0,0,0,0,732,674,0,0,0,0,0,0,674,1406
103,Verbano-Cusio-Ossola,16,693,0,0,0,0,0,0,693,584,0,0,0,0,0,0,584,1277
103,Verbano-Cusio-Ossola,17,749,0,2,0,0,0,0,751,664,0,0,0,0,0,0,664,1415
103,Verbano-Cusio-Ossola,18,735,4,0,0,0,0,0,739,701,1,0,0,0,0,0,702,1441
103,Verbano-Cusio-Ossola,19,718,9,0,0,0,0,0,727,644,0,0,0,0,0,0,644,1371
103,Verbano-Cusio-Ossola,20,798,8,0,0,0,0,0,806,686,10,0,0,0,0,0,696,1502
103,Verbano-Cusio-Ossola,21,732,8,0,0,0,0,0,740,659,16,1,0,0,0,0,676,1416
103,Verbano-Cusio-Ossola,22,739,14,0,0,0,0,0,753,672,18,0,0,0,0,0,690,1443
103,Verbano-Cusio-Ossola,23,728,15,0,1,0,0,0,744,645,28,1,0,0,0,0,674,1418
103,Verbano-Cusio-Ossola,24,748,12,1,0,0,0,0,761,638,65,1,1,0,0,0,705,1466
103,Verbano-Cusio-Ossola,25,781,15,1,0,0,0,0,797,611,61,3,0,0,0,0,675,1472
103,Verbano-Cusio-Ossola,26,685,33,0,0,1,0,0,719,601,90,1,2,1,0,0,695,1414
103,Verbano-Cusio-Ossola,27,721,37,0,0,0,0,0,758,607,121,1,0,0,0,0,729,1487
103,Verbano-Cusio-Ossola,28,693,58,1,1,0,0,0,753,553,150,4,0,0,0,0,707,1460
103,Verbano-Cusio-Ossola,29,615,81,2,0,0,0,0,698,501,196,6,0,0,0,0,703,1401
103,Verbano-Cusio-Ossola,30,642,130,5,0,0,0,0,777,446,233,5,1,0,0,0,685,1462
103,Verbano-Cusio-Ossola,31,609,154,2,0,0,0,0,765,405,259,5,1,0,0,0,670,1435
103,Verbano-Cusio-Ossola,32,573,189,1,0,2,0,0,765,398,280,11,3,3,0,0,695,1460
103,Verbano-Cusio-Ossola,33,563,230,3,0,0,0,0,796,360,339,21,0,0,0,0,720,1516
103,Verbano-Cusio-Ossola,34,491,248,10,0,0,0,0,749,370,361,12,1,2,0,0,746,1495
103,Verbano-Cusio-Ossola,35,516,286,16,0,1,0,0,819,317,391,14,1,2,0,0,725,1544
103,Verbano-Cusio-Ossola,36,514,324,7,0,0,0,0,845,346,414,28,3,0,0,0,791,1636
103,Verbano-Cusio-Ossola,37,468,361,10,0,0,0,0,839,312,429,33,3,0,0,0,777,1616
103,Verbano-Cusio-Ossola,38,474,361,18,0,0,0,0,853,347,465,34,0,0,0,0,846,1699
103,Verbano-Cusio-Ossola,39,494,393,26,0,3,0,0,916,275,518,44,4,0,0,0,841,1757
103,Verbano-Cusio-Ossola,40,482,449,27,1,3,0,0,962,303,586,56,11,0,0,0,956,1918
103,Verbano-Cusio-Ossola,41,525,440,31,2,0,0,0,998,333,632,55,12,1,0,0,1033,2031
103,Verbano-Cusio-Ossola,42,451,549,46,2,1,0,0,1049,322,696,76,5,0,0,0,1099,2148
103,Verbano-Cusio-Ossola,43,491,596,44,0,0,0,0,1131,316,776,75,9,1,0,0,1177,2308
103,Verbano-Cusio-Ossola,44,498,653,44,2,1,0,0,1198,352,758,101,14,1,0,0,1226,2424
103,Verbano-Cusio-Ossola,45,512,694,62,2,0,0,0,1270,317,817,94,13,2,0,0,1243,2513
103,Verbano-Cusio-Ossola,46,439,702,85,5,0,0,0,1231,312,853,128,11,1,0,0,1305,2536
103,Verbano-Cusio-Ossola,47,413,805,108,5,1,0,0,1332,270,899,134,23,0,0,0,1326,2658
103,Verbano-Cusio-Ossola,48,440,816,103,6,2,0,0,1367,260,864,126,21,1,0,0,1272,2639
103,Verbano-Cusio-Ossola,49,426,826,85,9,0,0,0,1346,271,940,130,33,0,0,0,1374,2720
103,Verbano-Cusio-Ossola,50,377,866,109,8,2,0,0,1362,233,1033,134,27,1,0,0,1428,2790
103,Verbano-Cusio-Ossola,51,351,838,105,6,1,0,0,1301,225,964,151,32,1,0,0,1373,2674
103,Verbano-Cusio-Ossola,52,355,927,137,9,0,0,0,1428,256,984,145,44,0,0,0,1429,2857
103,Verbano-Cusio-Ossola,53,363,938,126,8,0,0,0,1435,225,948,163,46,1,0,0,1383,2818
103,Verbano-Cusio-Ossola,54,316,955,135,8,0,0,0,1414,208,998,148,59,1,0,0,1414,2828
103,Verbano-Cusio-Ossola,55,276,942,109,10,2,0,0,1339,183,944,153,56,1,0,0,1337,2676
103,Verbano-Cusio-Ossola,56,280,878,125,14,0,0,0,1297,140,939,151,65,1,0,0,1296,2593
103,Verbano-Cusio-Ossola,57,235,826,125,20,1,0,0,1207,144,886,128,81,0,0,0,1239,2446
103,Verbano-Cusio-Ossola,58,194,877,110,15,1,0,0,1197,136,868,127,94,0,0,0,1225,2422
103,Verbano-Cusio-Ossola,59,175,826,99,16,0,0,0,1116,118,828,111,101,1,0,0,1159,2275
103,Verbano-Cusio-Ossola,60,157,812,111,21,2,1,0,1104,101,863,120,98,0,0,0,1182,2286
103,Verbano-Cusio-Ossola,61,184,825,102,21,0,0,0,1132,110,814,92,124,0,0,0,1140,2272
103,Verbano-Cusio-Ossola,62,134,828,79,14,0,0,0,1055,100,798,90,105,1,0,0,1094,2149
103,Verbano-Cusio-Ossola,63,139,785,82,22,0,0,0,1028,110,772,101,116,0,0,0,1099,2127
103,Verbano-Cusio-Ossola,64,138,741,84,30,0,0,0,993,83,845,74,148,0,0,0,1150,2143
103,Verbano-Cusio-Ossola,65,137,811,69,42,0,0,0,1059,88,799,74,148,0,0,0,1109,2168
103,Verbano-Cusio-Ossola,66,105,771,72,26,0,0,0,974,74,714,83,174,0,0,0,1045,2019
103,Verbano-Cusio-Ossola,67,100,760,63,57,0,0,0,980,84,716,67,181,0,0,0,1048,2028
103,Verbano-Cusio-Ossola,68,115,809,61,52,1,0,0,1038,64,745,66,220,0,0,0,1095,2133
103,Verbano-Cusio-Ossola,69,97,787,58,54,0,0,0,996,69,715,61,215,0,0,0,1060,2056
103,Verbano-Cusio-Ossola,70,96,845,50,49,0,0,0,1040,68,768,60,250,0,0,1,1147,2187
103,Verbano-Cusio-Ossola,71,106,791,52,55,0,0,0,1004,57,730,53,316,0,0,0,1156,2160
103,Verbano-Cusio-Ossola,72,95,797,55,67,0,0,0,1014,75,678,49,301,0,0,0,1103,2117
103,Verbano-Cusio-Ossola,73,67,557,31,50,0,0,0,705,41,459,37,258,0,0,0,795,1500
103,Verbano-Cusio-Ossola,74,64,615,24,59,0,0,0,762,49,542,32,332,1,0,0,956,1718
103,Verbano-Cusio-Ossola,75,57,534,21,72,0,0,0,684,58,478,28,322,0,0,0,886,1570
103,Verbano-Cusio-Ossola,76,57,592,22,72,0,0,0,743,54,488,34,341,0,0,0,917,1660
103,Verbano-Cusio-Ossola,77,57,631,31,86,0,0,0,805,53,463,41,430,0,0,0,987,1792
103,Verbano-Cusio-Ossola,78,70,654,29,99,0,0,0,852,66,463,27,467,1,0,0,1024,1876
103,Verbano-Cusio-Ossola,79,58,589,20,107,0,0,0,774,58,424,29,490,1,0,0,1002,1776
103,Verbano-Cusio-Ossola,80,57,532,15,102,1,0,0,707,68,396,21,470,0,0,0,955,1662
103,Verbano-Cusio-Ossola,81,49,475,14,87,0,0,0,625,48,337,20,509,0,0,0,914,1539
103,Verbano-Cusio-Ossola,82,39,411,13,78,0,0,0,541,41,249,13,461,0,0,0,764,1305
103,Verbano-Cusio-Ossola,83,33,361,12,104,1,0,0,511,50,215,13,476,0,0,0,754,1265
103,Verbano-Cusio-Ossola,84,34,279,6,93,0,0,0,412,45,180,20,489,0,0,0,734,1146
103,Verbano-Cusio-Ossola,85,16,234,7,78,0,0,0,335,60,142,13,469,0,0,0,684,1019
103,Verbano-Cusio-Ossola,86,30,196,4,70,0,0,0,300,55,103,9,460,1,0,0,628,928
103,Verbano-Cusio-Ossola,87,16,172,6,77,1,0,0,272,38,97,10,416,0,0,0,561,833
103,Verbano-Cusio-Ossola,88,11,170,5,70,0,0,0,256,38,71,1,432,0,0,0,542,798
103,Verbano-Cusio-Ossola,89,17,131,2,58,0,0,0,208,33,53,4,352,0,0,0,442,650
103,Verbano-Cusio-Ossola,90,6,91,2,61,0,0,0,160,38,35,6,330,0,0,0,409,569
103,Verbano-Cusio-Ossola,91,10,68,0,66,0,0,0,144,31,17,5,270,0,0,0,323,467
103,Verbano-Cusio-Ossola,92,9,60,0,42,0,0,0,111,24,18,2,234,0,0,0,278,389
103,Verbano-Cusio-Ossola,93,5,32,0,23,0,0,0,60,20,8,1,170,0,0,0,199,259
103,Verbano-Cusio-Ossola,94,3,15,0,25,0,0,0,43,13,4,2,146,0,0,0,165,208
103,Verbano-Cusio-Ossola,95,2,12,0,20,0,0,0,34,24,5,4,119,0,0,0,152,186
103,Verbano-Cusio-Ossola,96,1,7,0,9,0,0,0,17,7,0,1,83,0,0,0,91,108
103,Verbano-Cusio-Ossola,97,0,7,0,5,0,0,0,12,4,0,1,64,0,0,0,69,81
103,Verbano-Cusio-Ossola,98,1,1,0,6,0,0,0,8,6,2,0,44,0,0,0,52,60
103,Verbano-Cusio-Ossola,99,0,0,0,2,0,0,0,2,3,1,0,20,0,0,0,24,26
103,Verbano-Cusio-Ossola,100,1,1,0,3,0,0,0,5,7,0,1,38,0,0,0,46,51
108,Monza e della Brianza,0,3452,0,0,0,0,0,0,3452,3198,0,0,0,0,0,0,3198,6650
108,Monza e della Brianza,1,3674,0,0,0,0,0,0,3674,3326,0,0,0,0,0,0,3326,7000
108,Monza e della Brianza,2,3691,0,0,0,0,0,0,3691,3464,0,0,0,0,0,0,3464,7155
108,Monza e della Brianza,3,3882,0,0,0,0,0,0,3882,3742,0,0,0,0,0,0,3742,7624
108,Monza e della Brianza,4,3984,0,0,0,0,0,0,3984,3795,0,0,0,0,0,0,3795,7779
108,Monza e della Brianza,5,4115,0,0,0,0,0,0,4115,3762,0,0,0,0,0,0,3762,7877
108,Monza e della Brianza,6,4198,0,0,0,0,0,0,4198,4003,0,0,0,0,0,0,4003,8201
108,Monza e della Brianza,7,4244,0,0,0,0,0,0,4244,4184,0,0,0,0,0,0,4184,8428
108,Monza e della Brianza,8,4433,0,0,0,0,0,0,4433,4197,0,0,0,0,0,0,4197,8630
108,Monza e della Brianza,9,4600,0,0,0,0,0,0,4600,4246,0,0,0,0,0,0,4246,8846
108,Monza e della Brianza,10,4521,0,0,0,0,0,0,4521,4298,0,0,0,0,0,0,4298,8819
108,Monza e della Brianza,11,4508,0,0,0,0,0,0,4508,4246,0,0,0,0,0,0,4246,8754
108,Monza e della Brianza,12,4610,0,0,0,0,0,0,4610,4245,0,0,0,0,0,0,4245,8855
108,Monza e della Brianza,13,4397,0,0,0,0,0,0,4397,4093,0,0,0,0,0,0,4093,8490
108,Monza e della Brianza,14,4424,0,0,0,0,0,0,4424,4106,0,0,0,0,0,0,4106,8530
108,Monza e della Brianza,15,4234,0,0,0,0,0,0,4234,4143,0,0,0,0,0,0,4143,8377
108,Monza e della Brianza,16,4298,0,0,0,0,0,0,4298,4001,0,0,0,0,0,0,4001,8299
108,Monza e della Brianza,17,4140,0,1,0,0,0,0,4141,4030,0,0,0,0,0,0,4030,8171
108,Monza e della Brianza,18,4384,1,0,0,0,0,0,4385,4024,4,0,0,0,0,0,4028,8413
108,Monza e della Brianza,19,4260,0,0,0,0,0,0,4260,3848,12,0,0,0,0,0,3860,8120
108,Monza e della Brianza,20,4521,3,0,0,0,0,0,4524,3872,39,0,0,0,0,0,3911,8435
108,Monza e della Brianza,21,4351,7,0,0,0,0,0,4358,3894,64,0,0,0,0,0,3958,8316
108,Monza e della Brianza,22,4277,10,0,0,0,0,0,4287,3818,89,1,0,0,0,0,3908,8195
108,Monza e della Brianza,23,4234,26,1,0,0,0,0,4261,3748,156,1,0,0,0,0,3905,8166
108,Monza e della Brianza,24,4130,58,0,0,2,0,0,4190,3668,219,1,1,2,0,0,3891,8081
108,Monza e della Brianza,25,4018,75,2,0,2,0,0,4097,3650,324,2,1,0,0,0,3977,8074
108,Monza e della Brianza,26,4154,159,1,0,1,0,0,4315,3547,444,5,1,0,0,0,3997,8312
108,Monza e della Brianza,27,4120,252,0,0,1,0,0,4373,3584,624,8,0,1,0,0,4217,8590
108,Monza e della Brianza,28,4052,360,5,0,2,1,0,4420,3264,897,18,2,4,0,0,4185,8605
108,Monza e della Brianza,29,3727,598,6,0,3,0,0,4334,3095,1259,22,4,0,0,0,4380,8714
108,Monza e della Brianza,30,3685,774,10,1,2,0,0,4472,2932,1577,26,3,6,0,0,4544,9016
108,Monza e della Brianza,31,3419,978,13,0,4,0,0,4414,2659,1867,32,3,1,0,0,4562,8976
108,Monza e della Brianza,32,3234,1280,24,1,3,0,0,4542,2408,2074,45,1,4,0,0,4532,9074
108,Monza e della Brianza,33,3190,1607,28,2,2,0,0,4829,2333,2323,90,6,5,0,0,4757,9586
108,Monza e della Brianza,34,2924,1906,46,1,3,0,0,4880,2098,2638,87,8,4,0,0,4835,9715
108,Monza e della Brianza,35,2869,2142,40,2,3,0,0,5056,2041,2840,130,5,0,0,0,5016,10072
108,Monza e della Brianza,36,2787,2424,68,4,5,0,0,5288,1966,3212,144,6,3,1,0,5332,10620
108,Monza e della Brianza,37,2695,2492,97,1,10,0,0,5295,1799,3232,161,14,5,0,0,5211,10506
108,Monza e della Brianza,38,2583,2923,98,4,2,0,0,5610,1828,3529,186,12,5,0,0,5560,11170
108,Monza e della Brianza,39,2552,3164,92,3,2,0,0,5813,1725,3621,232,23,7,0,0,5608,11421
108,Monza e della Brianza,40,2563,3351,151,8,4,0,0,6077,1743,3977,242,17,4,0,0,5983,12060
108,Monza e della Brianza,41,2519,3605,185,10,5,0,0,6324,1653,4222,274,27,4,0,0,6180,12504
108,Monza e della Brianza,42,2542,3907,231,7,8,0,0,6695,1714,4388,367,25,7,0,0,6501,13196
108,Monza e della Brianza,43,2686,4259,245,9,8,0,0,7207,1716,4856,410,38,3,0,0,7023,14230
108,Monza e della Brianza,44,2518,4476,297,17,7,0,0,7315,1672,5123,452,56,6,0,0,7309,14624
108,Monza e della Brianza,45,2317,4624,350,14,5,0,0,7310,1588,5090,465,58,4,0,0,7205,14515
108,Monza e della Brianza,46,2233,4795,374,14,4,0,0,7420,1453,5250,449,67,2,0,0,7221,14641
108,Monza e della Brianza,47,2108,4981,390,28,9,0,1,7517,1342,5286,547,87,4,0,0,7266,14783
108,Monza e della Brianza,48,1899,4972,389,28,7,0,0,7295,1285,5356,547,84,5,0,0,7277,14572
108,Monza e della Brianza,49,1820,5235,436,33,6,0,0,7530,1305,5435,592,100,4,0,0,7436,14966
108,Monza e della Brianza,50,1807,5213,406,26,6,0,0,7458,1130,5594,605,120,1,0,0,7450,14908
108,Monza e della Brianza,51,1707,5270,474,36,5,0,0,7492,1026,5533,593,145,2,0,0,7299,14791
108,Monza e della Brianza,52,1523,5538,498,53,2,0,0,7614,1000,5705,602,175,4,0,0,7486,15100
108,Monza e della Brianza,53,1413,5462,506,66,8,0,0,7455,977,5695,592,174,2,0,0,7440,14895
108,Monza e della Brianza,54,1294,5595,508,59,6,0,0,7462,879,5699,646,209,2,0,0,7435,14897
108,Monza e della Brianza,55,1140,5316,448,66,3,0,0,6973,766,5282,557,202,1,0,0,6808,13781
108,Monza e della Brianza,56,974,4980,416,64,2,0,0,6436,736,5047,510,251,0,0,0,6544,12980
108,Monza e della Brianza,57,876,4898,411,77,8,0,0,6270,683,4810,465,266,1,0,0,6225,12495
108,Monza e della Brianza,58,773,4723,355,68,1,0,0,5920,615,4825,481,272,0,0,0,6193,12113
108,Monza e della Brianza,59,700,4579,335,79,2,0,0,5695,602,4690,434,358,1,0,0,6085,11780
108,Monza e della Brianza,60,598,4346,321,97,4,0,0,5366,507,4466,367,357,0,0,0,5697,11063
108,Monza e della Brianza,61,593,4403,337,91,5,0,0,5429,443,4366,322,419,0,0,0,5550,10979
108,Monza e della Brianza,62,539,4237,265,110,2,0,0,5153,410,4490,341,452,2,0,0,5695,10848
108,Monza e della Brianza,63,503,4091,245,116,2,0,0,4957,398,4301,314,485,0,0,0,5498,10455
108,Monza e della Brianza,64,477,3982,234,151,2,0,0,4846,417,4225,280,563,0,0,0,5485,10331
108,Monza e della Brianza,65,416,4011,222,153,0,0,1,4803,366,3977,237,584,0,0,0,5164,9967
108,Monza e della Brianza,66,440,3985,193,156,2,0,0,4776,359,3843,226,678,1,0,0,5107,9883
108,Monza e della Brianza,67,381,3951,174,169,1,0,0,4676,316,3837,179,759,0,0,0,5091,9767
108,Monza e della Brianza,68,358,4009,149,204,0,0,0,4720,308,3935,196,838,0,0,0,5277,9997
108,Monza e della Brianza,69,366,3979,132,198,0,0,0,4675,322,3762,197,936,1,0,0,5218,9893
108,Monza e della Brianza,70,333,4101,135,217,1,0,0,4787,346,3914,169,1081,0,0,0,5510,10297
108,Monza e della Brianza,71,311,3918,122,226,2,0,0,4579,288,3534,173,1152,0,0,0,5147,9726
108,Monza e della Brianza,72,276,4051,123,302,1,0,0,4753,268,3623,176,1303,1,0,0,5371,10124
108,Monza e della Brianza,73,187,2926,85,246,0,0,0,3444,254,2617,132,1111,0,0,0,4114,7558
108,Monza e della Brianza,74,183,2999,80,280,0,0,0,3542,244,2687,115,1214,0,0,0,4260,7802
108,Monza e della Brianza,75,188,2962,43,302,0,0,0,3495,244,2477,103,1305,0,0,0,4129,7624
108,Monza e della Brianza,76,204,2982,55,302,0,0,0,3543,226,2503,100,1483,0,0,0,4312,7855
108,Monza e della Brianza,77,206,2895,56,342,1,0,0,3500,261,2419,91,1696,0,0,0,4467,7967
108,Monza e della Brianza,78,206,3114,60,445,0,0,0,3825,251,2407,79,1938,0,0,0,4675,8500
108,Monza e della Brianza,79,224,3091,52,437,0,0,0,3804,284,2151,81,2069,0,0,0,4585,8389
108,Monza e della Brianza,80,156,2682,48,491,0,0,0,3377,289,1940,70,2117,0,0,0,4416,7793
108,Monza e della Brianza,81,127,2320,36,439,0,0,0,2922,259,1476,49,2053,0,0,0,3837,6759
108,Monza e della Brianza,82,129,2076,18,446,0,0,0,2669,250,1184,34,1951,0,0,0,3419,6088
108,Monza e della Brianza,83,115,1867,21,432,0,0,0,2435,241,1020,43,2173,0,0,0,3477,5912
108,Monza e della Brianza,84,95,1479,22,399,1,0,0,1996,230,843,30,2045,0,0,0,3148,5144
108,Monza e della Brianza,85,84,1309,17,398,0,0,0,1808,250,660,27,2007,0,0,0,2944,4752
108,Monza e della Brianza,86,68,1127,14,382,0,0,0,1591,215,483,22,1909,0,0,0,2629,4220
108,Monza e della Brianza,87,54,967,11,382,0,0,0,1414,210,412,18,1763,0,0,0,2403,3817
108,Monza e della Brianza,88,59,740,6,347,0,0,0,1152,207,292,16,1748,0,0,0,2263,3415
108,Monza e della Brianza,89,42,550,2,296,0,0,0,890,182,194,13,1534,0,0,0,1923,2813
108,Monza e della Brianza,90,30,377,3,250,0,0,0,660,173,155,12,1314,0,0,0,1654,2314
108,Monza e della Brianza,91,22,292,1,220,0,0,0,535,127,99,5,1123,0,0,0,1354,1889
108,Monza e della Brianza,92,13,199,3,164,0,0,0,379,95,48,5,920,0,0,0,1068,1447
108,Monza e della Brianza,93,11,155,2,133,0,0,0,301,74,40,4,763,0,0,0,881,1182
108,Monza e della Brianza,94,6,91,0,117,0,0,0,214,61,27,2,598,0,0,0,688,902
108,Monza e della Brianza,95,4,66,1,75,0,0,0,146,52,12,2,428,0,0,0,494,640
108,Monza e della Brianza,96,4,38,1,50,0,0,0,93,34,4,6,351,0,0,0,395,488
108,Monza e della Brianza,97,4,20,1,39,0,0,0,64,40,3,2,251,0,0,0,296,360
108,Monza e della Brianza,98,1,13,0,33,0,0,0,47,21,5,1,178,0,0,0,205,252
108,Monza e della Brianza,99,0,3,0,7,0,0,0,10,14,0,0,60,0,0,0,74,84
108,Monza e della Brianza,100,2,2,0,11,0,0,0,15,22,0,1,108,0,0,0,131,146
109,Fermo,0,620,0,0,0,0,0,0,620,548,0,0,0,0,0,0,548,1168
109,Fermo,1,608,0,0,0,0,0,0,608,585,0,0,0,0,0,0,585,1193
109,Fermo,2,666,0,0,0,0,0,0,666,623,0,0,0,0,0,0,623,1289
109,Fermo,3,695,0,0,0,0,0,0,695,651,0,0,0,0,0,0,651,1346
109,Fermo,4,694,0,0,0,0,0,0,694,613,0,0,0,0,0,0,613,1307
109,Fermo,5,737,0,0,0,0,0,0,737,691,0,0,0,0,0,0,691,1428
109,Fermo,6,713,0,0,0,0,0,0,713,700,0,0,0,0,0,0,700,1413
109,Fermo,7,790,0,0,0,0,0,0,790,736,0,0,0,0,0,0,736,1526
109,Fermo,8,783,0,0,0,0,0,0,783,709,0,0,0,0,0,0,709,1492
109,Fermo,9,810,0,0,0,0,0,0,810,722,0,0,0,0,0,0,722,1532
109,Fermo,10,767,0,0,0,0,0,0,767,724,0,0,0,0,0,0,724,1491
109,Fermo,11,815,0,0,0,0,0,0,815,756,0,0,0,0,0,0,756,1571
109,Fermo,12,780,0,0,0,0,0,0,780,758,0,0,0,0,0,0,758,1538
109,Fermo,13,790,0,0,0,0,0,0,790,721,0,0,0,0,0,0,721,1511
109,Fermo,14,761,0,0,0,0,0,0,761,726,0,0,0,0,0,0,726,1487
109,Fermo,15,749,0,0,0,0,0,0,749,716,0,0,0,0,0,0,716,1465
109,Fermo,16,778,0,0,0,0,0,0,778,728,0,0,0,0,0,0,728,1506
109,Fermo,17,813,0,0,0,0,0,0,813,738,0,0,0,0,0,0,738,1551
109,Fermo,18,859,0,0,0,0,0,0,859,752,2,0,0,0,0,0,754,1613
109,Fermo,19,877,0,0,0,0,0,0,877,762,8,0,0,0,0,0,770,1647
109,Fermo,20,933,2,0,0,0,0,0,935,799,12,0,0,1,0,0,812,1747
109,Fermo,21,881,1,0,0,0,0,0,882,752,29,0,0,0,0,0,781,1663
109,Fermo,22,924,3,0,0,0,0,0,927,750,38,1,0,0,0,0,789,1716
109,Fermo,23,907,8,0,0,0,0,0,915,795,53,0,0,0,0,0,848,1763
109,Fermo,24,849,15,0,0,1,0,0,865,701,72,0,0,0,0,0,773,1638
109,Fermo,25,829,28,0,0,0,0,0,857,739,100,0,0,1,0,0,840,1697
109,Fermo,26,907,39,1,0,0,0,0,947,735,129,2,0,0,0,0,866,1813
109,Fermo,27,858,81,0,1,0,0,0,940,703,156,1,0,0,0,0,860,1800
109,Fermo,28,804,61,0,0,0,0,0,865,710,194,1,0,2,0,0,907,1772
109,Fermo,29,815,108,1,0,0,0,0,924,614,239,5,0,0,0,0,858,1782
109,Fermo,30,820,143,1,0,0,0,0,964,620,316,3,1,1,0,0,941,1905
109,Fermo,31,710,182,0,0,0,0,0,892,534,400,6,0,1,0,0,941,1833
109,Fermo,32,711,280,3,0,0,0,0,994,489,439,11,1,0,0,0,940,1934
109,Fermo,33,705,292,5,0,0,0,0,1002,511,481,12,1,1,0,0,1006,2008
109,Fermo,34,599,372,5,0,0,0,0,976,435,515,18,3,0,0,0,971,1947
109,Fermo,35,610,368,5,1,0,0,0,984,423,557,18,3,0,0,0,1001,1985
109,Fermo,36,627,394,16,1,0,0,0,1038,377,595,34,4,0,0,0,1010,2048
109,Fermo,37,543,475,17,0,0,0,0,1035,371,639,29,2,0,0,0,1041,2076
109,Fermo,38,515,507,12,1,1,0,0,1036,346,641,33,6,1,0,0,1027,2063
109,Fermo,39,523,572,21,1,1,0,0,1118,360,781,42,7,1,0,0,1191,2309
109,Fermo,40,523,629,25,2,0,0,0,1179,341,770,46,6,1,0,0,1164,2343
109,Fermo,41,472,652,33,1,0,0,0,1158,337,811,42,6,0,0,0,1196,2354
109,Fermo,42,509,765,19,1,0,0,0,1294,299,782,43,14,0,0,0,1138,2432
109,Fermo,43,450,738,41,2,0,0,0,1231,337,908,60,16,2,0,0,1323,2554
109,Fermo,44,444,765,40,4,0,0,0,1253,292,905,81,17,0,0,0,1295,2548
109,Fermo,45,410,811,41,2,0,0,0,1264,304,932,72,9,0,0,0,1317,2581
109,Fermo,46,386,805,41,1,0,0,0,1233,274,945,70,16,0,0,0,1305,2538
109,Fermo,47,365,864,50,3,0,0,0,1282,234,1055,86,17,0,0,0,1392,2674
109,Fermo,48,402,884,54,3,1,0,0,1344,217,1014,71,23,1,0,0,1326,2670
109,Fermo,49,337,919,59,7,1,0,0,1323,215,1095,81,31,0,0,0,1422,2745
109,Fermo,50,333,907,61,3,0,0,0,1304,208,1008,88,24,0,0,0,1328,2632
109,Fermo,51,296,1017,56,6,0,0,0,1375,172,1112,101,34,0,0,0,1419,2794
109,Fermo,52,288,982,74,3,0,0,0,1347,185,1085,81,45,0,0,0,1396,2743
109,Fermo,53,238,1027,74,8,0,0,0,1347,162,1071,97,38,0,0,0,1368,2715
109,Fermo,54,241,1066,69,8,0,0,0,1384,155,1085,101,37,0,0,0,1378,2762
109,Fermo,55,215,984,73,16,0,0,0,1288,132,1091,98,44,2,0,0,1367,2655
109,Fermo,56,200,1000,64,12,0,0,0,1276,122,1054,71,71,0,0,0,1318,2594
109,Fermo,57,207,1052,70,17,0,0,0,1346,111,1078,88,64,0,0,0,1341,2687
109,Fermo,58,174,1022,53,23,0,0,0,1272,109,1042,87,67,0,0,0,1305,2577
109,Fermo,59,151,990,68,16,0,0,0,1225,94,1024,84,65,0,0,0,1267,2492
109,Fermo,60,123,972,74,17,0,0,0,1186,92,993,65,100,0,0,0,1250,2436
109,Fermo,61,140,934,67,26,0,0,0,1167,93,952,72,99,0,0,0,1216,2383
109,Fermo,62,142,948,39,20,0,0,0,1149,91,1064,63,123,0,0,0,1341,2490
109,Fermo,63,112,957,43,26,0,0,0,1138,76,987,49,112,0,0,0,1224,2362
109,Fermo,64,99,935,38,22,0,0,0,1094,74,930,48,117,0,0,0,1169,2263
109,Fermo,65,88,866,50,41,0,0,0,1045,67,848,52,121,0,0,0,1088,2133
109,Fermo,66,88,853,37,39,0,0,0,1017,66,770,36,158,0,0,0,1030,2047
109,Fermo,67,85,844,31,40,1,0,0,1001,63,849,44,180,0,0,0,1136,2137
109,Fermo,68,86,878,36,42,0,0,0,1042,53,756,42,206,0,0,0,1057,2099
109,Fermo,69,70,843,32,53,0,0,0,998,56,805,29,190,0,0,0,1080,2078
109,Fermo,70,88,876,21,41,0,0,0,1026,42,765,27,235,0,0,0,1069,2095
109,Fermo,71,60,817,28,51,0,0,0,956,51,766,34,239,0,0,0,1090,2046
109,Fermo,72,53,789,15,49,1,0,0,907,43,746,30,239,0,0,0,1058,1965
109,Fermo,73,47,687,26,57,1,0,0,818,48,537,30,250,0,0,0,865,1683
109,Fermo,74,41,583,15,47,0,0,0,686,31,540,14,248,0,0,0,833,1519
109,Fermo,75,43,610,13,61,0,0,0,727,39,513,14,287,0,0,0,853,1580
109,Fermo,76,43,547,13,60,0,0,1,664,38,412,10,320,0,0,0,780,1444
109,Fermo,77,32,561,5,64,0,0,0,662,24,448,16,328,0,0,0,816,1478
109,Fermo,78,51,638,5,86,0,0,0,780,30,516,7,438,0,0,0,991,1771
109,Fermo,79,51,682,8,89,0,0,0,830,34,513,11,509,0,0,0,1067,1897
109,Fermo,80,46,669,11,97,0,0,0,823,34,411,6,555,0,0,0,1006,1829
109,Fermo,81,33,564,5,102,0,0,0,704,25,364,9,487,0,0,0,885,1589
109,Fermo,82,27,512,3,70,0,0,0,612,32,278,7,496,0,0,0,813,1425
109,Fermo,83,32,490,8,100,0,0,0,630,26,258,6,579,0,0,0,869,1499
109,Fermo,84,27,430,2,82,0,0,0,541,39,203,5,491,0,0,0,738,1279
109,Fermo,85,15,350,4,101,0,0,0,470,33,180,4,535,0,0,0,752,1222
109,Fermo,86,15,262,0,78,0,0,0,355,32,139,6,464,0,0,0,641,996
109,Fermo,87,15,297,0,87,0,0,0,399,30,102,3,443,0,0,0,578,977
109,Fermo,88,10,228,1,74,0,0,0,313,26,86,4,444,0,0,0,560,873
109,Fermo,89,7,171,1,69,0,0,0,248,28,51,0,404,0,0,0,483,731
109,Fermo,90,11,158,0,75,0,0,0,244,28,40,4,316,0,0,0,388,632
109,Fermo,91,3,100,0,63,0,0,0,166,30,32,2,322,0,0,0,386,552
109,Fermo,92,5,69,0,66,0,0,0,140,23,16,0,258,0,0,0,297,437
109,Fermo,93,6,57,0,52,0,0,0,115,17,14,0,228,0,0,0,259,374
109,Fermo,94,1,25,0,33,0,0,0,59,16,4,2,175,0,0,0,197,256
109,Fermo,95,0,32,0,24,0,0,0,56,10,4,1,122,0,0,0,137,193
109,Fermo,96,0,13,0,24,0,0,0,37,5,2,1,98,0,0,0,106,143
109,Fermo,97,2,10,0,20,0,0,0,32,6,2,0,56,0,0,0,64,96
109,Fermo,98,1,6,0,6,0,0,0,13,4,1,0,42,0,0,0,47,60
109,Fermo,99,1,1,0,4,0,0,0,6,2,1,0,22,0,0,0,25,31
109,Fermo,100,0,1,0,6,0,0,0,7,4,0,0,26,0,0,0,30,37
110,Barletta-Andria-Trani,0,1601,0,0,0,0,0,0,1601,1377,0,0,0,0,0,0,1377,2978
110,Barletta-Andria-Trani,1,1625,0,0,0,0,0,0,1625,1505,0,0,0,0,0,0,1505,3130
110,Barletta-Andria-Trani,2,1656,0,0,0,0,0,0,1656,1583,0,0,0,0,0,0,1583,3239
110,Barletta-Andria-Trani,3,1645,0,0,0,0,0,0,1645,1482,0,0,0,0,0,0,1482,3127
110,Barletta-Andria-Trani,4,1768,0,0,0,0,0,0,1768,1673,0,0,0,0,0,0,1673,3441
110,Barletta-Andria-Trani,5,1645,0,0,0,0,0,0,1645,1642,0,0,0,0,0,0,1642,3287
110,Barletta-Andria-Trani,6,1737,0,0,0,0,0,0,1737,1668,0,0,0,0,0,0,1668,3405
110,Barletta-Andria-Trani,7,1905,0,0,0,0,0,0,1905,1756,0,0,0,0,0,0,1756,3661
110,Barletta-Andria-Trani,8,1956,0,0,0,0,0,0,1956,1898,0,0,0,0,0,0,1898,3854
110,Barletta-Andria-Trani,9,2004,0,0,0,0,0,0,2004,1909,0,0,0,0,0,0,1909,3913
110,Barletta-Andria-Trani,10,2032,0,0,0,0,0,0,2032,1915,0,0,0,0,0,0,1915,3947
110,Barletta-Andria-Trani,11,2111,0,0,0,0,0,0,2111,1993,0,0,0,0,0,0,1993,4104
110,Barletta-Andria-Trani,12,2144,0,0,0,0,0,0,2144,2018,0,0,0,0,0,0,2018,4162
110,Barletta-Andria-Trani,13,2185,0,0,0,0,0,0,2185,1993,0,0,0,0,0,0,1993,4178
110,Barletta-Andria-Trani,14,2260,0,0,0,0,0,0,2260,2087,0,0,0,0,0,0,2087,4347
110,Barletta-Andria-Trani,15,2268,0,0,0,0,0,0,2268,2098,0,0,0,0,0,0,2098,4366
110,Barletta-Andria-Trani,16,2300,0,0,0,0,0,0,2300,2244,0,0,0,0,0,0,2244,4544
110,Barletta-Andria-Trani,17,2264,0,0,0,0,0,0,2264,2203,1,0,0,0,0,0,2204,4468
110,Barletta-Andria-Trani,18,2343,0,0,0,0,0,0,2343,2383,1,0,0,0,0,0,2384,4727
110,Barletta-Andria-Trani,19,2497,0,0,0,0,0,0,2497,2268,11,0,0,0,0,0,2279,4776
110,Barletta-Andria-Trani,20,2382,2,0,0,0,0,0,2384,2156,20,0,0,0,0,0,2176,4560
110,Barletta-Andria-Trani,21,2452,10,0,0,0,0,0,2462,2243,40,0,0,0,0,0,2283,4745
110,Barletta-Andria-Trani,22,2416,17,1,0,0,0,0,2434,2108,69,1,0,0,0,0,2178,4612
110,Barletta-Andria-Trani,23,2341,17,1,0,0,0,0,2359,2161,97,1,1,0,0,0,2260,4619
110,Barletta-Andria-Trani,24,2408,47,1,0,0,0,0,2456,2170,169,1,0,0,0,0,2340,4796
110,Barletta-Andria-Trani,25,2268,58,0,0,0,0,0,2326,1966,269,1,0,0,0,0,2236,4562
110,Barletta-Andria-Trani,26,2392,120,3,0,0,0,0,2515,1925,376,1,0,1,0,0,2303,4818
110,Barletta-Andria-Trani,27,2265,226,0,0,0,0,0,2491,1756,567,3,0,0,0,0,2326,4817
110,Barletta-Andria-Trani,28,2109,342,1,0,0,0,0,2452,1594,683,9,0,0,0,0,2286,4738
110,Barletta-Andria-Trani,29,1907,479,2,0,1,0,0,2389,1389,899,10,2,1,0,0,2301,4690
110,Barletta-Andria-Trani,30,1771,609,6,0,0,0,0,2386,1197,1064,9,2,0,0,0,2272,4658
110,Barletta-Andria-Trani,31,1624,712,3,0,1,0,0,2340,1067,1189,17,2,0,0,0,2275,4615
110,Barletta-Andria-Trani,32,1471,897,7,1,0,0,0,2376,880,1362,11,4,0,0,0,2257,4633
110,Barletta-Andria-Trani,33,1205,993,3,1,0,0,0,2202,764,1376,20,2,1,0,0,2163,4365
110,Barletta-Andria-Trani,34,1137,1154,5,1,1,0,0,2298,658,1603,28,6,0,0,0,2295,4593
110,Barletta-Andria-Trani,35,1106,1229,10,3,1,0,0,2349,643,1618,31,5,0,0,0,2297,4646
110,Barletta-Andria-Trani,36,931,1380,16,0,0,0,0,2327,623,1775,29,7,0,0,0,2434,4761
110,Barletta-Andria-Trani,37,912,1451,26,2,0,0,0,2391,541,1822,48,9,0,0,0,2420,4811
110,Barletta-Andria-Trani,38,864,1590,24,5,1,0,0,2484,490,1980,42,16,0,0,0,2528,5012
110,Barletta-Andria-Trani,39,819,1751,19,1,0,0,0,2590,477,2081,54,18,0,0,0,2630,5220
110,Barletta-Andria-Trani,40,832,1905,42,3,0,0,0,2782,470,2159,64,19,0,0,0,2712,5494
110,Barletta-Andria-Trani,41,782,2053,35,4,2,0,0,2876,447,2355,77,18,0,0,0,2897,5773
110,Barletta-Andria-Trani,42,741,2102,52,7,0,0,0,2902,430,2411,80,27,0,0,0,2948,5850
110,Barletta-Andria-Trani,43,685,2203,59,4,0,0,0,2951,386,2469,67,25,0,0,0,2947,5898
110,Barletta-Andria-Trani,44,691,2310,55,7,0,0,0,3063,425,2638,107,34,0,0,0,3204,6267
110,Barletta-Andria-Trani,45,620,2250,65,11,0,0,0,2946,400,2536,102,35,0,0,0,3073,6019
110,Barletta-Andria-Trani,46,562,2362,72,13,0,0,0,3009,373,2549,99,35,0,0,0,3056,6065
110,Barletta-Andria-Trani,47,569,2539,66,10,0,0,0,3184,366,2630,105,46,0,0,0,3147,6331
110,Barletta-Andria-Trani,48,511,2530,55,21,0,0,0,3117,314,2639,106,77,0,0,0,3136,6253
110,Barletta-Andria-Trani,49,465,2520,76,21,0,0,0,3082,329,2839,111,79,0,0,0,3358,6440
110,Barletta-Andria-Trani,50,430,2677,82,21,1,0,0,3211,314,2615,79,84,0,0,0,3092,6303
110,Barletta-Andria-Trani,51,415,2684,79,20,1,0,0,3199,302,2594,89,89,0,0,0,3074,6273
110,Barletta-Andria-Trani,52,356,2588,84,31,0,0,0,3059,275,2801,94,102,0,0,0,3272,6331
110,Barletta-Andria-Trani,53,317,2574,64,17,0,0,0,2972,285,2607,111,87,0,0,0,3090,6062
110,Barletta-Andria-Trani,54,298,2698,79,35,1,0,0,3111,287,2736,86,130,0,0,0,3239,6350
110,Barletta-Andria-Trani,55,250,2579,64,37,0,0,0,2930,224,2515,88,119,0,0,0,2946,5876
110,Barletta-Andria-Trani,56,235,2475,63,40,0,0,0,2813,256,2422,81,145,0,0,0,2904,5717
110,Barletta-Andria-Trani,57,228,2418,58,46,0,0,0,2750,240,2313,73,162,1,0,0,2789,5539
110,Barletta-Andria-Trani,58,189,2272,63,41,1,0,0,2566,229,2183,70,173,0,0,0,2655,5221
110,Barletta-Andria-Trani,59,179,2270,60,37,1,0,0,2547,225,2182,71,177,0,0,0,2655,5202
110,Barletta-Andria-Trani,60,159,2054,58,49,0,0,0,2320,186,2061,59,210,0,0,0,2516,4836
110,Barletta-Andria-Trani,61,156,2166,67,48,2,0,0,2439,186,2067,60,209,1,0,0,2523,4962
110,Barletta-Andria-Trani,62,145,1963,44,47,0,0,0,2199,190,1873,57,221,0,0,0,2341,4540
110,Barletta-Andria-Trani,63,130,1977,43,54,0,0,0,2204,141,1864,58,245,0,0,0,2308,4512
110,Barletta-Andria-Trani,64,123,1874,45,61,0,0,0,2103,161,1864,63,258,0,0,0,2346,4449
110,Barletta-Andria-Trani,65,103,1795,43,72,1,0,0,2014,163,1651,51,291,0,0,0,2156,4170
110,Barletta-Andria-Trani,66,94,1764,32,69,0,0,0,1959,144,1544,47,318,0,0,0,2053,4012
110,Barletta-Andria-Trani,67,100,1783,23,77,0,0,0,1983,145,1661,40,344,0,0,0,2190,4173
110,Barletta-Andria-Trani,68,97,1798,37,91,0,0,0,2023,149,1584,39,362,0,0,0,2134,4157
110,Barletta-Andria-Trani,69,81,1816,35,91,0,0,0,2023,144,1554,45,408,0,0,0,2151,4174
110,Barletta-Andria-Trani,70,102,1933,27,112,0,0,0,2174,154,1642,37,471,0,0,0,2304,4478
110,Barletta-Andria-Trani,71,73,1748,24,131,0,0,0,1976,150,1510,32,486,0,0,0,2178,4154
110,Barletta-Andria-Trani,72,90,1765,31,108,0,0,0,1994,143,1452,35,541,0,0,0,2171,4165
110,Barletta-Andria-Trani,73,57,1412,18,108,0,0,0,1595,130,1078,25,492,0,0,0,1725,3320
110,Barletta-Andria-Trani,74,57,1256,15,134,0,0,0,1462,111,984,27,496,0,0,0,1618,3080
110,Barletta-Andria-Trani,75,64,1243,13,154,0,0,0,1474,110,909,16,520,0,0,0,1555,3029
110,Barletta-Andria-Trani,76,63,1176,11,166,0,0,0,1416,115,887,16,589,0,0,0,1607,3023
110,Barletta-Andria-Trani,77,46,1097,13,148,0,0,0,1304,109,786,17,596,0,0,0,1508,2812
110,Barletta-Andria-Trani,78,49,1199,14,170,0,0,0,1432,98,775,22,721,0,0,0,1616,3048
110,Barletta-Andria-Trani,79,37,1042,9,164,0,0,0,1252,96,719,14,717,0,0,0,1546,2798
110,Barletta-Andria-Trani,80,36,878,10,166,0,0,0,1090,100,584,15,694,0,0,0,1393,2483
110,Barletta-Andria-Trani,81,41,873,9,186,0,0,0,1109,91,547,15,751,0,0,0,1404,2513
110,Barletta-Andria-Trani,82,23,689,9,186,0,0,0,907,82,379,10,723,0,0,0,1194,2101
110,Barletta-Andria-Trani,83,18,689,12,188,0,0,0,907,93,376,9,728,0,0,0,1206,2113
110,Barletta-Andria-Trani,84,26,584,2,159,0,0,0,771,88,309,7,708,0,0,0,1112,1883
110,Barletta-Andria-Trani,85,17,444,7,175,0,0,0,643,70,236,7,671,0,0,0,984,1627
110,Barletta-Andria-Trani,86,13,422,2,177,0,0,0,614,60,179,12,651,0,0,0,902,1516
110,Barletta-Andria-Trani,87,8,382,2,161,0,0,0,553,57,136,1,610,0,0,0,804,1357
110,Barletta-Andria-Trani,88,8,266,1,142,0,0,0,417,53,106,2,574,0,0,0,735,1152
110,Barletta-Andria-Trani,89,13,174,4,147,0,0,0,338,50,71,6,472,0,0,0,599,937
110,Barletta-Andria-Trani,90,5,184,0,108,0,0,0,297,47,37,1,384,0,0,0,469,766
110,Barletta-Andria-Trani,91,6,118,0,111,0,0,0,235,39,27,1,358,0,0,0,425,660
110,Barletta-Andria-Trani,92,2,68,1,77,0,0,0,148,16,22,3,298,0,0,0,339,487
110,Barletta-Andria-Trani,93,2,44,0,61,0,0,0,107,25,11,0,237,0,0,0,273,380
110,Barletta-Andria-Trani,94,2,28,1,51,0,0,0,82,20,11,1,181,0,0,0,213,295
110,Barletta-Andria-Trani,95,3,14,0,44,0,0,0,61,10,3,1,153,0,0,0,167,228
110,Barletta-Andria-Trani,96,1,10,0,27,0,0,0,38,8,3,0,104,0,0,0,115,153
110,Barletta-Andria-Trani,97,2,10,0,20,0,0,0,32,9,0,0,73,0,0,0,82,114
110,Barletta-Andria-Trani,98,0,5,0,19,0,0,0,24,3,0,0,49,0,0,0,52,76
110,Barletta-Andria-Trani,99,0,2,0,9,0,0,0,11,1,0,0,22,0,0,0,23,34
110,Barletta-Andria-Trani,100,0,3,0,12,0,0,0,15,5,2,0,33,0,0,0,40,55
111,Sud Sardegna,0,998,0,0,0,0,0,0,998,906,0,0,0,0,0,0,906,1904
111,Sud Sardegna,1,984,0,0,0,0,0,0,984,959,0,0,0,0,0,0,959,1943
111,Sud Sardegna,2,1052,0,0,0,0,0,0,1052,1013,0,0,0,0,0,0,1013,2065
111,Sud Sardegna,3,1142,0,0,0,0,0,0,1142,1052,0,0,0,0,0,0,1052,2194
111,Sud Sardegna,4,1172,0,0,0,0,0,0,1172,1112,0,0,0,0,0,0,1112,2284
111,Sud Sardegna,5,1234,0,0,0,0,0,0,1234,1187,0,0,0,0,0,0,1187,2421
111,Sud Sardegna,6,1236,0,0,0,0,0,0,1236,1164,0,0,0,0,0,0,1164,2400
111,Sud Sardegna,7,1355,0,0,0,0,0,0,1355,1262,0,0,0,0,0,0,1262,2617
111,Sud Sardegna,8,1381,0,0,0,0,0,0,1381,1263,0,0,0,0,0,0,1263,2644
111,Sud Sardegna,9,1364,0,0,0,0,0,0,1364,1343,0,0,0,0,0,0,1343,2707
111,Sud Sardegna,10,1361,0,0,0,0,0,0,1361,1316,0,0,0,0,0,0,1316,2677
111,Sud Sardegna,11,1372,0,0,0,0,0,0,1372,1308,0,0,0,0,0,0,1308,2680
111,Sud Sardegna,12,1359,0,0,0,0,0,0,1359,1332,0,0,0,0,0,0,1332,2691
111,Sud Sardegna,13,1458,0,0,0,0,0,0,1458,1261,0,0,0,0,0,0,1261,2719
111,Sud Sardegna,14,1446,0,0,0,0,0,0,1446,1252,0,0,0,0,0,0,1252,2698
111,Sud Sardegna,15,1421,0,0,0,0,0,0,1421,1305,0,0,0,0,0,0,1305,2726
111,Sud Sardegna,16,1537,0,0,0,0,0,0,1537,1363,0,0,0,0,0,0,1363,2900
111,Sud Sardegna,17,1464,0,0,0,0,0,0,1464,1363,0,0,0,0,0,0,1363,2827
111,Sud Sardegna,18,1610,0,0,0,0,0,0,1610,1553,2,0,0,0,0,0,1555,3165
111,Sud Sardegna,19,1602,1,0,0,0,0,0,1603,1357,3,0,0,0,0,0,1360,2963
111,Sud Sardegna,20,1594,0,0,0,0,0,0,1594,1309,3,0,0,0,0,0,1312,2906
111,Sud Sardegna,21,1587,2,0,1,0,0,0,1590,1356,7,0,0,0,0,0,1363,2953
111,Sud Sardegna,22,1700,1,0,0,0,0,0,1701,1382,13,0,0,0,0,0,1395,3096
111,Sud Sardegna,23,1650,6,0,0,0,0,0,1656,1452,20,0,0,0,0,0,1472,3128
111,Sud Sardegna,24,1649,11,1,0,0,0,0,1661,1454,50,1,0,0,0,0,1505,3166
111,Sud Sardegna,25,1659,12,1,0,0,0,0,1672,1519,74,3,0,0,0,0,1596,3268
111,Sud Sardegna,26,1763,23,1,0,0,0,0,1787,1580,108,4,0,0,0,0,1692,3479
111,Sud Sardegna,27,1817,68,2,0,0,0,0,1887,1526,161,6,1,0,0,0,1694,3581
111,Sud Sardegna,28,1793,81,1,0,0,0,0,1875,1530,240,5,1,0,0,0,1776,3651
111,Sud Sardegna,29,1830,129,5,0,0,0,0,1964,1471,293,8,1,0,0,0,1773,3737
111,Sud Sardegna,30,1682,144,7,0,0,0,0,1833,1389,374,8,1,1,0,0,1773,3606
111,Sud Sardegna,31,1674,218,5,0,0,0,0,1897,1298,487,16,1,1,0,0,1803,3700
111,Sud Sardegna,32,1643,293,10,2,0,0,0,1948,1240,482,15,1,0,0,0,1738,3686
111,Sud Sardegna,33,1665,372,7,0,0,0,0,2044,1225,660,19,4,2,0,0,1910,3954
111,Sud Sardegna,34,1619,499,13,0,0,0,0,2131,1162,771,35,5,1,1,0,1975,4106
111,Sud Sardegna,35,1538,491,18,0,1,0,0,2048,1122,865,35,4,2,0,0,2028,4076
111,Sud Sardegna,36,1576,670,15,1,1,0,0,2263,1070,984,60,5,1,0,0,2120,4383
111,Sud Sardegna,37,1458,735,28,1,0,0,0,2222,998,1071,44,7,1,0,0,2121,4343
111,Sud Sardegna,38,1492,827,37,0,0,0,0,2356,1009,1127,58,5,0,0,0,2199,4555
111,Sud Sardegna,39,1287,955,40,0,0,0,0,2282,865,1262,81,11,0,0,0,2219,4501
111,Sud Sardegna,40,1448,1106,46,0,0,0,0,2600,868,1342,79,16,1,0,0,2306,4906
111,Sud Sardegna,41,1310,1211,50,2,0,0,0,2573,834,1496,99,12,2,0,0,2443,5016
111,Sud Sardegna,42,1308,1260,68,3,0,0,0,2639,819,1606,95,21,1,0,0,2542,5181
111,Sud Sardegna,43,1280,1357,71,5,1,0,0,2714,789,1685,108,26,1,0,0,2609,5323
111,Sud Sardegna,44,1274,1529,86,6,1,0,0,2896,759,1834,112,33,0,0,0,2738,5634
111,Sud Sardegna,45,1210,1539,92,11,0,0,0,2852,708,1816,121,25,0,0,0,2670,5522
111,Sud Sardegna,46,1132,1647,108,10,1,0,0,2898,592,1905,104,29,1,0,0,2631,5529
111,Sud Sardegna,47,1022,1570,116,7,0,0,0,2715,568,1908,153,55,0,0,0,2684,5399
111,Sud Sardegna,48,934,1660,126,9,0,0,0,2729,552,1914,125,49,1,0,0,2641,5370
111,Sud Sardegna,49,885,1778,117,16,0,0,0,2796,557,2103,151,60,0,0,0,2871,5667
111,Sud Sardegna,50,829,1700,126,13,0,0,0,2668,470,2041,176,81,0,0,0,2768,5436
111,Sud Sardegna,51,797,1952,144,19,0,0,0,2912,492,2139,135,77,0,0,0,2843,5755
111,Sud Sardegna,52,743,2005,164,16,2,0,0,2930,456,2156,150,96,0,0,0,2858,5788
111,Sud Sardegna,53,639,2049,142,23,2,0,0,2855,435,2104,140,106,0,0,0,2785,5640
111,Sud Sardegna,54,707,2133,136,26,1,0,0,3003,378,2205,155,138,0,0,0,2876,5879
111,Sud Sardegna,55,576,2107,136,26,0,1,0,2846,383,2262,113,143,1,0,0,2902,5748
111,Sud Sardegna,56,561,2006,130,24,0,0,0,2721,364,2290,133,149,0,0,0,2936,5657
111,Sud Sardegna,57,538,2119,122,32,1,0,0,2812,337,2219,125,186,0,0,0,2867,5679
111,Sud Sardegna,58,504,2070,129,46,0,0,0,2749,316,2117,118,196,0,0,0,2747,5496
111,Sud Sardegna,59,438,2074,104,56,0,0,0,2672,313,2068,99,190,0,0,0,2670,5342
111,Sud Sardegna,60,481,2025,101,61,0,0,0,2668,278,2077,118,238,0,0,0,2711,5379
111,Sud Sardegna,61,425,2127,105,52,0,0,0,2709,304,2128,93,267,0,0,0,2792,5501
111,Sud Sardegna,62,385,2048,109,50,0,0,0,2592,275,2063,80,290,0,0,0,2708,5300
111,Sud Sardegna,63,350,2022,95,73,0,0,0,2540,259,1990,63,307,0,0,0,2619,5159
111,Sud Sardegna,64,339,2098,107,65,0,0,0,2609,256,1908,68,346,0,0,0,2578,5187
111,Sud Sardegna,65,327,2077,85,80,0,0,0,2569,253,1841,80,385,0,0,0,2559,5128
111,Sud Sardegna,66,308,2035,71,84,0,1,0,2499,243,1899,65,358,0,0,0,2565,5064
111,Sud Sardegna,67,294,2045,85,75,0,0,0,2499,211,1791,51,454,0,0,0,2507,5006
111,Sud Sardegna,68,278,1965,80,90,0,0,0,2413,235,1729,69,423,0,0,0,2456,4869
111,Sud Sardegna,69,281,1908,65,114,0,0,0,2368,241,1609,56,492,0,0,0,2398,4766
111,Sud Sardegna,70,277,1985,56,111,0,0,0,2429,233,1612,51,508,0,0,0,2404,4833
111,Sud Sardegna,71,234,1839,60,120,0,0,0,2253,217,1493,51,525,0,0,0,2286,4539
111,Sud Sardegna,72,211,1683,46,96,0,0,0,2036,201,1258,44,564,0,0,0,2067,4103
111,Sud Sardegna,73,201,1448,35,110,0,0,0,1794,206,1115,40,548,0,0,0,1909,3703
111,Sud Sardegna,74,176,1373,32,135,0,0,0,1716,200,1077,38,581,0,0,0,1896,3612
111,Sud Sardegna,75,153,1344,35,118,0,0,0,1650,185,1050,35,617,0,0,0,1887,3537
111,Sud Sardegna,76,163,1320,23,139,0,0,0,1645,182,956,27,713,0,1,0,1879,3524
111,Sud Sardegna,77,153,1148,24,140,0,0,0,1465,183,823,27,758,0,0,0,1791,3256
111,Sud Sardegna,78,171,1221,29,180,0,0,0,1601,206,873,23,888,0,0,0,1990,3591
111,Sud Sardegna,79,154,1171,19,155,0,0,0,1499,213,790,12,852,0,0,0,1867,3366
111,Sud Sardegna,80,131,939,24,157,0,0,0,1251,171,615,17,849,0,0,0,1652,2903
111,Sud Sardegna,81,111,865,22,155,0,0,0,1153,188,516,12,811,0,0,0,1527,2680
111,Sud Sardegna,82,113,784,9,133,0,0,0,1039,153,435,19,833,0,0,0,1440,2479
111,Sud Sardegna,83,88,673,5,147,0,0,0,913,156,357,6,806,0,0,0,1325,2238
111,Sud Sardegna,84,94,663,8,171,0,0,0,936,140,339,10,859,0,0,0,1348,2284
111,Sud Sardegna,85,97,577,13,165,0,0,0,852,137,257,13,865,0,0,0,1272,2124
111,Sud Sardegna,86,65,469,9,149,0,0,0,692,129,231,4,869,0,0,0,1233,1925
111,Sud Sardegna,87,48,422,3,139,0,0,0,612,98,169,6,733,0,0,0,1006,1618
111,Sud Sardegna,88,58,362,0,157,0,0,0,577,131,133,7,795,0,0,0,1066,1643
111,Sud Sardegna,89,38,276,3,123,0,0,0,440,97,83,4,748,0,0,0,932,1372
111,Sud Sardegna,90,30,228,2,127,0,0,0,387,89,67,5,644,0,0,0,805,1192
111,Sud Sardegna,91,26,168,0,83,0,0,0,277,79,59,3,519,0,0,0,660,937
111,Sud Sardegna,92,24,131,0,93,0,0,0,248,71,36,1,429,0,0,0,537,785
111,Sud Sardegna,93,25,77,0,69,0,0,0,171,43,24,0,316,0,0,0,383,554
111,Sud Sardegna,94,8,57,0,61,0,0,0,126,38,12,0,279,0,0,0,329,455
111,Sud Sardegna,95,9,45,0,47,0,0,0,101,22,9,0,207,0,0,0,238,339
111,Sud Sardegna,96,3,27,0,42,0,0,0,72,20,9,1,138,0,0,0,168,240
111,Sud Sardegna,97,4,18,0,23,0,0,0,45,14,4,0,92,0,0,0,110,155
111,Sud Sardegna,98,2,11,0,17,0,0,0,30,9,0,0,91,0,0,0,100,130
111,Sud Sardegna,99,0,5,1,10,0,0,0,16,2,3,0,52,0,0,0,57,73
111,Sud Sardegna,100,1,12,0,17,0,0,0,30,8,1,0,70,0,0,0,79,109
