data,stato,codice_regione,denominazione_regione,lat,long,ricoverati_con_sintomi,terapia_intensiva,totale_ospedalizzati,isolamento_domiciliare,totale_positivi,variazione_totale_positivi,nuovi_positivi,dimessi_guariti,deceduti,totale_casi,tamponi,casi_testati,note_it,note_en
2020-05-23T17:00:00,ITA,13,Abruzzo,42.35122196,13.39843823,156,4,160,1008,1168,-11,1,1659,394,3221,65290,44680,,
2020-05-23T17:00:00,ITA,17,Basilicata,40.63947052,15.80514834,14,1,15,26,41,-8,4,330,27,398,25511,24841,,
2020-05-23T17:00:00,ITA,21,P.A. Bolzano,46.49933453,11.35662422,35,5,40,174,214,-10,0,2085,291,2590,59671,27549,,
2020-05-23T17:00:00,ITA,18,Calabria,38.90597598,16.59440194,43,1,44,244,288,-14,0,773,96,1157,61892,59633,,
2020-05-23T17:00:00,ITA,15,Campania,40.83956555,14.25084984,295,10,305,968,1273,-19,11,3067,404,4744,166692,79655,,
2020-05-23T17:00:00,ITA,08,Emilia-Romagna,44.49436681,11.3417208,524,84,608,3962,4570,-160,43,18896,4047,27513,287382,179022,,
2020-05-23T17:00:00,ITA,06,Friuli Venezia Giulia,45.6494354,13.76813649,63,1,64,395,459,-26,6,2447,327,3233,116689,71043,,
2020-05-23T17:00:00,ITA,12,Lazio,41.89277044,12.48366722,1097,60,1157,2424,3581,-54,18,3350,676,7607,230743,185285,,
2020-05-23T17:00:00,ITA,07,Liguria,44.41149315,8.9326992,247,20,267,1467,1734,-174,38,6279,1414,9427,91735,52664,,
2020-05-23T17:00:00,ITA,03,Lombardia,45.46679409,9.190347404,4026,199,4225,21405,25630,-303,441,45355,15840,86825,658784,389648,,
2020-05-23T17:00:00,ITA,11,Marche,43.61675973,13.5188753,100,15,115,1598,1713,-55,4,3995,993,6701,94657,60232,,
2020-05-23T17:00:00,ITA,14,Molise,41.55774754,14.65916051,8,2,10,179,189,5,5,220,22,431,13017,12552,,
2020-05-23T17:00:00,ITA,01,Piemonte,45.0732745,7.680687483,1291,76,1367,6658,8025,-427,60,18341,3771,30137,281897,185963,,
2020-05-23T17:00:00,ITA,16,Puglia,41.12559576,16.86736689,215,17,232,1573,1805,-33,8,2157,486,4448,101738,68485,,
2020-05-23T17:00:00,ITA,20,Sardegna,39.21531192,9.110616306,58,6,64,223,287,-19,0,940,129,1356,49675,42790,,
2020-05-23T17:00:00,ITA,19,Sicilia,38.11569725,13.3623567,95,9,104,1408,1512,-7,0,1640,269,3421,131913,116517,,
2020-05-23T17:00:00,ITA,09,Toscana,43.76923077,11.25588885,157,40,197,1569,1766,-20,12,7270,1011,10047,226046,162433,,
2020-05-23T17:00:00,ITA,22,P.A. Trento,46.06893511,11.12123097,28,4,32,533,565,-42,7,3374,456,4395,78185,45304,,
2020-05-23T17:00:00,ITA,10,Umbria,43.10675841,12.38824698,15,2,17,39,56,-3,1,1300,74,1430,63009,44473,,
2020-05-23T17:00:00,ITA,02,Valle d'Aosta,45.73750286,7.320149366,23,2,25,10,35,-8,0,999,143,1177,13828,10858,,
2020-05-23T17:00:00,ITA,05,Veneto,45.43490485,12.33845213,205,14,219,2622,2841,-182,10,14363,1865,19069,572834,300799,,